Tiberias	altoffsp	Tveria
Petah Tikva	altoffsp	Petah Tiqwa
Nahf	altoffsp	Nahef
Givatayim	altoffsp	Givatayim
Rishon LeZion	altoffsp	Rishon LeZiyyon
Beersheba	altoffsp	Be'er Sheva
Herzliya	altoffsp	Herzliya
Or Akiva	altoffsp	Or Aqiva
Beitar Illit	altoffsp	Betar Illit
Tira, Israel	altoffsp	Tire
Beit She'an	altoffsp	Bet She'an
Beit Shemesh	altoffsp	Bet Shemesh
Migdal HaEmek	altoffsp	Migdal HaEmeq
Ma'ale Adumim	altoffsp	Ma'ale Adummim
Kiryat Ono	altoffsp	Qiryat Ono
Kiryat Ata	altoffsp	Qiryat Ata
Kiryat Malakhi	altoffsp	Qiryat Mal'akhi
Kiryat Shmona	altoffsp	kiryat Shemona
Shefa-'Amr	altoffsp	Shfar'am
Safed	altoffsp	Tsfat, Tzefat, Zfat, áº”efat
Zikhron Ya'akov	altoffsp	Zichron Ya'aqov
Kiryat Arba	altoffsp	Qiryat Arba
Efrat	altoffsp	Efrata
Mevaseret Zion	altoffsp	Mevasseret Ziyyon
Kiryat Tiv'on	altoffsp	Qiryat Tiv'on
Shlomi, Israel	altoffsp	Shelomi
Kfar Yona	altoffsp	Kefar Yona
Beit El	altoffsp	Bet El
Alfei Menashe	altoffsp	Alfe Menashe
Rosh Pinna	altoffsp	Rosh Pina
Be'er Ya'akov	altoffsp	Be'er Ya'aqov
Meitar	altoffsp	Metar
Karnei Shomron	altoffsp	Qarne Shomron
Kedumim	altoffsp	Qedumim
Lakiya	altoffsp	Laqye
Shaqib al-Salam	altoffsp	Segev Shalom
Ar'arat an-Naqab	altoffsp	Ar'ara BaNegev
Deir Hanna	altoffsp	Deir Hana
Reineh	altoffsp	Reine
Tzoran-Kadima	altoffsp	Kadima-Tzoran
Baqa-Jatt	altoffsp	Baqa-Jat
Shaghur	altoffsp	Shagor
Peki'in	altoffsp	Peqi'in
Bnei Ayish	altoffsp	Bene Ayish
Kafr Kanna	altoffsp	Kafar Kanna
Maghar, Israel	altoffsp	Mughar
Kiryat Ekron	altoffsp	Qiryath Eqron
Mazra'a	altoffsp	\
Jaljulia	altoffsp	Jaljulye
Kabul, Israel	altoffsp	al-Kabul
Majd al-Krum	altoffsp	Majd al-Kurum
Kafr Yasif	altoffsp	Kafar Yasif
Kafr Bara	altoffsp	Kafar Bara
Jadeidi-Makr	altoffsp	Judeidi-Maker
Tuba-Zangariyye	altoffsp	Tuba az-Zanghariyya
Arraba, Israel	altoffsp	Arrabe
Rameh	altoffsp	Rame
Yafa an-Naseriyye	altoffsp	Yafia
Kafr Qara	altoffsp	Kefar Qara
Kafr Manda	altoffsp	Kafar Manda
Zarzir	altoffsp	Bet Zarzir
Bir al-Maksur	altoffsp	Bir el-Maksur
Eilabun	altoffsp	Illabun
Mashhad, Israel	altoffsp	Meshhed
Ma'ale Iron	altoffsp	Jabal 'Ara
Kaukab Abu al-Hija	altoffsp	Kaokab Abu Al-Hija
Kafr Qasim	altoffsp	Kafar Qasem
Katzrin	altoffsp	Qazrin
