Dimona	arname	ديمونا
Ashkelon	arname	عسقلان
Acre, Israel	arname	عكّا
Ra'anana	arname	رعنانا
Eilat	arname	ايلات
Tiberias	arname	طبرية
Petah Tikva	arname	بتاح تكفا
Holon	arname	حولون
Sakhnin	arname	سخنين
Sha'ab, Israel	arname	شعب
Nahf	arname	نحف
Ashdod	arname	أشدود
Kiryat Yam	arname	كريات يام
Givatayim	arname	جفعاتايم
Ramat Gan	arname	رمات غان
Rishon LeZion	arname	ريشون لتسيون
Bat Yam	arname	بات يام
Herzliya	arname	هرتسيليا
Bnei Brak	arname	بني براك
Ramat HaSharon	arname	رامات هاشارون
Karmiel	arname	كرمئيل
Ramla	arname	الرملة
Ofakim	arname	أوفاكيم
Or Akiva	arname	أور عقيفا
Umm al-Fahm	arname	أم الفحم
Or Yehuda	arname	أور یهودا
Baqa al-Gharbiyye	arname	باقة الغربية
Beitar Illit	arname	بيتار عيليت
Hadera	arname	الخضيرة
Hod HaSharon	arname	هود هاشرون
Tira, Israel	arname	الطـّيرة
Beit She'an	arname	بيسان
Beit Shemesh	arname	بيت شيمش
Tayibe	arname	الطيبة
Tamra	arname	طمرة
Yavne	arname	يفنه
Migdal HaEmek	arname	مجدال هعيمق/مغدال هعيمق
Yehud	arname	يهود
Nahariya	arname	نهاريّا
Ness Ziona	arname	نيس زيونا
Ma'ale Adumim	arname	معالي أدوميم
Kfar Saba	arname	كفار سابا
Nazareth Illit	arname	الناصرة العليا
Nesher	arname	نيشير
Ma'alot-Tarshiha	arname	معالوت ترشيحا
Netivot	arname	نتيفوت
Kiryat Ono	arname	كريات أونو
Kiryat Bialik	arname	كریات بیالیك
Kiryat Ata	arname	كريات آتا
Qalansawe	arname	قلنسوة
Afula	arname	العفولة
Kiryat Malakhi	arname	قرية ملأكي
Kiryat Motzkin	arname	كريات موصقين
Rosh HaAyin	arname	روش هاعين
Kiryat Gat	arname	كريات جات
Rahat	arname	رهط
Kiryat Shmona	arname	كريات شمونه
Shefa-'Amr	arname	شفاعمرو
Rehovot	arname	رحوفوت
Safed	arname	صفد
Mazkeret Batya	arname	مزكيرت باتيا
Zikhron Ya'akov	arname	زخرون يعكوف
Kiryat Arba	arname	قرية أربع
Sderot	arname	سديروت
Ariel	arname	اريئيل
Hatzor HaGlilit	arname	حتسور هجليليت
Efrat	arname	أفرات
Yeruham	arname	يروحام
Kfar Vradim	arname	كفار فراديم
Mevaseret Zion	arname	مفسيرت تصيون
Modi'in Illit	arname	موديعين عيليت
Giv'at Ze'ev	arname	چفعت زئيف
Mitzpe Ramon	arname	متسبي رمون
Kiryat Tiv'on	arname	كريات طبعون
Tirat Carmel	arname	طيرة الكرمل
Hura	arname	حورة
Kfar Tavor	arname	كفر تافور
Shlomi, Israel	arname	شلومي
Kokhav Ya'ir	arname	كوخاف يئير
Yehud-Monosson	arname	يهود-مونوسون
Tel Mond	arname	تل موند
Kfar Yona	arname	كفار يونا
Abu Snan	arname	أبو سنان
Iksal	arname	إكسال
Sajur	arname	ساجور
Metula	arname	المطلة
Kiryat Ye'arim	arname	قرية يعاريم
Beit El	arname	بيت إيل
Alfei Menashe	arname	ألفي منشيه
Rosh Pinna	arname	روش بينا
Migdal, Israel	arname	مغدال
Be'er Ya'akov	arname	بئر يعقوب
Gedera	arname	غديرا
Meitar	arname	ميتار
Karnei Shomron	arname	كرني شمرون
Kedumim	arname	كدوميم
Kfar Kama	arname	كفر كما
Giv'at Shmuel	arname	جفعات شموئيل
Pardes Hanna-Karkur	arname	برديس حنه كركور
Lehavim	arname	لهافيم
Kuseife	arname	كسيفة
Lakiya	arname	اللقية
Shaqib al-Salam	arname	شقيب السلام
Tel as-Sabi	arname	تل السبع
Ar'arat an-Naqab	arname	عرعرة
Shoham	arname	شوهم
Immanuel	arname	عيمانوئيل
Ma'ale Efrayim	arname	معلي افرايم
Even Yehuda	arname	حتى يهودا
Gan Yavne	arname	غان يافني
Deir Hanna	arname	دير حنا
El'ad	arname	إلعاد
Reineh	arname	الرينة
Tzoran-Kadima	arname	كاديما تسوران
Baqa-Jatt	arname	باقة جتّ
Modi'in-Maccabim-Re'ut	arname	موديعين مكابيم ريعوت
Shaghur	arname	الشاغور
Carmel City	arname	مدينة الكرمل
Beit Dagan	arname	بيت دجن
Peki'in	arname	البقيعة
Bnei Ayish	arname	بني عايش
Kafr Kanna	arname	كفر كنا
Yesud HaMa'ala	arname	يسود همعلاه
Maghar, Israel	arname	المغار
Fassuta	arname	فسّوطه
Julis	arname	جولس
I'billin	arname	إعبلين
Binyamina-Giv'at Ada	arname	بنيامينا غفعات عادة
Kiryat Ekron	arname	كريات عكرون
Mazra'a	arname	المزرعة
Kfar Shmaryahu	arname	كفر شمرياهو
Savyon	arname	سفيون
Azor	arname	أزور
Jaljulia	arname	جلجولية
Kabul, Israel	arname	كابول
Majd al-Krum	arname	مجد الكروم
Kafr Yasif	arname	كفر ياسيف
Elkana	arname	القناة
Kafr Bara	arname	كفر برا
'Ara	arname	عاره
Ar'ara	arname	عرعرة
Fureidis	arname	فريديس
Jadeidi-Makr	arname	مكر جديده
Bi'ina	arname	بعنة
Tuba-Zangariyye	arname	طوبه زنغرية
Arraba, Israel	arname	عرّابة
Rameh	arname	الرامه
Kafr Qara	arname	كفر قرع
Kafr Manda	arname	كفر مندا
Zarzir	arname	زرزير
Basma	arname	بسمة
Bir al-Maksur	arname	بئر المكسور
Daburiyya	arname	دبورية
Tur'an	arname	طرعان
Shibli–Umm al-Ghanam	arname	الشبلي - أم الغنم
Eilabun	arname	عيلبون
Jish	arname	الجش
Mashhad, Israel	arname	مشهد
Ma'ale Iron	arname	معاليه عيرون
Rekhasim	arname	رخاسيم
Ganei Tikva	arname	غني تيكفا
Basmat Tab'un	arname	بسمة طبعون
Hurfeish	arname	حرفيش
Ein Mahil	arname	عين ماهل
Yanuh-Jat	arname	يانوح-جت
Ramat Yishai	arname	رمات يشاي
Ka'abiyye-Tabbash-Hajajre	arname	كعبية طباش الحجاجرة
Ilut	arname	عيلوط
Yavne'el	arname	يفنيئيل
Bu'eine Nujeidat	arname	بعينة-نجيدات
Har Adar	arname	هار أدار
Pardesiya	arname	بردسيا
Kaukab Abu al-Hija	arname	كوكب أبو الهيجا
Kafr Misr	arname	كفر مصر
Elyakhin	arname	أليخين
Zemer	arname	زيمر
Oranit	arname	أورنيت
Mi'ilya	arname	معليا
Kisra-Sumei	arname	كسرا-سميع
Harish, Israel	arname	خريش
Beit Aryeh-Ofarim	arname	بيت آريه
Isfiya	arname	عسفيا
Musmus	arname	مُصمُص
Kafr Qasim	arname	كفر قاسم
Katzrin	arname	كتسرين
Musheirifa	arname	المشيرفة
Ein as-Sahla	arname	عين السهلة
Jatt, Israel	arname	جت
Zalafa	arname	زلفة
Salem, Ma'ale Iron	arname	سالم
Bayada, Ma'ale Iron	arname	البياضة
Mu'awiya, Basma	arname	معاوية
