Själevads IK	ballpark	Själevads IP
Anchorage Bucs	ballpark	Mulcahy Stadium
IFK Uppsala	ballpark	Stenhagens IP
Husqvarna IF	ballpark	Vapenvallen
Alaska Goldpanners of Fairbanks	ballpark	Growden Memorial Park
Coquitlam Reds	ballpark	Mundy Park
White Rock Tritons	ballpark	South Surrey Athletic Park
Langley Blaze	ballpark	Mcleod Athletic Park
Mat-Su Miners	ballpark	Hermon Brothers Field
Slottsbrons IF	ballpark	Strandvallen, Slottsbron
Katrineholms SK Bandy	ballpark	Backavallen
IFK Kungälv	ballpark	Skarpe Nord
Katrineholm Värmbol BS	ballpark	Backavallen
Borlänge-Stora Tuna BK	ballpark	Tunets IP
Frillesås BK	ballpark	Sjöaremossen
Jönköping Bandy IF	ballpark	Råslätts IP
Västanfors IF	ballpark	Västanfors IP
Skirö-Nävelsjö BS	ballpark	Sapa Arena
Karlsborgs BK	ballpark	Bruksvallen
Västerstrands AIK	ballpark	Tingvalla isstadion
Kareby IS	ballpark	Skarpe Nord
Kareby IS	ballpark	Kringledammen
Kareby IS	ballpark	Kareby Hed
IFK Holmsund	ballpark	Kamratvallen
Habo IF	ballpark	Slättens IP
Huskvarna Södra IS	ballpark	Hjärttorpsvallen
Sandslåns SK	ballpark	Flottarvallen
Hälleforsnäs IF	ballpark	Edströmsvallen
Lesjöfors IF	ballpark	Stålvallen
Norbergs BK	ballpark	Malmheden IP
Häggenås SK	ballpark	Tigervallen
Lönsboda GoIF	ballpark	Snapphanevallen
Hammenhögs IF	ballpark	Hamondavallen
Sidensjö IK	ballpark	Sidensjö IP
Hornskrokens IF	ballpark	Hildursborg
IFK Öxnehaga	ballpark	Öxnehaga IP
Lotorps IF	ballpark	Bruksvallen
Gideonsbergs IF	ballpark	Önsta IP
Öxabäcks IF	ballpark	Hagavallen
Filipstads IF	ballpark	Kalhyttans IP
Nynäshamns IF	ballpark	Kvarnängens IP
IFK Askersund	ballpark	Solberga IP
Söderköpings IS	ballpark	Vikingavallen, Söderköping
Härnösands AIK	ballpark	Högslättens IP
Forsbacka IK	ballpark	Mariehov
IK Heros	ballpark	Herosvallen
IF Verdandi	ballpark	Fröslunda IP
Waggeryds IK	ballpark	Vaggeryds multisportarena
Värmbols GoIF	ballpark	Backavallen
Eskilstuna BS	ballpark	Eskilstuna isstadion
Grycksbo IF	ballpark	Tansvallen
IK Viljan	ballpark	Vasavallen
IF Hallby	ballpark	Bymarksvallen
Sunvära SK	ballpark	Sjöaremossen
IFK Nässjö	ballpark	Skogsvallen, Nässjö
Östersunds BS	ballpark	Östersund Arena
Östersunds BS	ballpark	Odenvallens IP
