St. John Fisher College	baseballfield	Dugan Yard
Nebraska Cornhuskers	baseballfield	Haymarket Park
Harvard Crimson	baseballfield	Joseph J. O'Donnell Field
Arkansas Razorbacks	baseballfield	Baum Stadium
UBC Thunderbirds	baseballfield	UBC Thunderbirds Baseball Stadium
Medaille College	baseballfield	McCarthy Park
Minnesota Golden Gophers	baseballfield	Siebert Field U.S. Bank Stadium
Sul Ross State University	baseballfield	Kokernot Field
Tennessee Volunteers	baseballfield	Lindsey Nelson Stadium
Notre Dame Fighting Irish	baseballfield	Frank Eck Stadium
Florida Gators	baseballfield	Alfred A. McKethan Stadium
Ohio State Buckeyes	baseballfield	Bill Davis Stadium
Florida State Seminoles	baseballfield	Mike Martin Field at Dick Howser Stadium
Louisville Cardinals	baseballfield	Jim Patterson Stadium
Oklahoma Sooners	baseballfield	L. Dale Mitchell Baseball Park
Auburn Tigers	baseballfield	Samford Stadium – Hitchcock Field at Plainsman Park
Washington Huskies	baseballfield	Husky Ballpark
Purdue Boilermakers	baseballfield	Alexander Field
Georgia Southern Eagles	baseballfield	J.I. Clements Stadium
Alabama Crimson Tide	baseballfield	Sewell–Thomas Stadium
Illinois Fighting Illini	baseballfield	Illinois Field
Houston Cougars	baseballfield	Cougar Field
Ole Miss Rebels	baseballfield	Swayze Field
Memphis Tigers	baseballfield	FedExPark
Vanderbilt Commodores	baseballfield	Hawkins Field
Michigan Wolverines	baseballfield	Ray Fisher Stadium
Oregon Ducks	baseballfield	PK Park
Missouri Tigers	baseballfield	Taylor Stadium
Duke Blue Devils	baseballfield	Jack Coombs Field
Gonzaga Bulldogs	baseballfield	Washington Trust Field and Patterson Baseball Complex
Boston College Eagles	baseballfield	Eddie Pellagrini Diamond at John Shea Field
Cornell Big Red	baseballfield	Hoy Field
Pittsburgh Panthers	baseballfield	Charles L. Cost Field
Kentucky Wildcats	baseballfield	Cliff Hagan Stadium
Dartmouth Big Green	baseballfield	Red Rolfe Field at Biondi Park
Texas Longhorns	baseballfield	Disch-Falk Field
Tulane Green Wave	baseballfield	Greer Field at Turchin Stadium
Kansas Jayhawks	baseballfield	Hoglund Ballpark
Kansas State Wildcats	baseballfield	Tointon Family Stadium
UCLA Bruins	baseballfield	Jackie Robinson Stadium
Indiana Hoosiers	baseballfield	Bart Kaufman Field
Arizona Wildcats	baseballfield	Hi Corbett Field
West Virginia Mountaineers	baseballfield	Monongalia County Ballpark
Washington State Cougars	baseballfield	Bailey-Brayton Field
Virginia Cavaliers	baseballfield	Davenport Field
Georgetown Hoyas	baseballfield	Shirley Povich Field
Stanford Cardinal	baseballfield	Klein Field at Sunken Diamond
Michigan State Spartans	baseballfield	John H. Kobs Field
Iowa Hawkeyes	baseballfield	Duane Banks Field
Baylor Bears and Lady Bears	baseballfield	Baylor Ballpark
Oklahoma State Cowboys and Cowgirls	baseballfield	Allie P. Reynolds Stadium
Texas Tech Red Raiders and Lady Raiders	baseballfield	Dan Law Field at Rip Griffin Park
Creighton Bluejays	baseballfield	TD Ameritrade Park Omaha
Little Rock Trojans	baseballfield	Gary Hogan Field
Oregon State Beavers	baseballfield	Goss Stadium at Coleman Field
California Golden Bears	baseballfield	Evans Diamond
Georgia Bulldogs and Lady Bulldogs	baseballfield	Foley Field
UC Irvine Anteaters	baseballfield	Anteater Ballpark
Virginia Tech Hokies	baseballfield	English Field
Seattle Redhawks	baseballfield	Bannerwood Park
North Dakota State Bison	baseballfield	Newman Outdoor Field
George Mason Patriots	baseballfield	Spuhler Field
Arizona State Sun Devils	baseballfield	Phoenix Municipal Stadium
LSU Tigers and Lady Tigers	baseballfield	Skip Bertman Field
Yale Bulldogs	baseballfield	Yale Field
Louisiana–Lafayette Ragin' Cajuns	baseballfield	M. L. Tigue Moore Field
Illinois State Redbirds	baseballfield	Duffy Bass Field
Eastern Illinois Panthers	baseballfield	Coaches Stadium at Monier Field
Utah Utes	baseballfield	Smith's Ballpark
Penn State Nittany Lions	baseballfield	Medlar Field at Lubrano Park
Northwestern Wildcats	baseballfield	Rocky Miller Park
Texas A&M Aggies	baseballfield	Olsen Field
Fairfield Stags	baseballfield	Alumni Baseball Diamond
USC Trojans	baseballfield	Dedeaux Field
Maryland Terrapins	baseballfield	Shipley Field
Ohio Wesleyan Battling Bishops	baseballfield	Littick Field
La Salle Explorers	baseballfield	Hank DeVincent Field
South Carolina Gamecocks	baseballfield	Carolina Stadium
Columbia Lions	baseballfield	Hal Robertson Field at Phillip Satow Stadium
Georgia Tech Yellow Jackets	baseballfield	Russ Chandler Stadium
NC State Wolfpack	baseballfield	Doak Field
Clemson Tigers	baseballfield	Doug Kingsmore Stadium
Connecticut Huskies	baseballfield	J. O. Christian Field
Ball State Cardinals	baseballfield	Ball Diamond
UAB Blazers	baseballfield	Jerry D. Young Memorial Field
Mississippi State Bulldogs	baseballfield	Dudy Noble Field
North Carolina Tar Heels	baseballfield	Boshamer Stadium
Cincinnati Bearcats	baseballfield	Marge Schott Stadium
Fordham Rams	baseballfield	Jim Houlihan Park at Jack Coffey Field
Valparaiso Crusaders	baseballfield	Emory G. Bauer Field
South Alabama Jaguars	baseballfield	Eddie Stanky Field
McNeese State Cowboys and Cowgirls	baseballfield	Cowboy Diamond
Lehigh Mountain Hawks	baseballfield	Lehigh Baseball Field
Miami RedHawks	baseballfield	Stanley G. McKie Field at Joseph P. Hayden Jr. Park
Kent State Golden Flashes	baseballfield	Schoonover Stadium
BYU Cougars	baseballfield	Larry H. Miller Field
East Carolina Pirates	baseballfield	Clark-LeClair Stadium
Idaho Vandals	baseballfield	Guy Wicks Field
Wake Forest Demon Deacons	baseballfield	Gene Hooks Stadium
Rutgers Scarlet Knights	baseballfield	Bainton Field
Old Dominion Monarchs and Lady Monarchs	baseballfield	Bud Metheny Baseball Complex
Rhode Island Rams	baseballfield	Bill Beck Field
Western Michigan Broncos	baseballfield	Hyames Field
Marshall Thundering Herd	baseballfield	Appalachian Power Park
Rice Owls	baseballfield	Reckling Park
Oral Roberts Golden Eagles	baseballfield	J. L. Johnson Stadium
Miami Hurricanes	baseballfield	Mark Light Field at Alex Rodriguez Park
Eastern Michigan Eagles	baseballfield	Oestrike Stadium
Central Michigan Chippewas	baseballfield	Bill Theunissen Stadium
Toledo Rockets	baseballfield	Scott Park Baseball Complex
Bowling Green Falcons	baseballfield	Warren E. Steller Field
Oakland Golden Grizzlies	baseballfield	Oakland University Baseball Field
Butler Bulldogs	baseballfield	Bulldog Park
Campbell Fighting Camels and Lady Camels	baseballfield	Jim Perry Stadium
Florida Atlantic Owls	baseballfield	FAU Baseball Stadium
South Florida Bulls	baseballfield	USF Baseball Stadium
Seton Hall Pirates	baseballfield	Owen T. Carroll Field
St. John's Red Storm	baseballfield	Jack Kaiser Stadium
Villanova Wildcats	baseballfield	Villanova Ballpark at Plymouth
South Dakota State Jackrabbits	baseballfield	Erv Huether Field
New Mexico Lobos	baseballfield	Lobo Field
Navy Midshipmen	baseballfield	Terwilliger Brothers Field at Max Bishop Stadium
Missouri State Bears and Lady Bears	baseballfield	Hammons Field
UMBC Retrievers	baseballfield	The Baseball Factory Field at UMBC
San Francisco Dons	baseballfield	Dante Benedetti Diamond at Max Ulrich Field
Northeastern Huskies	baseballfield	Friedman Diamond
Wofford Terriers	baseballfield	Russell C. King Field
Western Illinois Leathernecks	baseballfield	Alfred D. Boyer Stadium
Richmond Spiders	baseballfield	Malcolm U. Pitt Field
Kennesaw State Owls	baseballfield	Stillwell Baseball Stadium
Stony Brook Seawolves	baseballfield	Joe Nathan Field
James Madison Dukes	baseballfield	Eagle Field at Veterans Memorial Park
UCF Knights	baseballfield	Jay Bergman Field
San Jose State Spartans	baseballfield	San Jose Municipal Stadium
Georgia State Panthers	baseballfield	Georgia State Baseball Complex
Appalachian State Mountaineers	baseballfield	Beaver Field at Jim and Bettie Smith Stadium
UC Santa Barbara Gauchos	baseballfield	Caesar Uyesaka Stadium
Bryant Bulldogs	baseballfield	Conaty Park
UNLV Rebels	baseballfield	Earl Wilson Stadium
VCU Rams	baseballfield	The Diamond
Charlotte 49ers	baseballfield	Robert & Mariam Hayes Stadium
Texas Southern Tigers	baseballfield	MacGregor Park
Saint Louis Billikens	baseballfield	Billiken Sports Center
Air Force Falcons	baseballfield	Falcon Baseball Field
Buffalo Bulls	baseballfield	Amherst Audubon Field
New Mexico State Aggies	baseballfield	Presley Askew Field
Youngstown State Penguins	baseballfield	Eastwood Field
Wright State Raiders	baseballfield	Nischwitz Stadium
UIC Flames	baseballfield	Les Miller Field
Norfolk State Spartans	baseballfield	Marty L. Miller Field
Army Black Knights	baseballfield	Johnson Stadium at Doubleday Field
Malone Pioneers	baseballfield	Thurman Munson Memorial Stadium
Trinity Tigers	baseballfield	Trinity Baseball Field
Wichita State Shockers	baseballfield	Eck Stadium
Bucknell Bison	baseballfield	Eugene B. Depew Field
NJIT Highlanders	baseballfield	Bears & Eagles Riverfront Stadium
San Diego Toreros	baseballfield	Fowler Park
West Texas A&M Buffaloes	baseballfield	Wilder Park
Northern Colorado Bears	baseballfield	Jackson Field
Texas State Bobcats	baseballfield	Bobcat Baseball Stadium
Murray State Racers	baseballfield	Reagan Field
Louisiana Tech Bulldogs and Lady Techsters	baseballfield	J. C. Love Field at Pat Patterson Park
Albany Great Danes	baseballfield	Varsity Field
Northern Illinois Huskies	baseballfield	Ralph McKinzie Field
Chico State Wildcats	baseballfield	Nettleton Stadium
College of Charleston Cougars	baseballfield	CofC Baseball Stadium at Patriot's Point
Furman Paladins	baseballfield	Latham Baseball Stadium
Davidson Wildcats	baseballfield	T. Henry Wilson, Jr. Field
Elon Phoenix	baseballfield	Walter C. Latham Park
UNC Greensboro Spartans	baseballfield	UNCG Baseball Stadium
East Tennessee State Buccaneers and Lady Buccaneers	baseballfield	Thomas Stadium
George Washington Colonials	baseballfield	Barcroft Park
William & Mary Tribe	baseballfield	Plumeri Park
Fresno State Bulldogs	baseballfield	Pete Beiden Field
Southern Jaguars and Lady Jaguars	baseballfield	Lee-Hines Field
New Orleans Privateers	baseballfield	Maestri Field at Privateer Park
California Vulcans	baseballfield	CONSOL Energy Park
Lamar Cardinals and Lady Cardinals	baseballfield	Vincent-Beck Stadium
Western Kentucky Hilltoppers and Lady Toppers	baseballfield	Nick Denes Field
UTSA Roadrunners	baseballfield	Roadrunner Field
Loyola Marymount Lions	baseballfield	George C. Page Stadium
Brown Bears	baseballfield	Murray Stadium
Southern Nazarene Crimson Storm	baseballfield	Cauld and Betty Cypert Athletic Complex
Evansville Purple Aces	baseballfield	Charles H. Braun Stadium
Houston Baptist Huskies	baseballfield	Husky Field
Bethune-Cookman Wildcats	baseballfield	Jackie Robinson Ballpark
Western Carolina Catamounts	baseballfield	Hennon Stadium
Princeton Tigers	baseballfield	Bill Clarke Field
UHV Jaguars	baseballfield	Riverside Stadium
Sam Houston State Bearkats	baseballfield	Don Sanders Stadium
Christian Brothers Buccaneers	baseballfield	Buc Field
Rider Broncs	baseballfield	Sonny Pittaro Field
Northwestern State Demons and Lady Demons	baseballfield	H. Alvin Brown–C. C. Stroud Field
IPFW Mastodons	baseballfield	Mastodon Field
Manhattan Jaspers and Lady Jaspers	baseballfield	Dutchess Stadium
Texas–Arlington Mavericks	baseballfield	Clay Gould Ballpark
UC San Diego Tritons	baseballfield	Triton Ballpark
Samford Bulldogs	baseballfield	Joe Lee Griffin Stadium
Portland Pilots	baseballfield	Joe Etzel Field
Louisiana–Monroe Warhawks	baseballfield	Warhawk Field
Emporia State Hornets	baseballfield	Trusler Sports Complex
Nevada Wolf Pack	baseballfield	William Peccole Park
West Florida Argonauts	baseballfield	Jim Spooner Field
Pepperdine Waves	baseballfield	Eddy D. Field Stadium
Eastern Kentucky Colonels and Lady Colonels	baseballfield	Turkey Hughes Field
Kutztown Golden Bears	baseballfield	North Campus Field
Marist Red Foxes	baseballfield	James J. McCann Baseball Field
Utah Valley Wolverines	baseballfield	Brent Brown Ballpark
UC Davis Aggies	baseballfield	Dobbins Baseball Complex
Central Washington Wildcats	baseballfield	CWU Baseball Field
Penn Quakers	baseballfield	Meiklejohn Stadium
Belhaven Blazers	baseballfield	Smith–Wills Stadium
Lindenwood Lions	baseballfield	Lou Brock Sports Complex
Pacific Tigers	baseballfield	Klein Family Field
Coastal Carolina Chanticleers	baseballfield	Springs Brooks Stadium
Jacksonville Dolphins	baseballfield	John Sessions Stadium
Monmouth Hawks	baseballfield	MU Baseball Field
Stetson Hatters	baseballfield	Melching Field at Conrad Park
Cal State Fullerton Titans	baseballfield	Goodwin Field
Lipscomb Bisons	baseballfield	Ken Dugan Field at Stephen Lee Marsh Stadium
Liberty Flames and Lady Flames	baseballfield	Liberty Baseball Stadium
Washington and Lee Generals	baseballfield	Cap'n Dick Smith Field
Gardner–Webb Runnin' Bulldogs	baseballfield	John Henry Moss Stadium
Washington & Jefferson Presidents	baseballfield	Ross Memorial Park and Alexandre Stadium
Middle Tennessee Blue Raiders	baseballfield	Reese Smith Jr. Field
Hofstra Pride	baseballfield	University Field
Southeast Missouri State Redhawks	baseballfield	Capaha Field
Stephen F. Austin Lumberjacks and Ladyjacks	baseballfield	Jaycees Field
Sacramento State Hornets	baseballfield	John Smith Field
Sacred Heart Pioneers	baseballfield	Pioneer Park
Sacred Heart Pioneers	baseballfield	The Ballpark at Harbor Yard
Presbyterian Blue Hose	baseballfield	Presbyterian Baseball Complex
North Carolina Central Eagles	baseballfield	Durham Athletic Park
Nicholls State Colonels	baseballfield	Ray E. Didier Field
Morehead State Eagles	baseballfield	Allen Field
Jacksonville State Gamecocks	baseballfield	Rudy Abbott Field
Holy Cross Crusaders	baseballfield	Fitton Field
Delaware State Hornets	baseballfield	Soldier Field
Central Arkansas Bears and Sugar Bears	baseballfield	Bear Stadium
Wagner Seahawks	baseballfield	Richmond County Bank Ballpark
Radford Highlanders	baseballfield	Radford Baseball Stadium
Mercer Bears	baseballfield	Claude Smith Field
North Florida Ospreys	baseballfield	Harmon Stadium
Xavier Musketeers	baseballfield	J. Page Hayden Field
Canisius Golden Griffins	baseballfield	Demske Sports Complex
Long Beach State 49ers	baseballfield	Blair Field
North Greenville Crusaders	baseballfield	Ashmore Field
Quinnipiac Bobcats	baseballfield	Quinnipiac Baseball Field
Santa Clara Broncos	baseballfield	Stephen Schott Stadium
Siena Saints	baseballfield	Siena Baseball Field
Western Washington Vikings	baseballfield	Viking Field
RIT Tigers	baseballfield	RIT Baseball Field
Loyola Wolfpack	baseballfield	Segnette Field
Cal State Northridge Matadors	baseballfield	Matador Field
Abilene Christian Wildcats	baseballfield	Crutcher Scott Field
Hartford Hawks	baseballfield	Fiondella Field
UC Riverside Highlanders	baseballfield	Riverside Sports Complex
Saint Mary's Gaels	baseballfield	Louis Guisto Field
Winthrop Eagles	baseballfield	Winthrop Ballpark
Charleston Southern Buccaneers	baseballfield	Buccaneer Ballpark
Coppin State Eagles	baseballfield	Joe Cannon Stadium
SIU Edwardsville Cougars	baseballfield	Roy E. Lee Field at Simmons Baseball Complex
UNC Wilmington Seahawks	baseballfield	Brooks Field
UNC Asheville Bulldogs	baseballfield	Greenwood Baseball Field
High Point Panthers	baseballfield	George S. Erath Field at Coy O. Williard Baseball Stadium
Angelo State Rams	baseballfield	Foster Field
American International Yellow Jackets	baseballfield	Richard F. Bedard Field
Bentley Falcons	baseballfield	Robert DeFelice Baseball Field
Charleston Golden Eagles	baseballfield	Triana Field
Charleston Golden Eagles	baseballfield	Appalachian Power Park
Concordia Golden Bears	baseballfield	Robert E. Barnes Field
Dixie State Trailblazers	baseballfield	Bruce Hurst Field
Incarnate Word Cardinals	baseballfield	Sullivan Field
Indianapolis Greyhounds	baseballfield	Greyhound Park
Mary Marauders	baseballfield	Bismarck Municipal Ballpark
Mercyhurst Lakers	baseballfield	Mercyhurst Baseball Field
Northern State Wolves	baseballfield	Fossum Field
Ouachita Baptist Tigers	baseballfield	Rab Rodgers Field
St. Augustine's Falcons	baseballfield	USA Baseball National Training Complex
Mount St. Mary's Mountaineers	baseballfield	Straw Family Stadium
North Carolina A&T Aggies	baseballfield	World War Memorial Stadium
St. Cloud State Huskies	baseballfield	Joe Faber Field
Grand Canyon Antelopes	baseballfield	Brazell Stadium
Northern Kentucky Norse	baseballfield	Bill Aker Baseball Complex
Davenport Panthers	baseballfield	East Kentwood High School
Texas A&M–Kingsville Javelinas	baseballfield	Nolan Ryan Field
Azusa Pacific Cougars	baseballfield	Cougar Baseball Field
West Georgia Wolves	baseballfield	Cole FIeld
Virginia State Trojans	baseballfield	Whaley Colbert Field
Upper Iowa Peacocks	baseballfield	Robertson Woods Field
St. Bonaventure Bonnies	baseballfield	Fred Handler Park
FIU Panthers	baseballfield	FIU Baseball Stadium
Cal State San Bernardino Coyotes	baseballfield	Fiscalini Field
Florida Gulf Coast Eagles	baseballfield	Swanson Stadium
Longwood Lancers	baseballfield	Bolding Stadium
Coast Guard Bears	baseballfield	Nitchman Field
Dayton Flyers	baseballfield	Woerner Field
Hampden–Sydney Tigers	baseballfield	Ty Cobb Ballpark
VMI Keydets	baseballfield	Gray–Minor Stadium
Milwaukee Panthers	baseballfield	Henry Aaron Field
Belmont Bruins	baseballfield	E. S. Rose Park
Niagara Purple Eagles	baseballfield	John P. Bobo Field
Saint Peter's Peacocks and Peahens	baseballfield	Joseph J. Jaroschak Field
Oklahoma Baptist Bison	baseballfield	Bison Field
Texas–Pan American Broncs	baseballfield	Edinburg Stadium
USC Upstate Spartans	baseballfield	Cleveland S. Harley Baseball Park
Fairleigh Dickinson Knights	baseballfield	Naimoli Family Baseball Complex
Dallas Baptist Patriots	baseballfield	Horner Ballpark
UT Martin Skyhawks	baseballfield	Skyhawk Park
Christopher Newport Captains	baseballfield	Captains Park
Central Connecticut Blue Devils	baseballfield	Central Connecticut State Baseball Field
Florida Tech Panthers	baseballfield	Andy Seminick-Les Hall Field
Texas A&M–Corpus Christi Islanders	baseballfield	Chapman Field
Texas A&M–Corpus Christi Islanders	baseballfield	Whataburger Field
Maryland Eastern Shore Hawks	baseballfield	Hawk Stadium
LIU Brooklyn Blackbirds	baseballfield	Long Island University Field
The Citadel Bulldogs	baseballfield	Joseph P. Riley, Jr. Park
St. Norbert Green Knights	baseballfield	Mel Nicks Sports Complex
Cal State Dominguez Hills Toros	baseballfield	Toro Field
Cal State Los Angeles Golden Eagles	baseballfield	Reeder Field
Colorado Mesa Mavericks	baseballfield	Sam Suplizio Field
Cal Poly Mustangs	baseballfield	Robin Baggett Stadium
Prairie View A&M Panthers and Lady Panthers	baseballfield	Tankersley Field
Mississippi Valley State Delta Devils and Devilettes	baseballfield	Magnolia Field
Lourdes Gray Wolves	baseballfield	Central Catholic Baseball Complex
Centenary Gentlemen and Ladies	baseballfield	Shehee Stadium
CSU–Pueblo ThunderWolves	baseballfield	Rawlings Field
Fredonia Blue Devils	baseballfield	Ludwig Field
Arkansas–Monticello Boll Weevils and Cotton Blossoms	baseballfield	Weevils Field
Virginia–Wise Highland Cavaliers	baseballfield	Burchell Stallard Field
Lubbock Christian Chaparrals and Lady Chaps	baseballfield	Hays Field
Southeastern Oklahoma State Savage Storm	baseballfield	The Ballpark in Durant
Missouri Southern Lions	baseballfield	Joe Becker Stadium
UMass Lowell River Hawks	baseballfield	Edward A. LeLacheur Park
Hawaii Pacific Sharks	baseballfield	Hans L'Orange Field
Northwestern Oklahoma State Rangers	baseballfield	Myers Stadium
Eckerd Tritons	baseballfield	Turley Athletic Complex
WPI Engineers	baseballfield	New England Baseball Complex
Bates Bobcats	baseballfield	Campus of Bates College
LSU–Alexandria Generals	baseballfield	Softball Complex
Alabama State Hornets and Lady Hornets	baseballfield	Wheeler-Watkins Baseball Complex
Alcorn State Braves and Lady Braves	baseballfield	Foster Baseball Field at McGowan Stadium
Austin Peay Governors and Lady Govs	baseballfield	Raymond C. Hand Park
Tennessee Tech Golden Eagles	baseballfield	Bush Stadium at Averitt Express Baseball Complex
Merchant Marine Mariners	baseballfield	Lower Roosevelt Field
Mount Olive Trojans	baseballfield	scarborough
Augusta Jaguars	baseballfield	Jaguar Field
Augusta Jaguars	baseballfield	Lake Olmstead Stadium
Southeastern Louisiana Lions and Lady Lions	baseballfield	Pat Kenelly Diamond at Alumni Field
Montana State Billings Yellowjackets	baseballfield	Dehler Park
Tarleton State Texans and TexAnns	baseballfield	Cecil Ballow Baseball Complex
Northeast Mississippi Community College Tigers	baseballfield	Harold T. White Field
Arkansas–Pine Bluff Golden Lions and Golden Lady Lions	baseballfield	Torii Hunter Baseball Complex
Itawamba Community College Indians	baseballfield	Roy Cresap Field
Delta State Statesmen and Lady Statesmen	baseballfield	Ferriss Field
Texas–Rio Grande Valley Vaqueros	baseballfield	Edinburg Stadium
Troy Trojans	baseballfield	Riddle-Pace Field
Hawaii Rainbow Warriors and Rainbow Wahine	baseballfield	Les Murakami Stadium
