Methicillin-resistant Staphylococcus aureus	binomial	Staphylococcus aureus
Asafoetida	binomial	Ferula assa-foetida
Domesticated turkey	binomial	Meleagris gallopavo
Ugli fruit	binomial	Citrus reticulata × Citrus paradisi
Edible frog	binomial	Pelophylax kl. esculentus
Jerusalem artichoke	binomial	Helianthus tuberosus
Lactococcus lactis	binomial	Lactococcus lactisBacterial small RNA
Tussilago	binomial	Tussilago farfara
Stratiotes	binomial	Stratiotes aloides
Feral pig	binomial	Sus scrofa
Bergamot orange	binomial	Citrus bergamia
Spondianthus	binomial	Spondianthus preussii
Celianella	binomial	Celianella montana
Colobocarpos	binomial	Colobocarpos nanus
Elateriospermum	binomial	Elateriospermum tapos
Paranecepsia	binomial	Paranecepsia alchorneifolia
Philyra	binomial	Philyra brasiliensis
Sumbaviopsis	binomial	Sumbaviopsis albicans
Cephalocrotonopsis	binomial	Cephalocrotonopsis socotranus
Astrococcus	binomial	Astrococcus coriaceus
Botryophora	binomial	Botryophora geniculata
Podadenia	binomial	Podadenia sapida
Droceloncia	binomial	Droceloncia rigidifolia
Klaineanthus	binomial	*Klaineanthus gaboniae
Manniophyton	binomial	Manniophyton fulvum
Strophioblachia	binomial	Strophioblachia fimbricalyx
Hylandia	binomial	Hylandia dockrillii
Cladogelonium	binomial	Cladogelonium madagascariense
Micrandropsis	binomial	Micrandropsis scleroxylon
Myricanthe	binomial	Myricanthe discolor
Ricinodendron	binomial	Ricinodendron heudelotii
Anomostachys	binomial	Anomostachys lastellei
Conosapium	binomial	Conosapium madagascariense
Pseudosenefeldera	binomial	Pseudosenefeldera inclinata
Spegazziniophytum	binomial	*Spegazziniophytum patagonicum
Whyanbeelia	binomial	Whyanbeelia terrae-reginae
Podocalyx	binomial	Podocalyx loranthoides
Didymocistus	binomial	Didymocistus chrysadenius
Keayodendron	binomial	Keayodendron bridelioides
Pseudolachnostylis	binomial	Pseudolachnostylis maprouneifolia
Microcalamus	binomial	Microcalamus barbinodis
Apoclada	binomial	Apoclada simplex
Ferrocalamus	binomial	Ferrocalamus strictus
Pseudostachyum	binomial	Pseudostachyum polymorphum
Hitchcockella	binomial	Hitchcockella baronii
Temburongia	binomial	Temburongia simplex
Masdevallia teaguei	binomial	Masdevallia teaguei Luer
Acidimicrobium	binomial	Acidimicrobium ferrooxidans
Lanaria	binomial	Lanaria lanata
Cytauxzoonosis	binomial	Cytauxzoon felis
Choristotanyderus	binomial	Choristotanyderus nanus †
Scissortail rasbora	binomial	Rasbora caudimaculata '''
Scissortail rasbora	binomial	(Volz, 1903)
Scissortail rasbora	binomial	'''\nRasbora spilocerca
Scissortail rasbora	binomial	(Rainboth and Kottelat, 1987)
Scissortail rasbora	binomial	Rasbora trilineata
Scissortail rasbora	binomial	(Steindachner, 1870)
Humeocline	binomial	Humeocline madagascariensis
Philesia	binomial	Philesia magellanica (J.F.Gmel. 1791)
Rhynchospermum	binomial	Rhynchospermum verticillatum
Rhinoceros iguana	binomial	Cyclura cornuta\n*C. c. onchiopsis, Navassa Island iguana\n*C. c. stejnegeri, Mona Island iguana
American gizzard shad	binomial	Dorosoma cepedianum
Methanospirillaceae	binomial	Methanomicrobiales
Nalacetus	binomial	Nalacetus ratimitus
Gandakasia	binomial	Gandakasia potens
Diaporthe phaseolorum var. phaseolorum	binomial	Diaporthe phaseolorum
Puerto Rican long-nosed bat	binomial	Monophyllus plethodon
Diaporthe phaseolorum var. sojae	binomial	Diaporthe phaseolorum
Rufous-tailed foliage-gleaner	binomial	Anabacerthia ruficaudatum
Indian palm squirrel	binomial	Funambulus palmarum
Aubregrinia	binomial	Aubregrinia taiensis
Autranella	binomial	Autranella congolensis
Bafodeya	binomial	Bafodeya benna
Breviea	binomial	Breviea sericea
Northia	binomial	Northia seychellana
Dimeresia	binomial	Dimeresia howellii
Swallenia	binomial	Swallenia alexandrae
Plasmodium falciparum biology	binomial	Plasmodium falciparum
Gibbaria	binomial	Gibbaria scabra
Cacaliopsis	binomial	Cacaliopsis nardosmia
Hecastocleis	binomial	Hecastocleis shockleyi
Lapland ringlet	binomial	Erebia embla
Lamprocephalus	binomial	Lamprocephalus montanus
Shafera	binomial	Shafera platyphylla
Acrisione	binomial	Acrisione denticulata
Chloracantha	binomial	Chloracantha spinosa
Showa	binomial	Cyprinus carpio
Macheirocera grandis	binomial	Macheirocera grandis\nCamillo Róndani, 1869
Phaenocoma	binomial	Phaenocoma prolifera
Elaeodendron australe	binomial	Elaeodendron australe Vent.
Amalocalyx	binomial	Amalocalyx microlobus
Ratzeburgia	binomial	Ratzeburgia pulcherrima
Chaetopogon	binomial	Chaetopogon fasciculatus
Ceruana	binomial	Ceruana pratensis
Canadanthus	binomial	Canadanthus modestus
Crinitaria	binomial	Crinitaria pontica
Chrysoma	binomial	Chrysoma pauciflosculosa
Cuniculotinus	binomial	Cuniculotinus gramineus
Damnamenia	binomial	Damnamenia vernicosa
Sheareria	binomial	Sheareria nana
Amolinia	binomial	Amolinia heydeana
Bishopiella	binomial	Bishopiella elegans
Bahianthus	binomial	Bahianthus viscosus
Blakeanthus	binomial	Blakeanthus cordatus
Ciceronia	binomial	Ciceronia chaptalioides
Chacoa	binomial	Chacoa pseudoprasiifolia
Corethamnium	binomial	Corethamnium chocoensis
Cronquistia	binomial	Cronquistia pringlei
Dissothrix	binomial	Dissothrix imbricata
Eupatoriopsis	binomial	Eupatoriopsis hoffmanniana
Erythradenia	binomial	Erythradenia pyramidalis
Gardnerina	binomial	Gardnerina angustata
Goyazianthus	binomial	Goyazianthus tetrastichus
Gymnocondylus	binomial	Gymnocondylus galeopsifolius
Leptoclinium	binomial	Leptoclinium trichotomum
Mexianthus	binomial	Mexianthus mexicanus
Monogereion	binomial	Monogereion carajensis
Metastevia	binomial	Metastevia hintonii
Lorentzianthus	binomial	Lorentzianthus viscidus
Nesomia	binomial	Nesomia chiapensis
Parapiqueria	binomial	Parapiqueria cavalcantei
Matudina	binomial	Matudina corvi
Neohintonia	binomial	Neohintonia monantha
Nothobaccharis	binomial	Nothobaccharis candolleana
Pachythamnus	binomial	Pachythamnus crassirameus
Oaxacania	binomial	Oaxacania malvaefolia
Piqueriella	binomial	Piqueriella brasiliensis
Sartorina	binomial	Sartorina schultzii
Piqueriopsis	binomial	Piqueriopsis michoacana
Santosia	binomial	Santosia talmonii
Scherya	binomial	Scherya bahiensis
Praxeliopsis	binomial	Praxeliopsis mattogrossensis
Prolobus	binomial	Prolobus nitidulus
Revealia	binomial	Revealia macrocephala
Siapaea	binomial	Siapaea liesneri
Semiria	binomial	Semiria viscosa
Standleyanthus	binomial	Standleyanthus triptychus
Platypodanthera	binomial	Platypodanthera melissifolia
Polyanthina	binomial	Polyanthina nemorosa
Teixeiranthus	binomial	Teixeiranthus foliosus
Sphaereupatorium	binomial	Sphaereupatorium scandens
Alatoseta	binomial	Alatoseta tenuis
Arrowsmithia	binomial	Arrowsmithia styphelioides
Atrichantha	binomial	Atrichantha gemmifera
Artemisiopsis	binomial	Artemisiopsis villosa
Hydroidea	binomial	Hydroidea elsiae
Langebergia	binomial	Langebergia canescens
Denekia	binomial	Denekia capensis
Helichrysopsis	binomial	Helichrysopsis septentrionalis
Oreoleysera	binomial	Oreoleysera montana
Nestlera	binomial	Nestlera biennis
Oxylaena	binomial	Oxylaena acicularis
Tenrhynea	binomial	Tenrhynea phylicifolia
Petalacte	binomial	Petalacte coronata
Oligothrix	binomial	Oligothrix gracilis
Traversia	binomial	Traversia baccharoides
Ligulariopsis	binomial	Ligulariopsis shichuana
Pojarkovia	binomial	Pojarkovia pojarkovae
Phaneroglossa	binomial	Phaneroglossa bolusii
Harnackia	binomial	Harnackia bisecta
Lescaillea	binomial	Lescaillea equisetiformis
Leucactinia	binomial	Leucactinia bracteata
Strotheria	binomial	Strotheria gypsophila
Boeberoides	binomial	Boeberoides grandiflora
Western tailed-blue	binomial	Cupido amyntula
Pellaea falcata	binomial	Pellaea falcata (R.Br. Fée)
Sclerodactylon	binomial	Sclerodactylon macrostachyum
Trilobachne	binomial	Trilobachne cookei
Taeniatherum	binomial	Taeniatherum caput-medusae
Dichaetaria	binomial	Dichaetaria wightii
Oryzidium	binomial	Oryzidium barnardii
Gilgiochloa	binomial	Gilgiochloa indurata
Leptocarydion	binomial	Leptocarydion vulpiastrum
Achyropappus	binomial	Achyropappus anthemoides
Adenoon	binomial	Adenoon indicum
Albertinia	binomial	Albertinia brasiliensis
Ajaniopsis	binomial	Ajaniopsis penicilliformis
Ameghinoa	binomial	Ameghinoa patagonica
Allopterigeron	binomial	Allopterigeron filifolius
Amblyocarpum	binomial	Amblyocarpum inuloides
Tamananthus	binomial	Tamananthus crinitus
Telmatophila	binomial	Telmatophila scolymastrum
Tetraperone	binomial	Tetraperone bellioides
Thiseltonia	binomial	Thiseltonia gracillima
Trichocoryne	binomial	Trichocoryne connata
Triplocephalum	binomial	Triplocephalum holstii
Tyrimnus	binomial	Tyrimnus leucographus
Trichospira	binomial	Trichospira verticillata
Evacidium	binomial	Evacidium discolor
Exomiocarpon	binomial	Exomiocarpon madagascariense
Espejoa	binomial	Espejoa mexicana
Epitriche	binomial	Epitriche demissus
Eriachaenium	binomial	Eriachaenium magellanicum
Endocellion	binomial	Endocellion glaciale
Ekmania	binomial	Ekmania lepidota
Decazesia	binomial	Decazesia hecatocephala
Decastylocarpus	binomial	Decastylocarpus perrieri
Dacryotrichia	binomial	Dacryotrichia robinsonii
Delamerea	binomial	Delamerea procumbens
Daveaua	binomial	Daveaua anthemoides
Damnxanthodium	binomial	Damnxanthodium calvum
Dicercoclados	binomial	Dicercoclados triplinervis
Dicranocarpus	binomial	Dicranocarpus parviflorus
Diaphractanthus	binomial	Diaphractanthus bomolepis
Dichaetophora	binomial	Dichaetophora campestris
Dimorphocoma	binomial	Dimorphocoma minutula
Dipterocome	binomial	Dipterocome pusilla
Dipterocypsela	binomial	Dipterocypsela succulenta
Diodontium	binomial	Diodontium filifolium
Dymondia	binomial	Dymondia margaretae
Dugesia	binomial	Dugesia mexicana
Dolichlasium	binomial	Dolichlasium lagascae
Duseniella	binomial	Duseniella patagonica
Fenixia	binomial	Fenixia pauciflora
Faxonia	binomial	Faxonia pusilla
Feddea	binomial	Feddea cubensis
Flosmutisia	binomial	Flosmutisia paramicola
Formania	binomial	Formania mekongensis
Gladiopappus	binomial	Gladiopappus vernonioides
Geissolepis	binomial	Geissolepis suaedifolia
Gilruthia	binomial	Gilruthia osbornii
Gilberta	binomial	Gilberta tenuifolia
Gamochaetopsis	binomial	Gamochaetopsis alpina
Gorceixia	binomial	Gorceixia decurrens
Goldmanella	binomial	Goldmanella sarmentosa
Geropogon	binomial	Geropogon hybridus
Glossopappus	binomial	Glossopappus macrotus
Grangeopsis	binomial	Grangeopsis perrieri
Goniocaulon	binomial	Goniocaulon indicum
Gratwickia	binomial	Gratwickia monochaeta
Greenmaniella	binomial	Greenmaniella resinosa
Gypothamnium	binomial	Gypothamnium pinifolium
Gyrodoma	binomial	Gyrodoma hispida
Handelia	binomial	Handelia trichophylla
Harleya	binomial	Harleya oxylepis
Heteracia	binomial	Heteracia szovitsii
Hilliardia	binomial	Hilliardia zuurbergensis
Huarpea	binomial	Huarpea andina
Hispidella	binomial	Hispidella hispanica
Hyalochaete	binomial	Hyalochaete modesta
Hyalochlamys	binomial	Hyalochlamys globifera
Hymenostemma	binomial	Hymenostemma pseudanthemis
Hystrichophora	binomial	Hystrichophora macrophylla
Ugamia	binomial	Ugamia angrenica
Urmenetea	binomial	Urmenetea atacamensis
Vernoniopsis	binomial	Vernoniopsis caudata
Vigethia	binomial	Vigethia mexicana
Welwitschiella	binomial	Welwitschiella neriifolia
Warionia	binomial	Warionia saharae
Vieraea	binomial	Vieraea laevigata
Xanthopappus	binomial	Xanthopappus subacaulis
Schischkinia	binomial	Schischkinia albispina
Selleophytum	binomial	Selleophytum buchii
Sinoleontopodium	binomial	Sinoleontopodium lingianum
Schmalhausenia	binomial	Schmalhausenia nidulans
Soaresia	binomial	Soaresia velutina
Schlechtendalia	binomial	Schlechtendalia luzulifolia
Iodocephalus	binomial	Iodocephalus gracilis
Iogeton	binomial	Iogeton nowickeanus
Ixiolaena	binomial	Ixiolaena viscosa
Jacmaia	binomial	Jacmaia incana
Karvandarina	binomial	Karvandarina aphylla
Karelinia	binomial	Karelinia caspia
Koehneola	binomial	Koehneola repens
Kippistia	binomial	Kippistia suaedifolia
Lepidolopsis	binomial	Lepidolopsis turkestanica
Marshalljohnstonia	binomial	Marshalljohnstonia gypsophila
Msuata	binomial	Msuata buettneri
Myripnois	binomial	Myripnois dioica
Nanothamnus	binomial	Nanothamnus sericeus
Nananthea	binomial	Nananthea perpusilla
Neblinaea	binomial	Neblinaea promontoriorum
Mexerion	binomial	Mexerion mexicanum
Macrachaenium	binomial	Macrachaenium gracile
Neopallasia	binomial	Neopallasia pectinata
Lamyropappus	binomial	Lamyropappus schakaptaricum
Lulia	binomial	Lulia nervosa
Lycapsus	binomial	Lycapsus tenuifolius
Lordhowea	binomial	Lordhowea insularis
Lonas	binomial	Lonas annua
Lipskyella	binomial	Lipskyella annua
Lifago	binomial	Lifago dielsii
Lepidophyllum	binomial	Lepidophyllum cupressiforme
Lepidophorum	binomial	Lepidophorum repandum
Leunisia	binomial	Leunisia laeta
Neotysonia	binomial	Neotysonia phyllostegia
Neurolakis	binomial	Neurolakis modesta
Neojeffreya	binomial	Neojeffreya decurrens
Nikitinia	binomial	Nikitinia leptoclada
Narvalina	binomial	Narvalina domingensis
Novenia	binomial	Novenia acaulis
Ochrocephala	binomial	Ochrocephala imatongensis
Omphalopappus	binomial	Omphalopappus newtonii
Ondetia	binomial	Ondetia linearis
Oxyphyllum	binomial	Oxyphyllum ulicinum
Oxycarpha	binomial	Oxycarpha suaedifolia
Staurochlamys	binomial	Staurochlamys burchellii
Otospermum	binomial	Otospermum glabrum
Oxypappus	binomial	Oxypappus scaber
Stephanodoria	binomial	Stephanodoria tomentella
Stilpnogyne	binomial	Stilpnogyne bellioides
Symphyllocarpus	binomial	Symphyllocarpus exilis
Stilpnolepis	binomial	Stilpnolepis centiflora
Quinetia	binomial	Quinetia urvillei
Syncephalum	binomial	Syncephalum arbutifolium
Synedrellopsis	binomial	Synedrellopsis grisebachii
Quinqueremulus	binomial	Quinqueremulus linearis
Spiroseris	binomial	Spiroseris phyllocephala
Squamopappus	binomial	Squamopappus skutchii
Rensonia	binomial	Rensonia salvadorica
Rhodogeron	binomial	Rhodogeron coronopifolius
Rojasianthe	binomial	Rojasianthe superba
Rothmaleria	binomial	Rothmaleria granatensis
Russowia	binomial	Russowia sogdiana
Paleaepappus	binomial	Paleaepappus patagonicus
Parantennaria	binomial	Parantennaria uniceps
Pelucha	binomial	Pelucha trifida
Pechuel-loeschea	binomial	Pechuel-loeschea leubnitziae
Pacourina	binomial	Pacourina edulis
Perymeniopsis	binomial	Perymeniopsis ovalifolia
Phacellothrix	binomial	Phacellothrix cladochaeta
Piora	binomial	Piora ericoides
Pithecoseris	binomial	Pithecoseris pacourinoides
Pippenalia	binomial	Pippenalia delphiniifolia
Plagiobasis	binomial	Plagiobasis centuroides
Pleuropappus	binomial	Pleuropappus phyllocalymmeus
Prolongoa	binomial	Prolongoa hispanica
Polycalymma	binomial	Polycalymma stuartii
Proteopsis	binomial	Proteopsis argentea
Pseudelephantopus	binomial	Pseudelephantopus spicatus
Pseudostifftia	binomial	Pseudostifftia kingii
Pseudohandelia	binomial	Pseudohandelia umbellifera
Pterygopappus	binomial	Pterygopappus lawrencii
Berardia	binomial	Berardia subacaulis
Blakiella	binomial	Blakiella bartsiifolia
Burkartia	binomial	Burkartia lanigera
Cancriniella	binomial	Cancriniella krascheninnikovii
Cephalipterum	binomial	Cephalipterum drummondii
Cephalosorus	binomial	Cephalosorus carpesioides
Chaetymenia	binomial	Chaetymenia peduncularis
Chardinia	binomial	Chardinia orientalis
Chromolepis	binomial	Chromolepis heterophylla
Chronopappus	binomial	Chronopappus bifrons
Colobanthera	binomial	Colobanthera waterlotii
Cladochaeta	binomial	Cladochaeta candidissima
Cousiniopsis	binomial	Cousiniopsis atractyloides
Coulterella	binomial	Coulterella capitata
Coleocoma	binomial	Coleocoma centaurea
Cuspidia	binomial	Cuspidia cernua
Apostates	binomial	Apostates rapae
Arctogeron	binomial	Arctogeron gramineum
Arbelaezaster	binomial	Arbelaezaster ellsworthii
Austrosynotis	binomial	Austrosynotis rectirama
Avellara	binomial	Avellara fistulosa
Aposeris	binomial	Aposeris foetida
Aylacophora	binomial	Aylacophora deserticola
Lindera aggregata	binomial	Lindera aggregata  Kosterm.
Bongardia	binomial	Bongardia chrysogonum
Pellaea atropurpurea	binomial	Pellaea atropurpurea (L. Link)
Pellaea glabella	binomial	Pellaea glabella (Mett. ex Kuhn)
Neogardneria	binomial	Neogardneria murrayana
Neogyna	binomial	Neogyna gardneriana
Maytenus silvestris	binomial	Maytenus silvestris, (Lander & L.A.S.Johnson)
Syncarpia hillii	binomial	Syncarpia hillii (F.M.Bailey)
Sequoia	binomial	Sequoia sempervirens
Attockicetus	binomial	Attockicetus praecursor
University of Maryland Arboretum & Botanical Garden	binomial	Acer griseum
Pellaea nana	binomial	Pellaea nana ( Bostock )
Geocarpon	binomial	Geocarpon minimum
Pellaea paradoxa	binomial	Pellaea paradoxa ( Hook. )
Magnolia montana	binomial	Magnolia montana ( Figlar)
Pimpinella major	binomial	Pimpinella major Huds.
Apis mellifera anatoliaca	binomial	Apis mellifera
Rhodesian giraffe	binomial	Giraffa tippelskirchi
Ōgonkan	binomial	Citrus flaviculpus (hort. ex. Tanaka)
Picralima	binomial	Picralima nitida
Lysicarpus	binomial	Lysicarpus angustifolius
Dehalogenimonas lykanthroporepellens	binomial	Dehalogenimonas lykanthroporepellans
Brocadia fulgida	binomial	Candidatus Brocadia fulgida
Pimpinella cypria	binomial	Pimpinella cypria Boiss.
Kochummenia	binomial	Kochummenia stenopetala
Atherigona reversura	binomial	Atherigona reversura
Dielsia	binomial	Dielsia stenostachya
Calocrater	binomial	Calocrater preussii
Corsiopsis	binomial	Corsiopsis chinensis
Corynanthera	binomial	Corynanthera flava
Mitrantia	binomial	Mitrantia bilocularis
Myrtastrum	binomial	Myrtastrum rufopunctatum
Welchiodendron	binomial	Welchiodendron longivalve
Whiteodendron	binomial	Whiteodendron moultonianum
Monocostus	binomial	Monocostus uniflorus
Coleocarya	binomial	Coleocarya gracilis
Winifredia	binomial	Winifredia sola
Patosia	binomial	Patosia clandestina
Afrolicania	binomial	Afrolicania elaeosperma
Neocarya	binomial	Neocarya macrophylla
Appertiella	binomial	Appertiella hexandra
Guacamaya	binomial	Guacamaya superba
Marahuacaea	binomial	Marahuacaea schomburgkii
Phelpsiella	binomial	Phelpsiella ptericaulis
Potarophytum	binomial	Potarophytum riparium
Diploon	binomial	Diploon cuspidatum
Amorphospermum	binomial	Amorphospermum antilogum
Tsebona	binomial	Tsebona macrantha
Van-royena	binomial	Van-royena castanosperma
Ixianthes	binomial	Ixianthes retzioides
Retzia	binomial	Retzia capensis
Thesmophora	binomial	Thesmophora scopulosa
Comaclinium	binomial	Comaclinium montanum
Dielitzia	binomial	Dielitzia tysonii
Endopappus	binomial	Endopappus macrocarpus
Feldstonia	binomial	Feldstonia nitens
Fitzwillia	binomial	Fitzwillia axilliflora
Lemooria	binomial	Lemooria burkittii
Tietkensia	binomial	Tietkensia corrickiae
Polychrysum	binomial	Polychrysum tadshikorum
Schizoptera	binomial	Schizoptera peduncularis
Taplinia	binomial	Taplinia saxatilis
Tuberculocarpus	binomial	Tuberculocarpus ruber
Chorisiva	binomial	Chorisiva nevadensis
Gnomophalium	binomial	Gnomophalium pulvinatum
Aspen trunk rot	binomial	Phellinus tremulae
Tomentaurum	binomial	Tomentaurum niveum
Pleocarphus	binomial	Pleocarphus revolutus
Guynesomia	binomial	Guynesomia scoparia
Ianthopappus	binomial	Ianthopappus corymbosus
Criscia	binomial	Criscia stricta
Gymnopentzia	binomial	Gymnopentzia bifurcata
Rhinactinidia	binomial	Rhinactinidia limoniifolia
Takhtajaniantha	binomial	Takhtajaniantha pusilla
Pterachaenia	binomial	Pterachaenia stewartii
Elachanthemum	binomial	Elachanthemum intricatum
Parasyncalathium	binomial	Parasyncalathium souliei
Villasenoria	binomial	Villasenoria orcuttii
Inuloides	binomial	Inuloides tomentosa
Zyzura	binomial	Zyzyura mayana
Misbrookea	binomial	Misbrookea strigosissima
Phitosia	binomial	Phitosia crocifolia
Liabellum	binomial	Liabellum hintoniorum
Holoschkuhria	binomial	Holoschkuhria tetramera
Sirochloa	binomial	Sirochloa parvifolia
Phyllosasa	binomial	× Phyllosasa tranquillans
Sulcia muelleri	binomial	Sulcia muelleri\n ( Moran et al 2005)
Carphephorus pseudoliatris	binomial	Carphephorus pseudoliatris
Drosophila subobscura	binomial	Drosophila subobscura (Collin, 1936)
