House of Lords	body	Parliament of the United Kingdom
House of Commons of the United Kingdom	body	Parliament of the United Kingdom of Great Britain and Northern Ireland
Australian House of Representatives	body	Parliament of Australia
House of Commons of Canada	body	Parliament of Canada
Senate of Canada	body	Parliament of Canada
Australian Senate	body	Parliament of Australia
Federal Council	body	Austrian Parliament
National Council	body	Austrian Parliament
Rajya Sabha	body	Parliament of India
Minnesota Senate	body	Minnesota Legislature
Minnesota House of Representatives	body	Minnesota Legislature
House of Representatives of the Philippines	body	Congress of the Philippines
National Assembly	body	French Parliament
Newport City Council	body	Newport, WalesNewport
Legislative Council of the Isle of Man	body	Tynwald
New Zealand House of Representatives	body	New Zealand Parliament
City of London Corporation	body	City of London
Chamber of Deputies	body	Congress of Mexico
California State Senate	body	California State Legislature
California State Assembly	body	California State Legislature
Dudley Metropolitan Borough Council	body	Metropolitan Borough of Dudley
Dewan Rakyat	body	Parliament of Malaysia
Skåne Regional Council	body	Scania County
Texas House of Representatives	body	Texas Legislature
Texas Senate	body	Texas Legislature
House of Commons of Northern Ireland	body	Parliament of Northern Ireland
Senate of Northern Ireland	body	Parliament of Northern Ireland
Senate	body	French Parliament
Victorian Legislative Assembly	body	Parliament of Victoria
New South Wales Legislative Assembly	body	Parliament of New South Wales
South Australian House of Assembly	body	Parliament of South Australia
South Australian Legislative Council	body	Parliament of South Australia
Tasmanian House of Assembly	body	Parliament of Tasmania
Tasmanian Legislative Council	body	Parliament of Tasmania
Victorian Legislative Council	body	Parliament of Victoria
Florida House of Representatives	body	Florida Legislature
House of Representatives	body	Congress of Colombia
National Council of Provinces	body	Parliament of South Africa
Michigan House of Representatives	body	Michigan Legislature
Michigan Senate	body	Michigan Legislature
Senate of Chile	body	National Congress of Chile
Chamber of Deputies of Chile	body	National Congress of Chile
People's Representative Council	body	People's Consultative Assembly
Senate of Pakistan	body	Parliament of Pakistan
Senate of the Republic	body	Parliament of Italy
Court of Aldermen	body	City of London Corporation
Senate of Puerto Rico	body	Legislative Assembly of Puerto Rico
House of Representatives of Puerto Rico	body	Legislative Assembly of Puerto Rico
Senate	body	Belgian Federal Parliament
Chamber of Deputies	body	Parliament of Italy
Senate of Romania	body	Parliament of Romania
Westminster City Council	body	City of Westminster
Bhiwandi-Nizampur Municipal Corporation	body	Bhiwandi
National Assembly of South Africa	body	Parliament of South Africa
Chamber of Deputies	body	National Congress of Brazil
Legislative Assembly of Queensland	body	Parliament of Queensland
House of the People	body	National Assembly National Assembly
Bedford Borough Council	body	Borough of Bedford
Florida Senate	body	Florida Legislature
Queensland Legislative Council	body	Parliament of Queensland
Dewan Negara	body	Parliament of Malaysia
Chamber of Deputies	body	Parliament of Tunisia
Legislative Assembly of Upper Canada	body	Parliament of Upper Canada
Leeds City Council	body	City of Leeds
Nottingham City Council	body	Nottingham
Philippine Assembly	body	Philippine Legislature
Senate	body	Parliament of the Democratic Republic of the Congo
House of Assembly of Barbados	body	Parliament of Barbados
National Assembly	body	Parliament of Kenya
Chamber of Representatives	body	Belgian Federal Parliament
Bruhat Bengaluru Mahanagara Palike	body	Bangalore
Chamber of Deputies of the Parliament of the Czech Republic	body	Parliament of the Czech Republic
Senate	body	National Assembly of Belize
House of Peoples' Representatives	body	Federal Parliamentary Assembly
Senate of Saint Lucia	body	Parliament of Saint Lucia
Senate of Bermuda	body	Parliament of Bermuda
Sunderland City Council	body	City of Sunderland
Kwai Tsing District Council	body	Kwai Tsing District
Solihull Metropolitan Borough Council	body	Metropolitan Borough of Solihull
Sefton Metropolitan Borough Council	body	Metropolitan Borough of SeftonSefton
New Delhi Municipal Council	body	New Delhi
Chamber of Nationalities	body	Union Parliament
Philippine Commission	body	Philippine Legislature
Doncaster Metropolitan Borough Council	body	Metropolitan Borough of Doncaster
Cambridge City Council	body	Cambridge
Thiruvananthapuram Corporation	body	Thiruvananthapuram
Municipal Corporation of Delhi	body	Delhi
National Assembly	body	Parliament of the Democratic Republic of the Congo
Knowsley Metropolitan Borough Council	body	Metropolitan Borough of Knowsley
Newham London Borough Council	body	London Borough of Newham
Redbridge London Borough Council	body	London Borough of Redbridge
Hackney London Borough Council	body	London Borough of Hackney
Havering London Borough Council	body	London Borough of Havering
Islington London Borough Council	body	London Borough of Islington
Barking and Dagenham London Borough Council	body	London Borough of Barking and Dagenham
Waltham Forest London Borough Council	body	London Borough of Waltham Forest
Milton Keynes Council	body	Borough of Milton Keynes
Kirklees Metropolitan Borough Council	body	Metropolitan Borough of Kirklees
High Peak Borough Council	body	High Peak, Derbyshire
Council for Wales and Monmouthshire	body	Wales
Guwahati Municipal Corporation	body	Guwahati
Swindon Borough Council	body	Borough of Swindon
South West Community Development Council	body	South West District, Singapore
Trafford Metropolitan Borough Council	body	Metropolitan Borough of Trafford
Tampa City Council	body	Municipal Government
Petaling Jaya City Council	body	Petaling Jaya
Shah Alam City Council	body	Shah Alam
Subang Jaya Municipal Council	body	Subang Jaya
Seberang Perai Municipal Council	body	Seberang Perai
Halton Borough Council	body	Borough of Halton
Chamber of Advisors	body	Parliament of Tunisia
City of Bradford Metropolitan District Council	body	City of Bradford
Watford Borough Council	body	Watford
Lambeth London Borough Council	body	London Borough of Lambeth
Andhra Pradesh Legislative Assembly	body	Andhra Pradesh Legislature
Pasir Gudang Municipal Council	body	Pasir Gudang
United States House of Representatives	body	United States Congress
Putrajaya Corporation	body	Putrajaya
Nashik Municipal Corporation	body	Nashik
Thane Municipal Corporation	body	Thane
Tower Hamlets London Borough Council	body	London Borough of Tower Hamlets
Labuan Corporation	body	Labuan
Malacca City Council	body	Central Malacca
Kolhapur Municipal Corporation	body	Kolhapur
Seanad Éireann	body	Oireachtas
Surat Municipal Corporation	body	Surat
New Jersey Legislative Council	body	New Jersey Legislature
Pimpri-Chinchwad Municipal Corporation	body	Pimpri-Chinchwad
Rochdale Metropolitan Borough Council	body	Metropolitan Borough of Rochdale
Salford City Council	body	City of Salford
Bolton Metropolitan Borough Council	body	Metropolitan Borough of Bolton
Jaipur Municipal Corporation	body	Jaipur
Senate of Kenya	body	Parliament of Kenya
Basildon Borough Council	body	Borough of Basildon
Lewisham London Borough Council	body	London Borough of Lewisham
Camden London Borough Council	body	London Borough of Camden
Barnet London Borough Council	body	London Borough of Barnet
Greenwich London Borough Council	body	Royal Borough of Greenwich
Sutton London Borough Council	body	London Borough of Sutton
Haringey London Borough Council	body	London Borough of Haringey
House of Nationalities	body	Pyidaungsu Hluttaw
House of Representatives	body	Pyidaungsu Hluttaw
Hounslow London Borough Council	body	London Borough of Hounslow
Central and Western District Council	body	Central and Western District
Wan Chai District Council	body	Wan Chai District
Hartlepool Borough Council	body	Borough of Hartlepool
Merton London Borough Council	body	London Borough of Merton
Eastern District Council	body	Eastern District, Hong Kong
Southern District Council	body	Southern District, Hong Kong
Tsuen Wan District Council	body	Tsuen Wan District
Kowloon City District Council	body	Kowloon City District
Yuen Long District Council	body	Yuen Long District
Sha Tin District Council	body	Sha Tin District
Wong Tai Sin District Council	body	Wong Tai Sin District
Sai Kung District Council	body	Sai Kung District
Tai Po District Council	body	Tai Po District
Kwun Tong District Council	body	Kwun Tong District
Sham Shui Po District Council	body	Sham Shui Po District
Yau Tsim Mong District Council	body	Yau Tsim Mong District
North District Council	body	North District, Hong Kong
Islands District Council	body	Islands District
Thrissur Municipal Corporation	body	Thrissur
Ahmednagar Municipal Corporation	body	Ahmednagar
Malegaon Municipal Corporation	body	Malegaon
Akola Municipal Corporation	body	Akola
Aurangabad Municipal Corporation	body	Aurangabad, Maharashtra
Nanded-Waghala Municipal Corporation	body	Nanded
Kalyan-Dombivali Municipal Corporation	body	Kalyan-Dombivli
Solapur Municipal Corporation	body	Solapur
Ulhasnagar Municipal Corporation	body	Ulhasnagar
Wandsworth London Borough Council	body	London Borough of Wandsworth
Bexley London Borough Council	body	London Borough of Bexley
Bromley London Borough Council	body	London Borough of Bromley
Enfield London Borough Council	body	London Borough of Enfield
Ealing London Borough Council	body	London Borough of Ealing
Croydon London Borough Council	body	London Borough of Croydon
Hammersmith and Fulham London Borough Council	body	London Borough of Hammersmith and Fulham
Harrow London Borough Council	body	London Borough of Harrow
Hillingdon London Borough Council	body	London Borough of Hillingdon
Kingston upon Thames London Borough Council	body	Royal Borough of Kingston upon Thames
Southwark London Borough Council	body	London Borough of Southwark
Richmond upon Thames London Borough Council	body	London Borough of Richmond upon Thames
Wakefield Metropolitan District Council	body	City of Wakefield
Indore Municipal Corporation	body	Indore
New Jersey Provincial Council	body	New Jersey Legislature
Sibu Municipal Council	body	Sibu Town
Bintulu Development Authority	body	Bintulu Division
Patna Municipal Corporation	body	Patna
East New Jersey Provincial Council	body	East New Jersey Legislature
Jalgaon Municipal Corporation	body	Jalgaon
Chandrapur Municipal Corporation	body	Chandrapur
Amravati Municipal Corporation	body	Amravati
Dhule Municipal Corporation	body	Dhule
Parbhani Municipal Corporation	body	Parbhani
Dáil Éireann	body	Oireachtas
Barnsley Metropolitan Borough Council	body	Metropolitan Borough of Barnsley
Oldham Metropolitan Borough Council	body	Metropolitan Borough of Oldham
Liverpool City Region Combined Authority	body	Liverpool City Region
Stockton-on-Tees Borough Council	body	Borough of Stockton-on-Tees
Wokingham Borough Council	body	Borough of Wokingham
Wirral Metropolitan Borough Council	body	Metropolitan Borough of Wirral
St Helens Metropolitan Borough Council	body	Metropolitan Borough of St Helens
Hajipur Nagar Parisad	body	Hajipur
Calderdale Metropolitan Borough Council	body	Metropolitan Borough of Calderdale
Tameside Metropolitan Borough Council	body	Metropolitan Borough of Tameside
Bury Metropolitan Borough Council	body	Metropolitan Borough of Bury
Kanpur Municipal Corporation	body	Kanpur
Rotherham Metropolitan Borough Council	body	Metropolitan Borough of Rotherham
Padawan Municipal Council	body	Padawan municipality
Mohali Municipal Corporation	body	Mohali
Nizamabad Municipal Corporation	body	Nizamabad, Telangana
Tirupati Municipal Corporation	body	Tirupati
Chamber of Deputies	body	Union Parliament
Medininagar Municipal Corporation	body	Medininagar
Rajahmundry Municipal Corporation	body	Rajahmundry
Ujjain Municipal Corporation	body	Ujjain
Kakinada Municipal Corporation	body	Kakinada
Nellore Municipal Corporation	body	Nellore
Ongole Municipal Corporation	body	Ongole
Eluru Municipal Corporation	body	Eluru
Machilipatnam Municipal Corporation	body	Machilipatnam
Municipal Corporation Chandigarh	body	Chandigarh
Srikakulam Municipal Corporation	body	Srikakulam
Karimnagar Municipal Corporation	body	Karimnagar, Telangana
Ramagundam Municipal Corporation	body	Ramagundam
Chittoor Municipal Corporation	body	Chittoor
Khammam Municipal Corporation	body	Khammam
Vizianagaram Municipal Corporation	body	Vizianagaram
Kurnool Municipal Corporation	body	Kurnool
Anantapur Municipal Corporation	body	Anantapur
Faizabad Municipal Corporation	body	Faizabad
Ayodhya Municipal Corporation	body	Ayodhya
Administration of Trivandrum district	body	Thiruvananthapuram
