Dumbarton Bridge	bridgeName	Dumbarton Bridge
Mackinac Bridge	bridgeName	Mackinac Bridge
Leonard P. Zakim Bunker Hill Memorial Bridge	bridgeName	Zakim Bunker Hill Bridge
Great Belt Fixed Link	bridgeName	The Great Belt Bridge
Great Belt Fixed Link	bridgeName	The West Bridge
Brooklyn Bridge	bridgeName	Brooklyn Bridge
Blackfriars Bridge	bridgeName	Blackfriars Bridge
Tower Bridge	bridgeName	Tower Bridge
Millennium Bridge, London	bridgeName	Millennium Bridge
Øresund Bridge	bridgeName	Øresund Bridge
Øresund Bridge	bridgeName	Öresund Bridge
Tacoma Narrows Bridge	bridgeName	Tacoma Narrows Bridge
Jackson's Sawmill Covered Bridge	bridgeName	Jackson's Sawmill Covered Bridge
Kauffman's Distillery Covered Bridge	bridgeName	Kauffman's Distillery Covered Bridge
Herr's Mill Covered Bridge	bridgeName	Herr's Mill Covered Bridge
Forry's Mill Covered Bridge	bridgeName	Forry's Mill Covered Bridge
Kurtz's Mill Covered Bridge	bridgeName	Kurtz's Mill Covered Bridge
Hunsecker's Mill Covered Bridge	bridgeName	Hunsecker's Mill Covered Bridge
Lime Valley Covered Bridge	bridgeName	Lime Valley Covered Bridge
Landis Mill Covered Bridge	bridgeName	Landis Mill Covered Bridge
White Rock Forge Covered Bridge	bridgeName	White Rock Forge Covered Bridge
Mercer's Mill Covered Bridge	bridgeName	Mercer's Mill Covered Bridge
Pine Grove Covered Bridge	bridgeName	Pine Grove Covered Bridge
Schenck's Mill Covered Bridge	bridgeName	Schenck's Mill Covered Bridge
Neff's Mill Covered Bridge	bridgeName	Neff's Mill Covered Bridge
Leaman's Place Covered Bridge	bridgeName	Leaman's Place Covered Bridge
Zook's Mill Covered Bridge	bridgeName	Zook's Mill Covered Bridge
Pinetown Bushong's Mill Covered Bridge	bridgeName	Pinetown Bushong's Mill Covered Bridge
Shearer's Covered Bridge	bridgeName	Shearer's Covered Bridge
Weaver's Mill Covered Bridge	bridgeName	Weaver's Mill Covered Bridge
Red Run Covered Bridge	bridgeName	Red Run Covered Bridge
Pool Forge Covered Bridge	bridgeName	Pool Forge Covered Bridge
Willow Hill Covered Bridge	bridgeName	Willow Hill Covered Bridge
Tsing Ma Bridge	bridgeName	Tsing Ma Bridge
Clifton Suspension Bridge	bridgeName	Clifton Suspension Bridge
London Bridge	bridgeName	London Bridge
Harvard Bridge	bridgeName	Harvard Bridge
Akashi Kaikyō Bridge	bridgeName	Akashi Kaikyō Bridge
Tay Rail Bridge	bridgeName	Tay Bridge
Tamar Bridge	bridgeName	Tamar Bridge
Tay Road Bridge	bridgeName	Tay Road Bridge\nthumb|Tay Road Bridge from City Quay, Dundee
Humber Bridge	bridgeName	Humber Bridge
San Francisco–Oakland Bay Bridge	bridgeName	San Francisco–Oakland Bay Bridge
Story Bridge	bridgeName	Story Bridge
Sir Leo Hielscher Bridges	bridgeName	Sir Leo Hielscher Bridges
Goodwill Bridge	bridgeName	Goodwill Bridge
Captain Cook Bridge, Brisbane	bridgeName	Captain Cook Bridge
Centenary Bridge	bridgeName	Centenary
Walter Taylor Bridge	bridgeName	Walter Taylor
Merivale Bridge	bridgeName	Merivale Bridge
Victoria Bridge, Brisbane	bridgeName	Victoria Bridge
Albert Bridge, Brisbane	bridgeName	Albert Bridge
William Jolly Bridge	bridgeName	William Jolly
George Washington Bridge	bridgeName	George Washington Bridge
Jack Pesch Bridge	bridgeName	Jack Pesch
Pont du Gard	bridgeName	Pont du Gard
Confederation Bridge	bridgeName	Confederation Bridge
Ambassador Bridge	bridgeName	Ambassador Bridge
Throgs Neck Bridge	bridgeName	Throgs Neck Bridge
New River Gorge Bridge	bridgeName	New River Gorge Bridge
Second Severn Crossing	bridgeName	Second Severn Crossing
Darlington's Bridge at Delaware Station	bridgeName	Darlington's Bridge at Delaware Station
Goethals Bridge	bridgeName	Goethals Bridge
Triborough Bridge	bridgeName	Robert F. Kennedy Bridge
Verrazano–Narrows Bridge	bridgeName	Verrazano–Narrows Bridge
Tacoma Narrows Bridge	bridgeName	Tacoma Narrows Bridge
Tinsley Viaduct	bridgeName	Tinsley Viaduct
Pont Neuf	bridgeName	Le Pont Neuf
Hell Gate Bridge	bridgeName	Hell Gate Bridge
Ribblehead Viaduct	bridgeName	Ribblehead Viaduct
Pegasus Bridge	bridgeName	Pegasus Bridge
Royal Albert Bridge	bridgeName	Royal Albert Bridge
Vauxhall Bridge	bridgeName	Vauxhall Bridge
Lambeth Bridge	bridgeName	Lambeth Bridge
Kew Gardens station	bridgeName	Kew Gardens Station Footbridge
Battersea Bridge	bridgeName	Battersea Bridge
Hammersmith Bridge	bridgeName	Hammersmith Bridge
Putney Bridge	bridgeName	Putney Bridge
Cannon Street Railway Bridge	bridgeName	Cannon Street Railway Bridge
Southwark Bridge	bridgeName	Southwark Bridge
Kew Bridge	bridgeName	Kew Bridge
Westminster Bridge	bridgeName	Westminster Bridge
Waterloo Bridge	bridgeName	Waterloo Bridge
Prince Edward Viaduct	bridgeName	Prince Edward Viaduct
Hungerford Bridge and Golden Jubilee Bridges	bridgeName	Hungerford Bridge
Blackfriars Railway Bridge	bridgeName	Blackfriars Railway Bridge
Grosvenor Bridge	bridgeName	Grosvenor Bridge
East-Link	bridgeName	Tom Clarke Bridge
Ha'penny Bridge	bridgeName	Ha'penny Bridge
Manhattan Bridge	bridgeName	Manhattan Bridge
Gladesville Bridge	bridgeName	Gladesville Bridge
Pulaski Skyway	bridgeName	General Pulaski Skyway
Tasman Bridge	bridgeName	Tasman Bridge
Hawthorne Bridge	bridgeName	Hawthorne Bridge
St. Johns Bridge	bridgeName	St. Johns Bridge
Miles Glacier Bridge	bridgeName	Miles Glacier Bridge
Bayonne Bridge	bridgeName	Bayonne Bridge
Dames Point Bridge	bridgeName	Dames Point Bridge
Victoria Bridge	bridgeName	Victoria Bridge
Tyne Bridge	bridgeName	Tyne Bridge
Lions Gate Bridge	bridgeName	Lions Gate Bridge
Williamsburg Bridge	bridgeName	Williamsburg Bridge
Gerrard Street	bridgeName	Gerrard Street Bridge
Blue Water Bridge	bridgeName	Blue Water Bridge
14th Street Bridges	bridgeName	14
Lethbridge Viaduct	bridgeName	High Level Bridge
Driscoll Bridge	bridgeName	Driscoll Bridge
Rio–Niterói Bridge	bridgeName	Rio-Niterói Bridge
Quebec Bridge	bridgeName	Quebec Bridge
Pierre Laporte Bridge	bridgeName	Pierre Laporte Bridge
Sault Ste. Marie International Bridge	bridgeName	Sault Ste. Marie International Bridge
Lewiston–Queenston Bridge	bridgeName	Lewiston–Queenston Bridge
Charles Bridge	bridgeName	Charles Bridge
Whirlpool Rapids Bridge	bridgeName	Whirlpool Rapids Bridge
Peace Bridge	bridgeName	Peace Bridge
Charlestown High Bridge	bridgeName	Charlestown High Bridge
Batman Bridge	bridgeName	Batman Bridge
Anzac Bridge	bridgeName	Anzac Bridge
Île d'Orléans Bridge	bridgeName	Orleans Island Bridge
Jacques Cartier Bridge	bridgeName	Jacques Cartier Bridge
Champlain Bridge, Montreal	bridgeName	Champlain Bridge
Alexandra Bridge	bridgeName	Alexandra Bridge
Thousand Islands Bridge	bridgeName	Thousand Islands Bridge
Pulteney Bridge	bridgeName	Pulteney Bridge
Lune Millennium Bridge	bridgeName	Lune Millennium Bridge
Gateshead Millennium Bridge	bridgeName	Gateshead Millennium Bridge
Little Belt Bridge	bridgeName	The Old Little Belt Bridge
Eads Bridge	bridgeName	Eads Bridge
Chelsea Bridge	bridgeName	Chelsea Bridge
Lacey V. Murrow Memorial Bridge	bridgeName	Lacey V. Murrow Memorial Bridge
Sino-Korean Friendship Bridge	bridgeName	Sino–Korean Friendship Bridge
Blue Wonder	bridgeName	Blue Wonder
Blue Wonder	bridgeName	''
Stan Musial Veterans Memorial Bridge	bridgeName	Stan Musial Veterans Memorial Bridge
Ironworkers Memorial Second Narrows Crossing	bridgeName	Ironworkers Memorial Bridge
Auckland Harbour Bridge	bridgeName	Auckland Harbour Bridge
Eagle Point Bridge	bridgeName	Eagle Point Bridge
Dubuque–Wisconsin Bridge	bridgeName	Dubuque-Wisconsin Bridge
Menai Suspension Bridge	bridgeName	Menai Bridge
Millau Viaduct	bridgeName	Millau Viaduct
Lincoln Memorial Bridge	bridgeName	Lincoln Memorial Bridge
Rainbow Bridge	bridgeName	Rainbow Bridge
Rainbow Bridge	bridgeName	Rainbow Bridge
Skye Bridge	bridgeName	Skye Bridge
West Gate Bridge	bridgeName	West Gate Bridge
Sundial Bridge at Turtle Bay	bridgeName	Sundial Bridge
Tacony–Palmyra Bridge	bridgeName	Tacony-Palmyra Bridge
Burlington–Bristol Bridge	bridgeName	Burlington-Bristol Bridge
Riverside–Delanco Bridge	bridgeName	Riverside-Delanco Bridge
Delaware Memorial Bridge	bridgeName	Delaware Memorial Bridge
Betsy Ross Bridge	bridgeName	Betsy Ross Bridge
Commodore Barry Bridge	bridgeName	Commodore Barry Bridge
Longfellow Bridge	bridgeName	Longfellow Bridge
Kingston Bridge, Glasgow	bridgeName	Kingston Bridge
Buckman Bridge	bridgeName	Buckman Bridge
Galata Bridge	bridgeName	Galata Bridge
Portage Lake Lift Bridge	bridgeName	Portage Lake Lift Bridge
Rio–Antirrio bridge	bridgeName	Rio–Antirrio Bridge
Rio–Antirrio bridge	bridgeName	Γέφυρα Ρίου - Αντιρρίου
Stone Arch Bridge	bridgeName	Stone Arch Bridge
Queensborough Bridge	bridgeName	Queensborough Bridge
Tappan Zee Bridge	bridgeName	Tappan Zee Bridge
Salmon Bay Bridge	bridgeName	Salmon Bay Bridge
University Bridge	bridgeName	University Bridge
Ship Canal Bridge	bridgeName	Ship Canal Bridge
Aurora Bridge	bridgeName	Aurora Bridge
Montlake Bridge	bridgeName	Montlake Bridge
Fremont Bridge	bridgeName	Fremont Bridge
Ballard Bridge	bridgeName	Ballard Bridge
Woodrow Wilson Bridge	bridgeName	Woodrow Wilson Bridge
Alaskan Way Viaduct	bridgeName	Alaskan Way Viaduct
Scudder Falls Bridge	bridgeName	Scudder Falls Bridge
Bronx–Whitestone Bridge	bridgeName	Bronx-Whitestone Bridge
Interstate 195	bridgeName	Julia Tuttle Causeway
Garabit viaduct	bridgeName	Garabit Viaduct
Öland Bridge	bridgeName	Öland Bridge
Jeremiah Morrow Bridge	bridgeName	Jeremiah Morrow Bridge
Vasco da Gama Bridge	bridgeName	Vasco da Gama Bridge
Chesapeake Bay Bridge–Tunnel	bridgeName	Chesapeake Bay Bridge
Britannia Bridge	bridgeName	Britannia Bridge
Richmond–San Rafael Bridge	bridgeName	Richmond–San Rafael Bridge
Rockville Bridge	bridgeName	Rockville Bridge
Hood Canal Bridge	bridgeName	Hood Canal Bridge
Malabadi Bridge	bridgeName	Malabadi Bridge
Carl Perkins Bridge	bridgeName	Carl D. Perkins Bridge
Lake Pontchartrain Causeway	bridgeName	Lake Pontchartrain Causeway
Moodna Viaduct	bridgeName	Moodna Viaduct
Fremont Bridge	bridgeName	Fremont Bridge
Burnside Bridge	bridgeName	Burnside Bridge
Marquam Bridge	bridgeName	Marquam Bridge
Morrison Bridge	bridgeName	Morrison Bridge
High Level Bridge	bridgeName	High Level Bridge
Severan Bridge	bridgeName	Severan Bridge
Broadway Bridge	bridgeName	Broadway Bridge
Ross Island Bridge	bridgeName	Ross Island Bridge
Interstate Bridge	bridgeName	Interstate Bridge
Sellwood Bridge	bridgeName	Sellwood Bridge
Fatih Sultan Mehmet Bridge	bridgeName	Fatih Sultan Mehmet Bridge
Clun Bridge	bridgeName	Clun Bridge
Burlington Northern Railroad Bridge 5.1	bridgeName	Burlington Northern Railroad
Burlington Northern Railroad Bridge 5.1	bridgeName	Bridge 5.1
Lewis and Clark Bridge	bridgeName	Lewis and Clark Bridge
Abernethy Bridge	bridgeName	George Abernethy Bridge
Rialto Bridge	bridgeName	Rialto Bridge
Tees Transporter Bridge	bridgeName	Tees Transporter Bridge
Glenn L. Jackson Memorial Bridge	bridgeName	Glenn Jackson Memorial Bridge
Oregon City Bridge	bridgeName	Oregon City Bridge
Seven Mile Bridge	bridgeName	Seven Mile Bridge
Astoria–Megler Bridge	bridgeName	Astoria–Megler Bridge
Pulaski Bridge	bridgeName	Pulaski Bridge
Trinity Bridge, Crowland	bridgeName	Trinity Bridge
Mystic River Bascule Bridge	bridgeName	Mystic River Bascule Bridge
Newark Bay Bridge	bridgeName	Newark Bay Bridge
Chesapeake Bay Bridge	bridgeName	Chesapeake Bay Bridge
Hangzhou Bay Bridge	bridgeName	Hangzhou Bay Bridge
Marlow Bridge	bridgeName	Marlow Bridge
Chain Bridge	bridgeName	Chain Bridge
Maidenhead Railway Bridge	bridgeName	Maidenhead Railway Bridge
Windsor Bridge	bridgeName	Windsor Bridge
Acosta Bridge	bridgeName	Acosta Bridge
Mathews Bridge	bridgeName	Mathews Bridge
Ting Kau Bridge	bridgeName	Ting Kau Bridge
Ting Kau Bridge	bridgeName	汀九橋
Johnson Street Bridge	bridgeName	Johnson Street Bridge
Severn Railway Bridge	bridgeName	Severn Railway Bridge
Alsea Bay Bridge	bridgeName	Alsea Bay Bridge
Conde McCullough Memorial Bridge	bridgeName	Coos Bay Bridge
Yaquina Bay Bridge	bridgeName	Yaquina Bay Bridge
Ouse Bridge	bridgeName	Ouse Bridge
Governor Harry W. Nice Memorial Bridge	bridgeName	Harry W. Nice Memorial Bridge
West-Link	bridgeName	West-Link
Thai–Lao Friendship Bridge	bridgeName	Thai–Lao Friendship Bridge
Tobin Bridge	bridgeName	Tobin Bridge
Birchenough Bridge	bridgeName	Birchenough Bridge
Albert Bridge, London	bridgeName	Albert Bridge
City Island Bridge	bridgeName	City Island Bridge
Hampton Roads Bridge–Tunnel	bridgeName	Hampton Roads Bridge–Tunnel
Monitor–Merrimac Memorial Bridge–Tunnel	bridgeName	Monitor–Merrimac Memorial Bridge–Tunnel
Fuller Warren Bridge	bridgeName	Fuller Warren Bridge
Bridge of the Gods	bridgeName	Bridge of the Gods
Hornibrook Bridge	bridgeName	Hornibrook Bridge
Houghton Highway	bridgeName	Houghton Highway
Malaysia–Singapore Second Link	bridgeName	Malaysia&ndash;Singapore Second Link
Waco Suspension Bridge	bridgeName	Waco Suspension Bridge
Homer M. Hadley Memorial Bridge	bridgeName	Homer M. Hadley Memorial Bridge
Hart Bridge	bridgeName	Isaiah D. Hart Bridge
Shands Bridge	bridgeName	Shands Bridge
Trajan's Bridge	bridgeName	Trajan's Bridge
Bridge of Lions	bridgeName	Bridge of Lions
St. Johns River Veterans Memorial Bridge	bridgeName	St. Johns River Veterans Memorial Bridge
Kincardine Bridge	bridgeName	Kincardine Bridge
Whitchurch Bridge	bridgeName	Whitchurch Bridge
Pennybacker Bridge	bridgeName	360
Burlington Bay James N. Allan Skyway	bridgeName	Burlington Bay James N. Allan Skyway
General Rafael Urdaneta Bridge	bridgeName	General Rafael Urdaneta Bridge
Pelham Bridge	bridgeName	Pelham Bridge
Angus L. Macdonald Bridge	bridgeName	Angus L. Macdonald Bridge
Kew Railway Bridge	bridgeName	Kew Railway Bridge
Reading Bridge	bridgeName	Reading Bridge
Goring and Streatley Bridge	bridgeName	Goring and Streatley Bridge)
Royal Gorge Bridge	bridgeName	Royal Gorge Bridge
Newburgh–Beacon Bridge	bridgeName	Newburgh-Beacon Bridge
Kessock Bridge	bridgeName	Kessock Bridge
Jackknife Bascule Bridge	bridgeName	Jackknife Bascule Bridge
Koersch Viaduct	bridgeName	Koersch Viaduct
Kocher Viaduct	bridgeName	Kocher Viaduct
Most SNP	bridgeName	Most SNP
Navajo Bridge	bridgeName	Navajo Bridge
Hennepin Avenue Bridge	bridgeName	Hennepin Avenue Bridge
Friendship Bridge	bridgeName	Friendship Bridge
Newport Transporter Bridge	bridgeName	Newport Transporter Bridge
Wheeling Suspension Bridge	bridgeName	Wheeling Suspension Bridge
Victoria Falls Bridge	bridgeName	Victoria Falls Bridge
Caversham Bridge	bridgeName	Caversham Bridge
Sonning Bridge	bridgeName	Sonning Bridge
Tancredo Neves Bridge	bridgeName	Fraternity Bridge
Bear Mountain Bridge	bridgeName	Bear Mountain Bridge
Robert E. Lee Memorial Bridge	bridgeName	Robert E. Lee Memorial Bridge
George P. Coleman Memorial Bridge	bridgeName	Coleman Bridge
James River Bridge	bridgeName	James River Bridge
Abraham Lincoln Memorial Bridge	bridgeName	Abraham Lincoln Memorial Bridge
Boyne Viaduct	bridgeName	Boyne Viaduct
Thomas J. Hatem Memorial Bridge	bridgeName	Thomas J. Hatem Memorial Bridge
Francis Scott Key Bridge	bridgeName	Francis Scott Key Bridge
Mary McAleese Boyne Valley Bridge	bridgeName	Mary McAleese
Mary McAleese Boyne Valley Bridge	bridgeName	Boyne Valley Bridge
Knox Memorial Bridge	bridgeName	Knox Memorial Bridge
Millard E. Tydings Memorial Bridge	bridgeName	Millard E. Tydings Memorial Bridge
Overseas Highway	bridgeName	Overseas Highway
Puente de la Mujer	bridgeName	Women's Bridge
George Street Bridge, Newport	bridgeName	George Street Bridge
King Fahd Causeway	bridgeName	King Fahd Causeway
King Fahd Causeway	bridgeName	جسر الملك فهد
25 de Abril Bridge	bridgeName	Ponte 25 de Abril
25 de Abril Bridge	bridgeName	()
Benjamin Harrison Memorial Bridge	bridgeName	Benjamin Harrison Memorial Bridge
Karni crossing	bridgeName	Karni Crossing
Puente del Alamillo	bridgeName	Puente del Alamillo
Dongting Lake Bridge	bridgeName	Dongting Lake Bridge
A419 road	bridgeName	A419 Road Bridge
Monnow Bridge	bridgeName	Monnow Bridge
Broadway Bridge	bridgeName	Broadway Bridge
Talbot Memorial Bridge	bridgeName	Talbot Memorial Bridge
Royal Victoria Dock Bridge	bridgeName	Royal Victoria Dock Bridge
Bowen Bridge	bridgeName	Bowen Bridge
Glenfinnan Viaduct	bridgeName	Glenfinnan Viaduct
Siuslaw River Bridge	bridgeName	Siuslaw River Bridge
Benicia–Martinez Bridge	bridgeName	Benicia–Martinez Bridge
Carquinez Bridge	bridgeName	Carquinez Bridge
Vincent Thomas Bridge	bridgeName	Vincent Thomas Bridge
Theodore Roosevelt Bridge	bridgeName	Theodore Roosevelt Bridge
Sam Hill Memorial Bridge	bridgeName	Biggs Rapids Bridge
The Dalles Bridge	bridgeName	The Dalles Bridge
Berkley Bridge	bridgeName	I-264 Berkley Bridge
Bolte Bridge	bridgeName	Bolte Bridge
Wicker Arches	bridgeName	The Wicker Arches
Pont de Normandie	bridgeName	Pont de Normandie
Penang Bridge	bridgeName	Penang Bridge
Zilwaukee Bridge	bridgeName	Zilwaukee Bridge
High Bridge	bridgeName	High Bridge
Chain of Rocks Bridge	bridgeName	Chain of Rocks Bridge
Magdalen Bridge	bridgeName	Magdalen Bridge
Cleddau Bridge	bridgeName	Cleddau Bridge
Triple Bridge	bridgeName	Triple Bridge
Collins Bridge	bridgeName	Collins Bridge
Tees Barrage	bridgeName	Tees Barrage
Mount Hope Bridge	bridgeName	Mount Hope Bridge
Blue Bridge	bridgeName	Blue Bridge
Venetian Causeway	bridgeName	Venetian Causeway
A. Murray MacKay Bridge	bridgeName	A. Murray MacKay Bridge
Dundas Street	bridgeName	Dundas Street Viaduct
Sandridge Bridge	bridgeName	Sandridge Bridge
Broadway Bridge	bridgeName	Broadway Bridge
Grand River Bridge	bridgeName	Caledonia Bridge
Anji Bridge	bridgeName	Anji Bridge
Varina-Enon Bridge	bridgeName	Varina-Enon Bridge
Pyrmont Bridge	bridgeName	Pyrmont Bridge
Kap Shui Mun Bridge	bridgeName	Kap Shui Mun Bridge
Kap Shui Mun Bridge	bridgeName	汲水門大橋
Silver Jubilee Bridge	bridgeName	Silver Jubilee Bridge
Salginatobel Bridge	bridgeName	Salginatobel Bridge
Juscelino Kubitschek bridge	bridgeName	Juscelino Kubitschek Bridge
Vivekananda Setu	bridgeName	Vivekananda Setu
Vivekananda Setu	bridgeName	বিবেকানন্দ সেতু
Cape Coral Bridge	bridgeName	Cape Coral Bridge
Sanibel Causeway	bridgeName	Sanibel Causeway
Midpoint Memorial Bridge	bridgeName	Midpoint Memorial Bridge
Hogg's Hollow Bridge	bridgeName	Hogg's Hollow Bridge
Garden City Skyway	bridgeName	Garden City Skyway
Erskine Bridge	bridgeName	Erskine Bridge
St. George Island Bridge	bridgeName	St. George Island Bridge
Rip Van Winkle Bridge	bridgeName	Rip Van Winkle Bridge
San Juanico Bridge	bridgeName	San Juanico Bridge
Friarton Bridge	bridgeName	Friarton Bridge
Hampton Bridge	bridgeName	Hampton Bridge
Eastern span replacement of the San Francisco–Oakland Bay Bridge	bridgeName	San Francisco–Oakland Bay Bridge
Mike O'Callaghan–Pat Tillman Memorial Bridge	bridgeName	Mike O'Callaghan–Pat Tillman Memorial Bridge
Boston University Bridge	bridgeName	Boston University Bridge
Livingston Avenue Bridge	bridgeName	Livingston Avenue Bridge
Rosario-Victoria Bridge	bridgeName	Rosario-Victoria Bridge
Yolo Causeway	bridgeName	Yolo Causeway
Pamban Bridge	bridgeName	Pamban Bridge
Willis Avenue Bridge	bridgeName	Willis Avenue Bridge
Ludendorff Bridge	bridgeName	Ludendorff Bridge
Bangabandhu Bridge	bridgeName	Bangabandhu Bridge
Rock Island Centennial Bridge	bridgeName	Centennial Bridge
Pons Sublicius	bridgeName	Pons Sublicius
Calhoun Street Bridge	bridgeName	Calhoun Street Bridge
Mid-Hudson Bridge	bridgeName	Mid-Hudson Bridge
Qatar Bahrain Causeway	bridgeName	Qatar Bahrain Bridge
Ireland Bridge	bridgeName	Ireland Bridge
Charles River Dam Bridge	bridgeName	Charles River Dam Bridge
Third Avenue Bridge	bridgeName	Third Avenue Bridge
Runyang Yangtze River Bridge	bridgeName	Runyang Bridge
Veterans' Glass City Skyway	bridgeName	Veterans' Glass City Skyway
Tancarville Bridge	bridgeName	Tancarville Bridge
Arthur Ravenel Jr. Bridge	bridgeName	Arthur Ravenel Jr. Bridge
Washington Avenue Bridge	bridgeName	Washington Avenue Bridge
Chain Bridge	bridgeName	Chain Bridge
Porthill Bridge	bridgeName	Porthill Bridge
American Legion Memorial Bridge	bridgeName	American Legion Memorial Bridge
Whitney Young Memorial Bridge	bridgeName	Whitney Young Memorial Bridge
American Legion Memorial Bridge	bridgeName	American Legion Memorial Bridge
Bridge of the Americas	bridgeName	Bridge of the Americas
Nanjing Yangtze River Bridge	bridgeName	Nanjing Yangtze River Bridge
Franklin Avenue Bridge	bridgeName	Franklin Avenue Bridge
10th Avenue Bridge	bridgeName	10
John Philip Sousa Bridge	bridgeName	John Philip Sousa Bridge
Xihoumen Bridge	bridgeName	Xihoumen Bridge
Xihoumen Bridge	bridgeName	西堠门大桥
London Bridge	bridgeName	London Bridge in Lake Havasu
Swing Bridge, River Tyne	bridgeName	Swing Bridge
Ladykirk and Norham Bridge	bridgeName	Ladykirk and Norham Bridge
Berwick Bridge	bridgeName	Berwick Bridge
Coldstream Bridge	bridgeName	Coldstream Bridge
Dryburgh Suspension Bridge	bridgeName	Dryburgh Suspension Bridge
Royal Border Bridge	bridgeName	Royal Border Bridge
Royal Tweed Bridge	bridgeName	Royal Tweed Bridge
Glebe Island Bridge	bridgeName	Glebe Island Bridge
Great Barford Bridge	bridgeName	Great Barford Bridge
Kurushima-Kaikyō Bridge	bridgeName	Kurushima-kaikyō Bridge
Elisabeth Bridge	bridgeName	Elisabeth Bridge
Claiborne Pell Newport Bridge	bridgeName	Newport Bridge
Margaret Bridge	bridgeName	Margaret Bridge
Árpád Bridge	bridgeName	Árpád Bridge
Grattan Bridge	bridgeName	Grattan Bridge
Niagara Cantilever Bridge	bridgeName	Niagara Cantilever Bridge
O'Connell Bridge	bridgeName	O'Connell Bridge
Seán Heuston Bridge	bridgeName	Seán Heuston Bridge
Millennium Bridge	bridgeName	Millennium Bridge
Höga Kusten Bridge	bridgeName	High Coast Bridge
O'Donovan Rossa Bridge	bridgeName	O'Donovan Rossa Bridge
Fred Schwengel Memorial Bridge	bridgeName	Fred Schwengel Memorial Bridge
Bridgewater Bridge	bridgeName	Bridgewater Bridge
Davenport Skybridge	bridgeName	Davenport Skybridge
Umpqua River Bridge	bridgeName	Umpqua River Bridge
Howard Frankland Bridge	bridgeName	W. Howard Frankland Bridge
Patroon Island Bridge	bridgeName	Patroon Island Bridge
112th Street Bridge	bridgeName	112
Stari Most	bridgeName	Stari Most
Three Sisters	bridgeName	The Three Sisters
Three Sisters	bridgeName	Sixth Street Bridge
Three Sisters	bridgeName	Seventh Street Bridge
Three Sisters	bridgeName	Ninth Street Bridge
Ponte delle Guglie	bridgeName	Ponte delle Guglie
Stonecutters Bridge	bridgeName	Stonecutters Bridge
Chesapeake & Delaware Canal Bridge	bridgeName	Chesapeake & Delaware Canal Bridge
I-74 Bridge	bridgeName	Interstate 74 Bridge
Barmouth Bridge	bridgeName	Barmouth Bridge
James Joyce Bridge	bridgeName	James Joyce Bridge
Richard I. Bong Memorial Bridge	bridgeName	Richard I. Bong Memorial Bridge
Puente Nuevo	bridgeName	Puente Nuevo
Puente Viejo	bridgeName	Puente Viejo
Loopline Bridge	bridgeName	Loopline Bridge
Twickenham Bridge	bridgeName	Twickenham Bridge
Richmond Bridge, London	bridgeName	Richmond Bridge
Seán O'Casey Bridge	bridgeName	Seán O'Casey Bridge
Frank Sherwin Bridge	bridgeName	Frank Sherwin Bridge
Butt Bridge	bridgeName	Butt Bridge
Mellows Bridge	bridgeName	Mellows Bridge
Father Mathew Bridge	bridgeName	Father Mathew Bridge
Milford–Montague Toll Bridge	bridgeName	Milford–Montague Toll Bridge
Marcelo Fernan Bridge	bridgeName	Marcelo Fernan Bridge
Skybridge	bridgeName	SkyBridge
Niagara Falls Suspension Bridge	bridgeName	Niagara Falls Suspension Bridge
Pie IX Bridge	bridgeName	Le Caron Bridge
Dingman's Ferry Bridge	bridgeName	Dingman's Ferry Bridge
Black Hawk Bridge	bridgeName	Black Hawk Bridge
Hockley Railway Viaduct	bridgeName	Hockley Railway Viaduct
Stone Bridge	bridgeName	Stone Bridge
Ryde Bridge	bridgeName	Ryde Bridge
Jamestown Verrazzano Bridge	bridgeName	Jamestown Verrazzano Bridge
Jamestown Bridge	bridgeName	Jamestown Bridge
Jamestown Bridge	bridgeName	(Old Jamestown Bridge)
Burrard Bridge	bridgeName	Burrard Bridge
Henderson Bridge	bridgeName	Henderson Bridge
Louis-Hippolyte Lafontaine Bridge–Tunnel	bridgeName	Louis-Hippolyte Lafontaine Bridge–Tunnel
Golden Ears Bridge	bridgeName	Golden Ears Bridge
Benjamin Sheares Bridge	bridgeName	Benjamin Sheares Bridge
Westham Island Bridge	bridgeName	Westham Island Bridge
Enneüs Heerma Bridge	bridgeName	Enneüs Heerma Bridge
Capilano Suspension Bridge	bridgeName	Capilano Suspension Bridge
Honoré Mercier Bridge	bridgeName	Honoré Mercier Bridge
Granville Street Bridge	bridgeName	Granville Street Bridge
Vashi Bridge	bridgeName	Vashi Bridge
Vashi Bridge	bridgeName	वाशी पुल
Widnes-Runcorn Transporter Bridge	bridgeName	Widnes-Runcorn Transporter Bridge
Warrington Transporter Bridge	bridgeName	Warrington Transporter Bridge
Roosevelt Bridge	bridgeName	Roosevelt Bridge
Sakonnet River Bridge	bridgeName	Sakonnet River Bridge
Avonmouth Bridge	bridgeName	Avonmouth Bridge
Perrine's Bridge	bridgeName	Perrine's Bridge
Perrine Bridge	bridgeName	Perrine Bridge
Arthur Laing Bridge	bridgeName	Arthur Laing Bridge
Talmadge Memorial Bridge	bridgeName	Talmadge Memorial Bridge
Radcot Bridge	bridgeName	Radcot Bridge
Frederick Douglass Memorial Bridge	bridgeName	Frederick Douglass Memorial Bridge
Knight Street Bridge	bridgeName	Knight Street Bridge
Plougastel Bridge	bridgeName	Plougastel Bridge
Stillwater Bridge	bridgeName	Stillwater Bridge
Mezcala Bridge	bridgeName	Mezcala Bridge
Tampico Bridge	bridgeName	Tampico Bridge
Million Dollar Bridge	bridgeName	Million Dollar Bridge
Governador Nobre de Carvalho Bridge	bridgeName	Governor Nobre de Carvalho Bridge
Amizade Bridge	bridgeName	Amizade Bridge
Cambie Bridge	bridgeName	Cambie Street Bridge
Sai Van Bridge	bridgeName	Sai Van Bridge
City Bridge	bridgeName	City Bridge
William H. Natcher Bridge	bridgeName	William H. Natcher Bridge
Butt Memorial Bridge	bridgeName	Butt Memorial Bridge
Oak Street Bridge	bridgeName	Oak Street Bridge
Pitt River Bridge	bridgeName	Pitt River Bridge
Port Mann Bridge	bridgeName	Port Mann Bridge
Hörn Bridge	bridgeName	Hörn Bridge
Hoan Bridge	bridgeName	Hoan Bridge
Guandu Bridge	bridgeName	Guandu Bridge
Wilson Creek Bridge	bridgeName	Wilson Creek Bridge
Prince of Wales Bridge	bridgeName	Prince of Wales Bridge
Ponte Milvio	bridgeName	Ponte Milvio
Battersea Railway Bridge	bridgeName	Battersea Railway Bridge
Bixby Creek Bridge	bridgeName	Bixby Creek Bridge
Köhlbrand Bridge	bridgeName	Köhlbrandbrücke
Narrows Bridge	bridgeName	Narrows Bridge
Narrows Bridge	bridgeName	(Southbound)
Narrows Bridge	bridgeName	(Northbound)
Narrows Bridge	bridgeName	Narrows Rail Bridge
Mahatma Gandhi Setu	bridgeName	Mahatma Gandhi Setu
Roebling's Delaware Aqueduct	bridgeName	Roebling's Delaware Aqueduct
Silas N. Pearman Bridge	bridgeName	New Cooper River Bridge
John P. Grace Memorial Bridge	bridgeName	Cooper River Bridge
Bourne Bridge	bridgeName	Bourne Bridge
Sagamore Bridge	bridgeName	Sagamore Bridge
Johor–Singapore Causeway	bridgeName	Johor–Singapore Causeway
Jefferson Barracks Bridge	bridgeName	Jefferson Barracks Bridge
McKinley Bridge	bridgeName	McKinley Bridge
Poplar Street Bridge	bridgeName	Poplar Street Bridge
MacArthur Bridge	bridgeName	MacArthur Bridge
Huey P. Long Bridge	bridgeName	Huey P. Long Bridge
Macombs Dam Bridge	bridgeName	Macombs Dam Bridge
Normand Edward Fontaine Bridge	bridgeName	Normand Edward Fontaine Bridge
Berkley–Dighton Bridge	bridgeName	Berkley-Dighton Bridge
Crescent City Connection	bridgeName	Crescent City Connection
Al-Aimmah Bridge	bridgeName	Al-Aimmah Bridge
Champlain Bridge	bridgeName	Champlain Bridge
High Level Bridge	bridgeName	High Level Bridge
Pattullo Bridge	bridgeName	Pattullo Bridge
Storstrøm Bridge	bridgeName	Storstrøm Bridge
Lower Trenton Bridge	bridgeName	Lower Trenton Bridge
Bidwell Bar Bridge	bridgeName	Bidwell Bar Bridge
Hood River Bridge	bridgeName	Hood River Bridge
Smithfield Street Bridge	bridgeName	Smithfield Street Bridge
Fort Pitt Bridge	bridgeName	Fort Pitt Bridge
Apollo Bridge	bridgeName	Apollo Bridge
Tjeldsund Bridge	bridgeName	Tjeldsund Bridge
Djupfjordstraumen Bridge	bridgeName	Djupfjordstraumen Bridge
Gimsøystraumen Bridge	bridgeName	Gimsøystraumen Bridge
Sundklakkstraumen Bridge	bridgeName	Sundklakkstraumen Bridge
Kåkern Bridge	bridgeName	Kåkern Bridge
Drammen Bridge	bridgeName	Drammen Bridge
Nordhordland Bridge	bridgeName	Nordhordland Bridge
Gjemnessund Bridge	bridgeName	Gjemnessund Bridge
Leaside Bridge	bridgeName	Leaside Bridge
Queen Street Viaduct	bridgeName	Queen Street Viaduct
Humber Bay Arch Bridge	bridgeName	Humber Bay Arch Bridge
Old Eastern Avenue Bridge	bridgeName	Old Eastern Avenue Bridge
Måløy Bridge	bridgeName	Måløy Bridge
Old Finch Avenue Bailey Bridge	bridgeName	Old Finch Avenue Bailey Bridge
Lake Shore Boulevard Bailey Bridge	bridgeName	Lake Shore Boulevard Bailey Bridge
Owensboro Bridge	bridgeName	Owensboro Bridge
Stord Bridge	bridgeName	Stord Bridge
Stavanger City Bridge	bridgeName	Stavanger City Bridge
Askøy Bridge	bridgeName	Askøy Bridge
Tromsø Bridge	bridgeName	Tromsø Bridge
Skarnsund Bridge	bridgeName	Skarnsund Bridge
Bømla Bridge	bridgeName	Bømla Bridge
Sotra Bridge	bridgeName	Sotra Bridge
Farø Bridges	bridgeName	Farø South Bridge
Farø Bridges	bridgeName	Farø North Bridge
Martin Luther King Bridge	bridgeName	Martin Luther King Bridge
Mark Twain Memorial Bridge	bridgeName	Mark Twain Memorial Bridge
Rombak Bridge	bridgeName	Rombak Bridge
Skjomen Bridge	bridgeName	Skjomen Bridge
Beisfjord Bridge	bridgeName	Beisfjord Bridge
Cropredy Bridge	bridgeName	Cropredy Bridge
Trengsel Bridge	bridgeName	Trengsel Bridge
Efjord Bridges	bridgeName	Efjord Bridges
Dyrøy Bridge	bridgeName	Dyrøy Bridge
Sommarøy Bridge	bridgeName	Sommarøy Bridge
Sørstraumen Bridge	bridgeName	Sørstraumen Bridge
Skjervøy Bridge	bridgeName	Skjervøy Bridge
Skjervøy Bridge	bridgeName	Skattørsundet Bridge
Sami Bridge	bridgeName	Sami Bridge
Havøysund Bridge	bridgeName	Havøysund Bridge
Ramsund Bridge	bridgeName	Ramsund Bridge
Henningsvær Bridges	bridgeName	Henningsvær Bridges
Fredvang Bridges	bridgeName	Fredvang Bridges
Engeløy Bridges	bridgeName	Engeløy Bridges
Åselistraumen Bridge	bridgeName	Åselistraumen Bridge
Sandhornøy Bridge	bridgeName	Sandhornøy Bridge
Vassås Bridge	bridgeName	Vassås Bridge
Marøysund Bridge	bridgeName	Marøysund Bridge
Lokkaren Bridge	bridgeName	Lokkaren Bridge
Strelasund Crossing	bridgeName	Rügen Bridge
Strelasund Crossing	bridgeName	''Rügenbrücke
Kalvøyrevet Bridge	bridgeName	Kalvøyrevet Bridge
Brattsund Bridge	bridgeName	Brattsund Bridge
Indre Sunnan Bridge	bridgeName	Indre Sunnan Bridge
Hestøy Bridge	bridgeName	Hestøy Bridge
Smines Bridge	bridgeName	Smines Bridge
Sneppen Bridge	bridgeName	Sneppen Bridge
Aursund Bridge	bridgeName	Aursund Bridge
Mjosund Bridge	bridgeName	Mjosund Bridge
Valsøy Bridge	bridgeName	Valsøy Bridge
Bergsøysund Bridge	bridgeName	Bergsøysund Bridge
Omsund Bridge	bridgeName	Omsund Bridge
Nordsund Bridge	bridgeName	Nordsund Bridge
Storseisundet Bridge	bridgeName	Storseisundet  Bridge
Dromnessund Bridge	bridgeName	Dromnessund Bridge
Midsund Bridge	bridgeName	Midsund Bridge
Skodje Bridge	bridgeName	Skodje Bridge
Ullasund Bridge	bridgeName	Ullasund Bridge
Nerlandsøy Bridge	bridgeName	Nerlandsøy Bridge
Herøy Bridge	bridgeName	Herøy Bridge
Runde Bridge	bridgeName	Runde Bridge
Remøy Bridge	bridgeName	Remøy Bridge
Norddalsfjord Bridge	bridgeName	Norddalsfjord Bridge
Cape Cod Canal Railroad Bridge	bridgeName	Cape Cod Canal Railroad Bridge
Severn Bridge	bridgeName	Severn Bridge
West Seattle Bridge	bridgeName	West Seattle Bridge
Millennium Bridge	bridgeName	Millennium Bridge
Queen Alexandra Bridge	bridgeName	Queen Alexandra Bridge
Centennial Bridge, Panama	bridgeName	Centennial Bridge
Zárate–Brazo Largo Bridge	bridgeName	Zárate–Brazo Largo Bridge
Washington Bridge	bridgeName	Washington Bridge
Ledyard Bridge	bridgeName	Ledyard Bridge
Boulevard Bridge	bridgeName	Boulevard Bridge
The Iron Bridge	bridgeName	The Iron Bridge
Liberty Bridge, Novi Sad	bridgeName	Liberty Bridge
Huguenot Memorial Bridge	bridgeName	Huguenot Memorial Bridge
Admiral Clarey Bridge	bridgeName	Admiral Clarey Bridge
Vale of Avoca	bridgeName	Vale of Avoca
Lupu Bridge	bridgeName	Lupu Bridge
Roosevelt Island Bridge	bridgeName	Roosevelt Island Bridge
Hawarden Bridge	bridgeName	Hawarden Bridge
Runcorn Railway Bridge	bridgeName	Runcorn Railway Bridge
Ponte Sant'Angelo	bridgeName	Ponte Sant'Angelo
Pont Alexandre III	bridgeName	Pont Alexandre III
Dauphin Island Bridge	bridgeName	Gordon Persons Bridge
Macdonald-Cartier Bridge	bridgeName	Macdonald-Cartier Bridge
Archie Stevenot Bridge	bridgeName	Archie Stevenot Bridge
Daniel Carter Beard Bridge	bridgeName	Daniel Carter Beard Bridge
Brent Spence Bridge	bridgeName	Brent Spence Bridge
Sidney Lanier Bridge	bridgeName	Sidney Lanier Bridge
Gandy Bridge	bridgeName	Gandy Bridge
Westham Bridge	bridgeName	Westham Bridge
Four Bears Bridge	bridgeName	Four Bears Bridge
Melbourne Causeway	bridgeName	Melbourne Causeway
Hakuchō Bridge	bridgeName	Hakuchō Bridge
Newport Southbank Bridge	bridgeName	Newport Southbank Bridge
Airoli Bridge	bridgeName	Airoli Bridge
Airoli Bridge	bridgeName	ऐरोली पूल
Third Mainland Bridge	bridgeName	Third Mainland Bridge
Lapstone Zig Zag	bridgeName	Knapsack Viaduct
Rocky Creek Bridge	bridgeName	Rocky Creek Bridge
Wandsworth Bridge	bridgeName	Wandsworth Bridge
Taşköprü	bridgeName	Taşköprü
Eau Gallie Causeway	bridgeName	Eau Gallie Causeway
Hampden Bridge	bridgeName	Hampden Bridge
Virginia State Route 168	bridgeName	Campostella Bridge
Fulham Railway Bridge	bridgeName	Fulham Railway Bridge
Kingston Bridge, London	bridgeName	Kingston Bridge
Kingston Railway Bridge	bridgeName	Kingston Railway Bridge
Teddington Lock Footbridges	bridgeName	Teddington Lock Footbridge
Richmond Railway Bridge	bridgeName	Richmond Railway Bridge
Chiswick Bridge	bridgeName	Chiswick Bridge
Barnes Railway Bridge	bridgeName	Barnes Railway Bridge
Hampton Court Bridge	bridgeName	Hampton Court Bridge
Hammersmith flyover	bridgeName	Hammersmith flyover
Gwangandaegyo	bridgeName	Gwangandaegyo
Florida Avenue Bridge	bridgeName	Florida Avenue Bridge
Lady Bay Bridge	bridgeName	Lady Bay Bridge
Mountain Creek Lake Bridge	bridgeName	Mountain Creek Lake Bridge
Chertsey Bridge	bridgeName	Chertsey Bridge
Alvord Lake Bridge	bridgeName	Alvord Lake Bridge
Suramadu Bridge	bridgeName	Suramadu Bridge
Reversing Falls Railway Bridge	bridgeName	Reversing Falls Railway Bridge
Seal Island Bridge	bridgeName	Seal Island Bridge
Card Sound Bridge	bridgeName	Card Sound Bridge
Sam Houston Ship Channel Bridge	bridgeName	Sam Houston Tollway Ship Channel Bridge
Lewisville Lake Toll Bridge	bridgeName	Lewisville Lake Toll Bridge
Wakota Bridge	bridgeName	Wakota Bridge
Percy Burn Viaduct	bridgeName	Percy Burn Viaduct
Chaudière Bridge	bridgeName	Chaudière Bridge
Keystone Wye	bridgeName	Keystone Wye
Fehmarn Belt Fixed Link	bridgeName	Fehmarn Belt Fixed Link
Mendota Bridge	bridgeName	Mendota Bridge
Folly Bridge	bridgeName	Folly Bridge
Bridge to Nowhere	bridgeName	Bridge to Nowhere
Gravina Island Bridge	bridgeName	Gravina Island Bridge
Fort Duquesne Bridge	bridgeName	Fort Duquesne Bridge
11th Street Bridges	bridgeName	11
Fred Hartman Bridge	bridgeName	Fred Hartman Bridge
Delaware Water Gap Toll Bridge	bridgeName	Delaware Water Gap Toll Bridge
Yokohama Bay Bridge	bridgeName	Yokohama Bay Bridge
Palace Bridge	bridgeName	Palace Bridge
Palace Bridge	bridgeName	Дворцо́вый мост
William A. Stickel Memorial Bridge	bridgeName	William A. Stickel Memorial Bridge
John McLoughlin Bridge	bridgeName	John McLoughlin Bridge
Cavenagh Bridge	bridgeName	Cavenagh Bridge
Kingston–Rhinecliff Bridge	bridgeName	Kingston–Rhinecliff Bridge
Kingston–Port Ewen Suspension Bridge	bridgeName	Kingston–Port Ewen Suspension Bridge
Treasure Island Causeway	bridgeName	Treasure Island Causeway
Elgin Bridge	bridgeName	Elgin Bridge
Walkway over the Hudson	bridgeName	Walkway over the Hudson
Waldo–Hancock Bridge	bridgeName	Waldo–Hancock Bridge
Surgut Bridge	bridgeName	Surgut Bridge
Anderson Bridge	bridgeName	Anderson Bridge
Castleton Bridge	bridgeName	Castleton Bridge
Bulkeley Bridge	bridgeName	Bulkeley Bridge
Svatopluk Čech Bridge	bridgeName	Čechův most
Crooked River High Bridge	bridgeName	Crooked River  Bridge
Lewis and Clark River Bridge	bridgeName	Lewis and Clark River Bridge
Sky Ride	bridgeName	300
Wilburton Trestle	bridgeName	Wilburton Trestle
M. Harvey Taylor Memorial Bridge	bridgeName	M. Harvey Taylor Memorial Bridge
Walnut Street Bridge	bridgeName	Walnut Street Bridge
Columbia–Wrightsville Bridge	bridgeName	Veterans Memorial Bridge
Columbia–Wrightsville Bridge	bridgeName	Columbia&ndash;Wrightsville Bridge
Clair–Fort Kent Bridge	bridgeName	Clair – Fort Kent Bridge
Gatehampton Railway Bridge	bridgeName	Gatehampton Railway Bridge
Replot Bridge	bridgeName	Replot Bridge
Cable Bridge	bridgeName	Cable Bridge
Market Street Bridge	bridgeName	Market Street Bridge
Silver Memorial Bridge	bridgeName	Silver Memorial Bridge
Henley Bridge	bridgeName	Henley Bridge
Thaddeus Kosciusko Bridge	bridgeName	Thaddeus Kosciusko Bridge
Kosciuszko Bridge	bridgeName	Kosciuszko Bridge
Edison Bridge	bridgeName	Edison Bridge
Godstow Bridge	bridgeName	Godstow Bridge
North–South Expressway Central Link	bridgeName	Batu Tiga flyover
Damansara–Puchong Expressway	bridgeName	LDP Cable-Stayed Bridge
Deception Pass Bridge	bridgeName	Deception Pass Bridge
Jamaraat Bridge	bridgeName	Jamaraat Bridge
Bandra–Worli Sea Link	bridgeName	Bandra-Worli Sea Link
Courtney Campbell Causeway	bridgeName	Courtney Campbell Causeway
Bayview Bridge	bridgeName	Bayview Bridge
Great River Bridge	bridgeName	Great River Bridge
Queen Elizabeth Bridge	bridgeName	Queen Elizabeth Bridge
Quincy Memorial Bridge	bridgeName	Quincy Memorial Bridge
Mark Morris Memorial Bridge	bridgeName	Mark Morris Memorial Bridge
Savanna–Sabula Bridge	bridgeName	Savanna-Sabula Bridge
Gateway Bridge	bridgeName	Gateway Bridge
Hutsonville Bridge	bridgeName	Hutsonville Bridge
Putra Bridge	bridgeName	Putra Bridge
Kingsgate Bridge	bridgeName	Kingsgate Bridge
Keokuk–Hamilton Bridge	bridgeName	Keokuk-Hamilton Bridge
Fort Madison Toll Bridge	bridgeName	Fort Madison Toll Bridge
East Channel Bridge	bridgeName	East Channel Bridge
Winterbrook Bridge	bridgeName	Winterbrook Bridge
Wallingford Bridge	bridgeName	Wallingford Bridge
Cotter Bridge	bridgeName	Cotter Bridge
Marquette–Joliet Bridge	bridgeName	Marquette–Joliet Bridge
Prescott Drawbridge	bridgeName	Prescott Drawbridge
North Channel Bridge	bridgeName	North Channel Bridge
Wabasha–Nelson Bridge	bridgeName	Wabasha–Nelson Bridge
Lafayette Bridge	bridgeName	Lafayette Bridge
High Bridge	bridgeName	Smith Avenue High Bridge
Joseph P. Addabbo Memorial Bridge	bridgeName	Joseph P. Addabbo Memorial Bridge
Coraopolis Bridge	bridgeName	Coraopolis Bridge
Duke Ellington Bridge	bridgeName	Duke Ellington Bridge
Uddevalla Bridge	bridgeName	Uddevalla Bridge
Svinesund Bridge	bridgeName	Svinesund Bridge
Jordan Bridge	bridgeName	South Norfolk Jordan Bridge
Gilmerton Bridge	bridgeName	Gilmerton Bridge
Elvet Bridge	bridgeName	Elvet Bridge
Chelfham Viaduct	bridgeName	Chelfham Viaduct
Hardinge Bridge	bridgeName	Hardinge Bridge
Hardinge Bridge	bridgeName	হার্ডিঞ্জ ব্রিজ
Lalon Shah Bridge	bridgeName	Lalon Shah Bridge
Lalon Shah Bridge	bridgeName	লালন শাহ সেতু
Champ Clark Bridge	bridgeName	Champ Clark Bridge
Clark Bridge	bridgeName	Clark Bridge
Gramercy Bridge	bridgeName	Gramercy Bridge
Sunshine Bridge	bridgeName	Sunshine Bridge
Horace Wilkinson Bridge	bridgeName	Horace Wilkinson Bridge
Huey P. Long Bridge	bridgeName	Huey P. Long Bridge
Memphis & Arkansas Bridge	bridgeName	Memphis & Arkansas Bridge
Helena Bridge	bridgeName	Helena Bridge
Charles W. Dean Bridge	bridgeName	Charles W. Dean Bridge
Benjamin G. Humphreys Bridge	bridgeName	Benjamin G. Humphreys Bridge
Old Vicksburg Bridge	bridgeName	Old Vicksburg Bridge
Vicksburg Bridge	bridgeName	Vicksburg Bridge
Natchez–Vidalia Bridge	bridgeName	Natchez-Vidalia Bridge
Alkaff Bridge	bridgeName	Alkaff Bridge
Frisco Bridge	bridgeName	Frisco Bridge
Harahan Bridge	bridgeName	Harahan Bridge
Hernando de Soto Bridge	bridgeName	Hernando de Soto Bridge
Caruthersville Bridge	bridgeName	Caruthersville Bridge
Cairo Mississippi River Bridge	bridgeName	Cairo Mississippi River Bridge
Cairo I-57 Bridge	bridgeName	Cairo I-57 Bridge
Thebes Bridge	bridgeName	Thebes Bridge
Chester Bridge	bridgeName	Chester Bridge
Bill Emerson Memorial Bridge	bridgeName	Bill Emerson Memorial Bridge
Kolbäck Bridge	bridgeName	Kolbäck Bridge
CRRNJ Newark Bay Bridge	bridgeName	Newark Bay
William R. Bennett Bridge	bridgeName	William R. Bennett Bridge
Libertador General San Martín Bridge	bridgeName	Libertador General San Martín Bridge
General Artigas Bridge	bridgeName	Libertador General San Martín Bridge
Salto Grande Bridge	bridgeName	Libertador General San Martín Bridge
Paso de los Libres–Uruguaiana International Bridge	bridgeName	Paso de los Libres – Uruguaiana International Bridge
New Chain of Rocks Bridge	bridgeName	New Chain of Rocks Bridge
General Belgrano Bridge	bridgeName	General Manuel Belgrano Bridge
Pira Delal	bridgeName	Delal
Delair Bridge	bridgeName	Delair Bridge
Delaware River–Turnpike Toll Bridge	bridgeName	Delaware River–Turnpike Toll Bridge
Al Garhoud Bridge	bridgeName	Al Garhoud Bridge
Si-o-seh pol	bridgeName	Si-o-se Pol
Arthur Kill Vertical Lift Bridge	bridgeName	Arthur Kill Vertical Lift Bridge
Trammell Bridge	bridgeName	Trammell Bridge
Wright's Ferry Bridge	bridgeName	Wright's Ferry Bridge
Susquehanna River Bridge	bridgeName	Susquehanna River Bridge
Katima Mulilo Bridge	bridgeName	Katima Mulilo Bridge
Burdekin Bridge	bridgeName	Burdekin Bridge
Merchants Bridge	bridgeName	Merchants Bridge
Bosphorus Bridge	bridgeName	--07-15
Bosphorus Bridge	bridgeName	(15 Temmuz Şehitler Köprüsü )
Maidenhead Bridge	bridgeName	Maidenhead Bridge
Trenton–Morrisville Toll Bridge	bridgeName	Trenton-Morrisville Toll Bridge
Bridge 10, Erie Canal	bridgeName	Bridge 10
Parit Sulong Bridge	bridgeName	Sungai Simpang Kiri Bridge
Sultan Ismail Bridge	bridgeName	Sungai Muar Bridge
Muar Second Bridge	bridgeName	Sungai Muar Bridge
Raja Pemaisuri Bainun Bridge	bridgeName	Sungai Dinding Bridge
Tarr Steps	bridgeName	Tarr Steps
Welland Viaduct	bridgeName	Welland Viaduct
Carrick-a-Rede Rope Bridge	bridgeName	Carrick-a-Rede Rope Bridge
Landwasser Viaduct	bridgeName	Landwasser Viaduct
Bridge 8, Erie Canal	bridgeName	Bridge 8
Sea Cliff Bridge	bridgeName	Sea Cliff Bridge
U.S. Grant Bridge	bridgeName	U.S. Grant Bridge
Sciotoville Bridge	bridgeName	Sciotoville Bridge
Moray Bridge	bridgeName	Moray Bridge
Sea Island Connector	bridgeName	Sea Island Connector
Michigan Central Railway Bridge	bridgeName	Michigan Central Railway Bridge
Hanover Street Bridge	bridgeName	Hanover Street Bridge
Sherman Minton Bridge	bridgeName	Sherman Minton Bridge
Itchen Bridge	bridgeName	Itchen Bridge
Sultan Mahmud Bridge	bridgeName	Sungai Terengganu Bridge
Kuala Krai Bridge	bridgeName	Kuala Krai Bridge
Buloh Kasap Bridge	bridgeName	Sungai Muar Bridge
Iron Cove Bridge	bridgeName	Iron Cove Bridge
Sewickley Bridge	bridgeName	Sewickley Bridge
Permas Jaya Bridge	bridgeName	Permas Jaya Bridge
Raymond E. Baldwin Bridge	bridgeName	Raymond E. Baldwin Bridge
Cairo Ohio River Bridge	bridgeName	Cairo Ohio River Bridge
Gold Star Memorial Bridge	bridgeName	Gold Star Memorial Bridge
Esplanade Riel	bridgeName	Esplanade Riel
Lesner Bridge	bridgeName	Lesner Bridge
CSX Susquehanna River Bridge	bridgeName	CSX Susquehanna River Bridge
Norman Wood Bridge	bridgeName	Norman Wood Bridge
Pennsylvania Railroad Bridge	bridgeName	Pennsylvania Railroad Bridge
John Harris Bridge	bridgeName	John Harris Bridge/South Bridge
Philadelphia & Reading Railroad Bridge	bridgeName	Philadelphia & Reading Railroad Bridge
Cumberland Valley Railroad Bridge	bridgeName	Cumberland Valley Railroad Bridge
Dinsmore Bridge	bridgeName	Dinsmore Bridge
Louisiana Railroad Bridge	bridgeName	Louisiana Railroad Bridge
Eleanor Schonell Bridge	bridgeName	Eleanor Schonell
Lucan Bridge	bridgeName	Lucan Bridge
Anna Livia Bridge	bridgeName	Anna Livia Bridge
Farmleigh Bridge	bridgeName	Farmleigh Bridge
Liffey Railway Bridge	bridgeName	Liffey Railway Bridge
Islandbridge	bridgeName	Islandbridge
Veterans Bridge	bridgeName	Veterans Bridge
Cabrillo Bridge	bridgeName	Cabrillo Bridge
I-90 Mississippi River Bridge	bridgeName	I-90 Mississippi River Bridge
Seri Wawasan Bridge	bridgeName	Seri Wawasan Bridge
Seri Saujana Bridge	bridgeName	Seri Saujana Bridge
Beaver Bridge	bridgeName	Beaver Bridge
North Grand Island Bridge	bridgeName	North Grand Island Bridge
South Grand Island Bridge	bridgeName	South Grand Island Bridge
International Railway Bridge	bridgeName	International Railway Bridge
Morrisville–Trenton Railroad Bridge	bridgeName	Morrisville&ndash;Trenton Railroad Bridge
West Trenton Railroad Bridge	bridgeName	West Trenton Railroad Bridge
Wabash Bridge	bridgeName	Wabash Bridge
Ponte Conde de Linhares	bridgeName	Count of Linhares Bridge
Seri Perdana Bridge	bridgeName	Seri Perdana Bridge
King Edward VII Bridge	bridgeName	King Edward VII Bridge
Redheugh Bridge	bridgeName	Redheugh Bridge
Quincy Rail Bridge	bridgeName	Quincy Rail Bridge
Keokuk Rail Bridge	bridgeName	Keokuk Bridge
Burlington Rail Bridge	bridgeName	Burlington Rail Bridge
Monorail Suspension Bridge	bridgeName	Monorail Suspension Bridge
Grenland Bridge	bridgeName	Grenland bridge
Keithsburg Rail Bridge	bridgeName	Keithsburg Bridge
Norbert F. Beckey Bridge	bridgeName	Norbert F. Beckey Bridge
Sergeant John F. Baker Jr. Bridge	bridgeName	Sergeant John F. Baker Jr. Bridge
Crescent Rail Bridge	bridgeName	Crescent Bridge
Elgeseter Bridge	bridgeName	Elgeseter Bridge
Seri Gemilang Bridge	bridgeName	Seri Gemilang Bridge
Seri Bestari Bridge	bridgeName	Seri Bestari Bridge
Seri Bakti Bridge	bridgeName	Seri Bakti Bridge
Seri Setia Bridge	bridgeName	Seri Setia Bridge
Osterøy Bridge	bridgeName	Osterøy Bridge
John A. Blatnik Bridge	bridgeName	John A. Blatnik Bridge
Captain William J. Hudson %22Steamboat Bill%22 Memorial Bridges	bridgeName	Captain William J. Hudson \
MacArthur Bridge	bridgeName	MacArthur Bridge
Grosse Ile Toll Bridge	bridgeName	Grosse Ile Toll Bridge
Karmsund Bridge	bridgeName	Karmsund Bridge
53rd Street Tunnel	bridgeName	53
Rikers Island Bridge	bridgeName	Rikers Island Bridge
Wards Island Bridge	bridgeName	Wards Island Bridge
Esplanade Bridge	bridgeName	Esplanade Bridge
Third Avenue Bridge	bridgeName	Third Avenue Bridge
Park Avenue Bridge	bridgeName	Park Avenue Bridge
145th Street Bridge	bridgeName	145
Madison Avenue Bridge	bridgeName	Madison Avenue Bridge
University Heights Bridge	bridgeName	University Heights Bridge
Spuyten Duyvil Bridge	bridgeName	Spuyten Duyvil Bridge
Alfred H. Smith Memorial Bridge	bridgeName	Alfred H. Smith Memorial Bridge
Dunn Memorial Bridge	bridgeName	Dunn Memorial Bridge
Martin Luther King Bridge	bridgeName	Gulfgate Bridge
Menands Bridge	bridgeName	Menands Bridge
Congress Street Bridge	bridgeName	Congress Street Bridge
Green Island Bridge	bridgeName	Green Island Bridge
Collar City Bridge	bridgeName	Collar City Bridge
Troy–Waterford Bridge	bridgeName	Troy&ndash;Waterford Bridge
Michigan Avenue Bridge	bridgeName	Michigan Avenue Bridge
Hudson River Way	bridgeName	Hudson River Way
Okanagan Lake Bridge	bridgeName	Kelowna Floating Bridge
Deer Isle Bridge	bridgeName	Deer Isle Bridge
Interstate 78 Toll Bridge	bridgeName	Interstate 78 Toll Bridge
Cedar Avenue Bridge	bridgeName	Cedar Avenue Bridge
Ogdensburg–Prescott International Bridge	bridgeName	Ogdensburg–Prescott International Bridge
Amu Darya Pipeline Bridge	bridgeName	Amu Darya Pipeline Bridge
Yichang Yangtze River Highway Bridge	bridgeName	Yichang Bridge
Clay Wade Bailey Bridge	bridgeName	Clay Wade Bailey Bridge
Taylor–Southgate Bridge	bridgeName	Taylor-Southgate Bridge
Combs–Hehl Bridge	bridgeName	Combs&ndash;Hehl Bridge
Simon Kenton Memorial Bridge	bridgeName	Simon Kenton Memorial Bridge
Government Bridge	bridgeName	Government Bridge
Clinton Railroad Bridge	bridgeName	Clinton Railroad Bridge
William H. Harsha Bridge	bridgeName	William H. Harsha Bridge
High Bridge of Kentucky	bridgeName	High Bridge
Big Four Bridge	bridgeName	Big Four Bridge
Sabula Rail Bridge	bridgeName	Sabula Rail Bridge
Dubuque Rail Bridge	bridgeName	Dubuque Rail Bridge
Johor Bahru Eastern Dispersal Link Expressway	bridgeName	EDL flyover
Barrett's Ferry Bridge	bridgeName	Barrett's Ferry Bridge
Dominion Boulevard Steel Bridge	bridgeName	Steel Bridge
Robert Street Bridge	bridgeName	Robert Street Bridge
Mississippi River Bridge	bridgeName	Mississippi River Bridge
Mississippi River Bridge	bridgeName	La Crosse, Wisconsin
Panhandle Bridge	bridgeName	Panhandle Bridge
South Tenth Street Bridge	bridgeName	South Tenth Street Bridge
Birmingham Bridge	bridgeName	Birmingham Bridge
Glenwood Bridge	bridgeName	Glenwood Bridge
Glenwood B&O Railroad Bridge	bridgeName	Glenwood B&O Railroad Bridge
Fort Wayne Railroad Bridge	bridgeName	Fort Wayne Railroad Bridge
Pinkerton's Landing Bridge	bridgeName	Pinkerton's Landing Bridge
Carrie Furnace Hot Metal Bridge	bridgeName	Carrie Furnace Hot Metal Bridge
Linn Cove Viaduct	bridgeName	Linn Cove Viaduct
C&O Railroad Bridge	bridgeName	C&O Railroad Bridge
Hope Memorial Bridge	bridgeName	Hope Memorial Bridge
Detroit–Superior Bridge	bridgeName	Detroit–Superior Bridge
No. 2 Road Bridge	bridgeName	No. 2 Road Bridge
Georgia Viaduct	bridgeName	Georgia Viaduct
Pont de la Concorde	bridgeName	Concordia Bridge
Uhlerstown–Frenchtown Bridge	bridgeName	Uhlerstown&ndash;Frenchtown Bridge
Charles M. Braga Jr. Memorial Bridge	bridgeName	Braga Bridge
Lumberville–Raven Rock Bridge	bridgeName	Lumberville&ndash;Raven Rock Bridge
Washington Bridge	bridgeName	Washington Bridge
Wabasha Street Bridge	bridgeName	Wabasha Street Bridge
West End Bridge	bridgeName	West End Bridge
Laughery Creek Bridge	bridgeName	Laughery Creek Bridge
Derwent Way Bridge	bridgeName	Derwent Way Bridge
Bollman Truss Railroad Bridge	bridgeName	Bollman Suspension and Trussed Bridge
Asparuhov most	bridgeName	Asparuhov most
Asparuhov most	bridgeName	Аспарухов мост
Covered Bridge, Lovech	bridgeName	Covered Bridge
Belenski most	bridgeName	Belenski most
Rankin Bridge	bridgeName	Rankin Bridge
Milton–Madison Bridge	bridgeName	Milton–Madison Bridge
John F. Kennedy Memorial Bridge	bridgeName	John F. Kennedy Memorial Bridge
Älvsborg Bridge	bridgeName	Älvsborgsbron
Carrollton Viaduct	bridgeName	Carrollton Viaduct
Thomas Viaduct	bridgeName	Thomas Viaduct
Patterson Viaduct	bridgeName	Patterson Viaduct
Bloomington Viaduct	bridgeName	Bloomington Viaduct
Wills Creek Bollman Bridge	bridgeName	Wills Creek Bollman Bridge
Reedy Point Bridge	bridgeName	Reedy Point Bridge
St. Georges Bridge	bridgeName	St. Georges Bridge
Chesapeake & Delaware Canal Lift Bridge	bridgeName	Chesapeake & Delaware Canal Lift Bridge
Vizcaya Bridge	bridgeName	Vizcaya Bridge
Old Dee Bridge	bridgeName	Old Dee Bridge
Summit Bridge	bridgeName	Summit Bridge
Chesapeake City Bridge	bridgeName	Chesapeake City Bridge
San Roque González de Santa Cruz Bridge	bridgeName	San Roque González de Santa Cruz Bridge
Lótus Bridge	bridgeName	Lótus Bridge
Waibaidu Bridge	bridgeName	Waibaidu Bridge
Garden Bridge	bridgeName	Garden Bridge
Nusle Bridge	bridgeName	Nusle Bridge
Mỹ Thuận Bridge	bridgeName	Mỹ Thuận Bridge
Sarah Mildred Long Bridge	bridgeName	Sarah Mildred Long Bridge
Hale Boggs Memorial Bridge	bridgeName	Hale Boggs Memorial Bridge
High Rise Bridge	bridgeName	High Rise Bridge
Bunting Island Bridge	bridgeName	Bunting Island Bridge
Xiling Yangtze River Bridge	bridgeName	Xiling Yangtze River Bridge
Humen Pearl River Bridge	bridgeName	Humen Pearl River Bridge
Dazi Bridge	bridgeName	Dazi Bridge
Lincoln Trail Bridge	bridgeName	Bob Cummings Lincoln Trail Bridge
Semey Bridge	bridgeName	Semey Bridge
Hirado Bridge	bridgeName	Hirado Bridge
Egongyan Bridge	bridgeName	Egongyan Bridge
Pelješac Bridge	bridgeName	Pelješac Bridge
Donghai Bridge	bridgeName	Donghai Bridge
Merdeka Bridge, Malaysia	bridgeName	Sungai Muda Bridge
Seventh Street Improvement Arches	bridgeName	Seventh Street Improvement Arches
Črni Kal Viaduct	bridgeName	Črni Kal Viaduct
Old Bridge, Svilengrad	bridgeName	The Old Bridge
Fort Road Bridge	bridgeName	Fort Road Bridge
Queen Elizabeth II Bridge, Newcastle upon Tyne	bridgeName	Queen Elizabeth II Metro Bridge
Intercity Bridge	bridgeName	Intercity Bridge
Shantou Bay Bridge	bridgeName	Shantou Bay Bridge
Haicang Bridge	bridgeName	Haicang Bridge
Fengdu Yangtze River Bridge	bridgeName	Fengdu Yangtze River Bridge
Lake Street-Marshall Bridge	bridgeName	Lake Street-Marshall Avenue Bridge
Short Line Bridge	bridgeName	Short Line Bridge
Dartmouth Bridge	bridgeName	Dartmouth Bridge
Northern Pacific Bridge Number 9	bridgeName	Northern Pacific Bridge #9
Dyavolski most	bridgeName	Dyavolski most
Allenby Bridge	bridgeName	Allenby Bridge
Rickenbacker Causeway	bridgeName	Rickenbacker Causeway
Rachel Carson Bridge	bridgeName	Rachel Carson Bridge
Newport City footbridge	bridgeName	Newport City footbridge
Danube Bridge	bridgeName	Giurgiu–Ruse Bridge
Sungai Johor Bridge	bridgeName	Sungai Johor Bridge
Cape Girardeau Bridge	bridgeName	Cape Girardeau Bridge
St. Julian's railway bridge	bridgeName	St Julian's railway bridge
Commodore Schuyler F. Heim Bridge	bridgeName	Commodore Schuyler F. Heim Bridge
Red Wing Bridge	bridgeName	Eisenhower Bridge
Princes Bridge	bridgeName	Princes Bridge
Traffic Bridge	bridgeName	Traffic Bridge
La Crosse Rail Bridge	bridgeName	La Crosse-La Crescent Canadian Pacific Railway, Main Channel Bridge
Main Channel Bridge	bridgeName	Main Channel Bridge
Hastings Rail Bridge	bridgeName	Hastings Rail Bridge
University Bridge	bridgeName	University Bridge
Broadway Bridge	bridgeName	Broadway Bridge
Hastings High Bridge	bridgeName	Hastings High Bridge
Senator Sid Buckwold Bridge	bridgeName	Senator Sid Buckwold Bridge
Bolivar Bridge	bridgeName	Bolivar Bridge
Matadi Bridge	bridgeName	Matadi Bridge / OEBK Bridge
Lysefjord Bridge	bridgeName	Lysefjord Bridge
Thuận Phước Bridge	bridgeName	Thuận Phước Bridge
Emmerich Rhine Bridge	bridgeName	Emmerich Rhine Bridge
Namhae Bridge	bridgeName	Namhae Bridge
Pont d'Aquitaine	bridgeName	Pont d'Aquitaine
Yeongjong Bridge	bridgeName	Yeongjong Bridge
Neville Island Bridge	bridgeName	Neville Island Bridge
McKees Rocks Bridge	bridgeName	McKees Rocks Bridge
Fig Tree Bridge	bridgeName	Fig Tree Bridge
Tarban Creek Bridge	bridgeName	Tarban Creek Bridge
Ohio Connecting Railroad Bridge	bridgeName	Ohio Connecting Bridge
Ambridge–Aliquippa Bridge	bridgeName	Ambridge&ndash;Aliquippa Bridge
Circle Drive Bridge	bridgeName	Circle Drive Bridge
Lennox Bridge, Parramatta	bridgeName	Lennox Bridge
Souleuvre Viaduct	bridgeName	Souleuvre Viaduct
Rochester–Monaca Bridge	bridgeName	Monaca&ndash;Rochester Bridge
Veterans Memorial Bridge	bridgeName	Veterans Memorial Bridge
Monaca–East Rochester Bridge	bridgeName	Monaca–East Rochester Bridge
Robert C. Byrd Bridge	bridgeName	Robert C. Byrd Bridge
Bridgeport Bridge	bridgeName	Bridgeport Bridge
Ben Williamson Memorial Bridge	bridgeName	Ben Williamson Memorial Bridge
Carroll Lee Cropper Bridge	bridgeName	Carroll Lee Cropper Bridge
East Huntington Bridge	bridgeName	Frank Gatski Memorial Bridge
Fort Henry Bridge	bridgeName	Fort Henry Bridge
Interstate 470 Bridge	bridgeName	Interstate 470 Bridge
Marietta–Williamstown Interstate Bridge	bridgeName	Marietta–Williamstown Interstate Bridge
Ironton–Russell Bridge	bridgeName	Ironton&ndash;Russell Bridge
Jesse Stuart Memorial Bridge	bridgeName	Jesse Stuart Memorial Bridge
Norfolk Southern Bridge	bridgeName	Norfolk Southern Bridge
Moundsville Bridge	bridgeName	Moundsville Bridge
Pomeroy–Mason Bridge	bridgeName	Pomeroy&ndash;Mason Bridge
Simeon Willis Memorial Bridge	bridgeName	Simeon Willis Memorial Bridge
Williamstown Bridge	bridgeName	Williamstown Bridge
Paseo Bridge	bridgeName	Paseo Bridge
Anoka-Champlin Mississippi River Bridge	bridgeName	Anoka-Champlin Mississippi River Bridge
John James Audubon Bridge	bridgeName	John James Audubon Bridge
Bebresh Viaduct	bridgeName	Bebresh Viaduct
Marco Polo Bridge	bridgeName	Lugou Bridge
Trinity Bridge, Saint Petersburg	bridgeName	Trinity Bridge
Trinity Bridge, Saint Petersburg	bridgeName	Тро́ицкий мост
Minneapolis BNSF Rail Bridge	bridgeName	Minneapolis BNSF Rail Bridge
Broadway Avenue Bridge	bridgeName	Broadway Avenue Bridge
Northern Pacific-BNSF Minneapolis Rail Bridge	bridgeName	Northern Pacific-BNSF Minneapolis Rail Bridge
Krk Bridge	bridgeName	Krčki most
Nehru Bridge	bridgeName	Nehru Bridge
Ellis Bridge	bridgeName	Swami Vivekananda Bridge
Richmond Bridge	bridgeName	Richmond Bridge
Clifton Hampden Bridge	bridgeName	Clifton Hampden Bridge
Omaha Road Bridge Number 15	bridgeName	Omaha Road Bridge #15
Blanchette Memorial Bridge	bridgeName	Blanchette Memorial Bridge
Discovery Bridge	bridgeName	Discovery Bridge
Erasmusbrug	bridgeName	Erasmus Bridge
Hardanger Bridge	bridgeName	Hardanger Bridge
Donnington Bridge	bridgeName	Donnington Bridge
Richard P. Braun Bridge	bridgeName	Richard P. Braun Bridge
I-694 Bridge	bridgeName	I-694 Bridge
Camden Bridge	bridgeName	Camden Bridge
Canadian Pacific Camden Place Rail Bridge	bridgeName	Canadian Pacific Camden Place Rail Bridge
Lowry Avenue Bridge	bridgeName	Lowry Avenue Bridge
I-35W Mississippi River bridge	bridgeName	I-35W Mississippi River bridge
Semyonovsky Bridge	bridgeName	Semenovsky Bridge
Belle Vernon Bridge	bridgeName	Belle Vernon Bridge
Sheppard Avenue Bridge	bridgeName	Sheppard Avenue Bridge
Great Egg Harbor Bridge	bridgeName	Great Egg Harbor Bridge
St. Paul Union Pacific Vertical-lift Rail Bridge	bridgeName	St. Paul Union Pacific Vertical-lift Rail Bridge
St. Paul Union Pacific Rail Bridge	bridgeName	St. Paul Union Pacific Rail Bridge
Betty Adkins Bridge	bridgeName	Betty Adkins Bridge
Parrish Avenue Bridge	bridgeName	Parrish Avenue Bridge
Highway 25 Bridge	bridgeName	Monticello Highway Bridge
Highway 24 Bridge	bridgeName	Highway 24 Bridge
University Bridge	bridgeName	University Bridge
St. Cloud Rail Bridge	bridgeName	St. Cloud Rail Bridge
Veterans Bridge	bridgeName	Veterans Bridge
DeSoto Bridge	bridgeName	DeSoto Bridge
Sauk Rapids Bridge	bridgeName	Sauk Rapids Bridge
Bridge of Hope	bridgeName	Bridge of Hope
Bringle Ferry Bridge	bridgeName	Bringle Ferry Bridge
Daniel Boone Bridge	bridgeName	Daniel Boone Bridge
Old St. Charles Bridge	bridgeName	Old St. Charles Bridge
Hohenzollern Bridge	bridgeName	Hohenzollern Bridge
Claiborne Avenue Bridge	bridgeName	Claiborne Avenue Bridge
Middle Bridge	bridgeName	Middle Bridge
Isaac Lee Patterson Bridge	bridgeName	Isaac Lee Patterson Bridge
Bristol Bridge	bridgeName	Bristol Bridge
Gerald Desmond Bridge	bridgeName	Gerald Desmond Bridge
Champlain Bridge	bridgeName	Champlain Bridge
Mendota Road Bridge	bridgeName	Mendota Road Bridge
Tharwa Bridge	bridgeName	Tharwa Bridge
Mathers Bridge	bridgeName	Mathers Bridge
Little Current Swing Bridge	bridgeName	Little Current Swing Bridge
Hartland Bridge	bridgeName	Hartland Bridge
Cheongdam Bridge	bridgeName	Cheongdam Bridge
Buck O'Neil Bridge	bridgeName	Buck O'Neil Bridge
Pont au Change	bridgeName	Pont au Change
Starrucca Viaduct	bridgeName	starrucca viaduct
Albert Memorial Bridge	bridgeName	Albert Memorial Bridge
North Avenue Bridge	bridgeName	North Avenue Bridge
Foresthill Bridge	bridgeName	Foresthill Bridge
Captain Cook Bridge, New South Wales	bridgeName	Captain Cook Bridge, Sydney
Tom Uglys Bridge	bridgeName	Tom Uglys Bridge
Alfords Point Bridge	bridgeName	Alfords Point Bridge
The Tridge	bridgeName	The Tridge
George N. Wade Memorial Bridge	bridgeName	George N. Wade Memorial Bridge
Clarks Ferry Bridge	bridgeName	Clarks Ferry Bridge
Mala Rijeka Viaduct	bridgeName	The Mala Rijeka Viaduct
Maria Pia Bridge	bridgeName	Maria Pia Bridge
Charles Berry Bridge	bridgeName	Charles Berry Bridge
Franklin Street Bridge	bridgeName	Franklin–Orleans Street Bridge
Marysville Bridge	bridgeName	Marysville Bridge
Aqueduct Bridge	bridgeName	Aqueduct Bridge
Reichsbrücke	bridgeName	Reichsbrücke
Cape Fear Memorial Bridge	bridgeName	Cape Fear Memorial Bridge
Arrigoni Bridge	bridgeName	Charles J. Arrigoni Bridge
Marion Memorial Bridge	bridgeName	Marion Memorial Bridge
Tunkhannock Viaduct	bridgeName	Tunkhannock Creek Viaduct
Christopher S. Bond Bridge	bridgeName	Christopher S. Bond Bridge
Basilone Memorial Bridge	bridgeName	Basilone Memorial Bridge
Albany Street Bridge	bridgeName	Albany Street Bridge
Raritan Bay Drawbridge	bridgeName	Raritan Bay Drawbridge
Landing Lane Bridge	bridgeName	Landing Lane Bridge
Oregon Inlet	bridgeName	Herbert C. Bonner Bridge
Portland–Columbia Toll Bridge	bridgeName	Portland–Columbia Toll Bridge
Erb's Covered Bridge	bridgeName	Erb's Covered Bridge
Mayo Bridge	bridgeName	Mayo's Bridge
Manchester Bridge	bridgeName	Manchester Bridge
Old Clark Bridge	bridgeName	Clark Bridge
Frank E. Bauer Bridge	bridgeName	Frank E. Bauer Bridge
Swinford Toll Bridge	bridgeName	Swinford Toll Bridge
Two Cent Bridge	bridgeName	Two Cent Bridge
Willemsbrug	bridgeName	Willemsbrug
Bayside Bridge	bridgeName	Pinellas County Bayside Bridge
Escambia Bay Bridge	bridgeName	Escambia Bay Bridge
Conowingo Bridge	bridgeName	Conowingo Bridge
CNR Bridge	bridgeName	CNR Bridge
Sultan Yahya Petra Bridge	bridgeName	Sungai Kelantan Bridge
Sultan Ahmad Shah II Bridge	bridgeName	Sungai Pahang Bridge
Ross Bridge	bridgeName	Ross Bridge
Beesley's Point Bridge	bridgeName	Beesley's Point Bridge
ASB Bridge	bridgeName	ASB Bridge
Hannibal Bridge	bridgeName	Hannibal Bridge
Heart of America Bridge	bridgeName	Heart of America Bridge
Blue Bridge	bridgeName	Blue Bridge
Bolshoy Obukhovsky Bridge	bridgeName	Bolshoi Obukhovsky Bridge
Bolshoy Obukhovsky Bridge	bridgeName	Большо́й Обу́ховский мост
Đurđevića Tara Bridge	bridgeName	Đurđevića Tara Bridge
New Hope–Lambertville Toll Bridge	bridgeName	New Hope&ndash;Lambertville Toll Bridge
Barrage Vauban	bridgeName	Barrage Vauban
Parkersburg Bridge	bridgeName	Parkersburg Bridge
Hawthorn Bridge	bridgeName	Hawthorn Bridge
George Rogers Clark Memorial Bridge	bridgeName	George Rogers Clark Memorial Bridge
Walnut Lane Memorial Bridge	bridgeName	Walnut Lane Memorial Bridge
Eko Bridge	bridgeName	Eko Bridge
Barwon Heads Bridge	bridgeName	Barwon Heads Bridge
Matthew E. Welsh Bridge	bridgeName	Matthew E. Welsh\nBridge
Wayne County Bridge	bridgeName	Wayne County Bridge
Fourteenth Street Bridge	bridgeName	Fourteenth Street Bridge
Kentucky & Indiana Terminal Bridge	bridgeName	Kentucky & Indiana Bridge
Queen Alexandrine Bridge	bridgeName	Queen Alexandrine Bridge
Tower Bridge	bridgeName	Tower Bridge
Hawkesbury River Railway Bridge	bridgeName	Hawkesbury River Railway Bridge
Volodarsky Bridge	bridgeName	Volodarsky Bridge
Volodarsky Bridge	bridgeName	Волода́рский мост
Megyeri Bridge	bridgeName	Megyeri Bridge
Wanette–Byars Bridge	bridgeName	Wanette&ndash;Byars Bridge
Blagoveshchensky Bridge	bridgeName	Blagoveshchensky  Bridge
Thomas A. Mathis and J. Stanley Tunney Bridges	bridgeName	Thomas A. Mathis Bridge
Thomas A. Mathis and J. Stanley Tunney Bridges	bridgeName	J. Stanley Tunney Bridge
Adolphe Bridge	bridgeName	Adolphe Bridge
Ponte Amerigo Vespucci	bridgeName	Ponte Amerigo Vespucci
Liteyny Bridge	bridgeName	Liteyny Bridge
Liteyny Bridge	bridgeName	Лите́йный мост
Agate Pass Bridge	bridgeName	Agate Pass Bridge
Bolsheokhtinsky Bridge	bridgeName	Bolsheokhtinsky Bridge
Bolsheokhtinsky Bridge	bridgeName	Большеохтинский мост
Over Bridge	bridgeName	Over Bridge
Portage Bridge	bridgeName	Portage Bridge
Lane Avenue Bridge	bridgeName	Lane Avenue Bridge
Phra Pin-klao Bridge	bridgeName	Phra Pin-klao Bridge
Paulinskill Viaduct	bridgeName	Paulinskill Viaduct
Mid-Bay Bridge	bridgeName	Mid-Bay Bridge
Great Western Railway Usk bridge	bridgeName	Great Western Railway Usk bridge
Old Sartell Bridge	bridgeName	Old Sartell Bridge
Sartell Bridge	bridgeName	Sartell Bridge
North Arm Bridge	bridgeName	North Arm Bridge
Sauk Rapids Regional Bridge	bridgeName	Sauk Rapids Regional Bridge
Finland Railway Bridge	bridgeName	Finland Railway Bridge
Newport Bridge, Newport	bridgeName	Newport Bridge
Italian Bridge	bridgeName	Italian Bridge
Italian Bridge	bridgeName	Итальянский мост
Kolia Bhomora Setu	bridgeName	Kolia_Bhomora_Setu
Kolia Bhomora Setu	bridgeName	কলীয়াভোমোৰা সেতু
Hazen Bridge	bridgeName	Hazen Bridge
Pons Cestius	bridgeName	Pons Cestius
Tees Newport Bridge	bridgeName	Tees Newport Bridge
Dabong Bridge	bridgeName	Dabong Bridge
Sultan Ismail Petra Bridge	bridgeName	Kelantan River Second Bridge
Hampden Bridge	bridgeName	Hampden Bridge
Murrumbidgee River Railway Bridge	bridgeName	Murrumbidgee River Railway Bridge
The Rolling Bridge	bridgeName	The Rolling Bridge
Penobscot Narrows Bridge and Observatory	bridgeName	Penobscot Narrows Bridge
Garcon Point Bridge	bridgeName	Garcon Point Bridge
Clearwater Memorial Causeway	bridgeName	Clearwater Memorial Causeway
Allen Williamson Bridge	bridgeName	Allen Williamson Bridge
First Avenue South Bridge	bridgeName	First Avenue South Bridge
South Park Bridge	bridgeName	South Park Bridge
Spokane Street Bridge	bridgeName	Spokane Street Bridge
Glen Canyon Dam Bridge	bridgeName	Glen Canyon Bridge
Atlantic Beach Bridge	bridgeName	Atlantic Beach Bridge
Medway Viaducts	bridgeName	Medway Viaduct
Pony Express Bridge	bridgeName	Pony Express Bridge
Centennial Bridge	bridgeName	Centennial Bridge
Fairfax Bridge	bridgeName	Fairfax Bridge
Platte Purchase Bridge	bridgeName	Platte Purchase Bridge
Amelia Earhart Memorial Bridge	bridgeName	Amelia Earhart Memorial Bridge
Amelia Earhart Memorial Bridge	bridgeName	Amelia Earhart Bridge
Delaware River Viaduct	bridgeName	Delaware River Viaduct
Clifford Hollow Bridge	bridgeName	Clifford Hollow Bridge
Shocks Mills Bridge	bridgeName	Shocks Mills Bridge
Centre Bridge–Stockton Bridge	bridgeName	Centre Bridge&ndash;Stockton Bridge
Brightman Street Bridge	bridgeName	Brightman Street Bridge
South Market Street Bridge	bridgeName	South Market Street Bridge
Monroe Street Bridge	bridgeName	Monroe Street Bridge
Cairo Rail Bridge	bridgeName	Cairo Rail Bridge
CPR Bridge	bridgeName	CPR Bridge
New Hope–Lambertville Bridge	bridgeName	New Hope&ndash;Lambertville Bridge
Leeds Bridge	bridgeName	Leeds Bridge
Helix Bridge	bridgeName	Helix Bridge
Clyde Arc	bridgeName	Clyde Arc
Wabash Bridge	bridgeName	Wabash Bridge
Lewis Bridge	bridgeName	Lewis Bridge
Nowra Bridge	bridgeName	Nowra Bridge
Victoria Bridge	bridgeName	Victoria Bridge over Nepean River
Nebraska City Bridge	bridgeName	Nebraska City Bridge
Lake Temenggor Bridge	bridgeName	Lake Temenggor Bridge
Kelvin Aqueduct	bridgeName	Kelvin Aqueduct
Wearmouth Bridge	bridgeName	Wearmouth Bridge
Veterans International Bridge at Los Tomates	bridgeName	Veterans International Bridge
Windsor Railway Bridge	bridgeName	Windsor Railway Bridge
HX Draw	bridgeName	HX Draw
Lower Hack Lift	bridgeName	Lower Hack Lift Bridge
Upper Hack Lift	bridgeName	Upper Hack Lift
Albert Edward Bridge	bridgeName	Albert Edward Bridge
Ak-Sar-Ben Bridge	bridgeName	Ak-Sar-Ben Bridge
Union Pacific Missouri River Bridge	bridgeName	Union Pacific Missouri River Bridge
Bob Kerrey Pedestrian Bridge	bridgeName	J Robert Kerrey Pedestrian Bridge
Selat Lumut Bridge	bridgeName	Selat Lumut Bridge
Chestnut Street Bridge	bridgeName	Chestnut Street Bridge
Lachapelle Bridge	bridgeName	Lachapelle Bridge
Viau Bridge	bridgeName	Viau Bridge
Bordeaux Railway Bridge	bridgeName	Bordeaux Railway Bridge
New Bridge, Mitrovica	bridgeName	New Bridge
New Bridge, Mitrovica	bridgeName	Mitrovica Bridge
New Bridge, Mitrovica	bridgeName	Ibar Bridge
Piscataqua River Bridge	bridgeName	Piscataqua River Bridge
Memorial Bridge	bridgeName	World War I Memorial Bridge
Little Bay Bridge	bridgeName	Little Bay Bridge
Almö Bridge	bridgeName	Almö Bridge
Cawood Bridge	bridgeName	Cawood Bridge
Bridge to Nowhere	bridgeName	Bridge to Nowhere
Cantlop Bridge	bridgeName	Cantlop Bridge
Ada Covered Bridge	bridgeName	Ada Covered Bridge
Kingsferry Bridge	bridgeName	Kingsferry Bridge
James River Bridge	bridgeName	James River Bridge
William H. Putnam Memorial Bridge	bridgeName	Putnam Bridge
Puente de la Unidad	bridgeName	Puente de la Unidad
Natchez Trace Parkway Bridge	bridgeName	Natchez Trace Parkway Bridge
Wittpenn Bridge	bridgeName	Wittpenn Bridge
Wylam Railway Bridge	bridgeName	Wylam Railway Bridge
Bennerley Viaduct	bridgeName	Bennerley Viaduct
Puente La Amistad de Taiwán	bridgeName	Puente La Amistad de Taiwán
Grand Trunk Bridge	bridgeName	Grand Trunk Bridge
Big Dam Bridge	bridgeName	Pulaski County Pedestrian and Bicycle Bridge
Spit Bridge	bridgeName	The Spit Bridge
Grafton Bridge, New South Wales	bridgeName	Grafton Bridge
Roseville Bridge	bridgeName	Roseville Bridge
Hong Kong–Shenzhen Western Corridor	bridgeName	Hong Kong-Shenzhen Western Corridor
Hong Kong–Shenzhen Western Corridor	bridgeName	深港西部通道
Suez Canal Bridge	bridgeName	Mubarak Peace Bridge
Vikramshila Setu	bridgeName	Vikramshila Setu
Sutong Yangtze River Bridge	bridgeName	Sutong Bridge
Parkhead Viaduct	bridgeName	Parkhead Viaduct
Bridge 5827	bridgeName	Bridge 5827
Bethany Bridge	bridgeName	Bethany Bridge
Easton–Phillipsburg Toll Bridge	bridgeName	Easton-Phillipsburg Toll Bridge
Northampton Street Bridge	bridgeName	Northampton Street Bridge
Gimpo Bridge	bridgeName	Gimpo Bridge
Laurel Creek Gorge Bridge	bridgeName	Laurel Creek Gorge Bridge
Pink Bridge	bridgeName	8
Framwellgate Bridge	bridgeName	Framwellgate Bridge
Bhumibol Bridge	bridgeName	Bhumibol Bridge
Leo Frigo Memorial Bridge	bridgeName	Leo Frigo Bridge
Sixth Street Viaduct	bridgeName	6
Orinoquia Bridge	bridgeName	Orinoquia Bridge
Benetka Road Covered Bridge	bridgeName	Benetka Road Bridge
Caine Road Covered Bridge	bridgeName	Caine Road Bridge
Creek Road Covered Bridge	bridgeName	Creek Road Bridge
Doyle Road Covered Bridge	bridgeName	Doyle Road Bridge
Waterloo Bridge, Betws-y-Coed	bridgeName	Waterloo Bridge
Giddings Road Covered Bridge	bridgeName	Giddings Road Bridge
Clackmannanshire Bridge	bridgeName	Clackmannanshire Bridge
Graham Road Covered Bridge	bridgeName	Graham Road Bridge
Harpersfield Covered Bridge	bridgeName	Harpersfield Bridge
Mechanicsville Road Covered Bridge	bridgeName	Mechanicsville Road Bridge
Prai River Bridge	bridgeName	Prai River Bridge
Sorell Causeway	bridgeName	Sorell Causeway
New Railroad Bridge	bridgeName	New Railway Bridge
Wells Street Bridge	bridgeName	Wells Street Bridge
Dearborn Street Bridge	bridgeName	Dearborn Street Bridge
Clark Street Bridge	bridgeName	Clark Street Bridge
Middle Road Covered Bridge	bridgeName	Middle Road Bridge
Netcher Road Covered Bridge	bridgeName	Netcher Road Bridge
Sheppey Crossing	bridgeName	Sheppey Crossing
South Pennsylvania Railroad Bridge	bridgeName	South Pennsylvania Railroad Bridge
Shakespeare Bridge	bridgeName	Shakespeare Bridge
Poniatowski Bridge	bridgeName	Poniatowski Bridge
Anderson Memorial Bridge	bridgeName	Anderson Memorial Bridge
Olin's Covered Bridge	bridgeName	Olin's Bridge
Riverdale Road Covered Bridge	bridgeName	Riverdale Road Bridge
Root Road Covered Bridge	bridgeName	Root Road Bridge
South Denmark Road Covered Bridge	bridgeName	South Denmark Road Bridge
State Road Covered Bridge	bridgeName	State Road Bridge
Windsor Mills Covered Bridge	bridgeName	Windsor Mills Bridge
Godavari Bridge	bridgeName	Godavari Bridge
Smolen–Gulf Bridge	bridgeName	Smolen–Gulf Bridge
Paul Bryant Bridge	bridgeName	Paul Bryant Bridge
Coleman Bridge, Singapore	bridgeName	Coleman Bridge
Haringvlietdam	bridgeName	Haringvlietdam
Tajik–Afghan Friendship Bridge	bridgeName	Tajikistan-Afghanistan Friendship Bridge In Darwaz region
Grosvenor Bridge	bridgeName	Grosvenor Bridge
Cookham Bridge	bridgeName	Cookham Bridge
Marlow By-pass Bridge	bridgeName	Marlow By-pass Bridge
Bourne End Railway Bridge	bridgeName	Bourne End Railway Bridge
Plattsmouth Bridge	bridgeName	Plattsmouth Bridge
Bellevue Bridge	bridgeName	Bellevue Bridge
Mormon Bridge	bridgeName	Mormon Bridge
Angers Bridge	bridgeName	Angers Bridge
Verrazano Bridge	bridgeName	Verrazano Bridge
Connel Bridge	bridgeName	Connel Bridge
Mulberry Street Bridge	bridgeName	Mulberry Street Bridge
Whites Bridge	bridgeName	Whites Bridge
Second Thai–Lao Friendship Bridge	bridgeName	Second Thai–Lao Friendship Bridge
Yarrow Bridge	bridgeName	Yarrow Bridge
Washington Crossing Bridge	bridgeName	Washington Crossing Bridge
Fallasburg Bridge	bridgeName	Fallasburg Bridge
Grand Tower Pipeline Bridge	bridgeName	Grand Tower Pipeline Bridge
St. Claude Avenue Bridge	bridgeName	St. Claude Avenue Bridge
Almonaster Avenue Bridge	bridgeName	Almonaster Avenue Bridge
I-10 High Rise Bridge	bridgeName	I-10 High Rise Bridge
Danziger Bridge	bridgeName	Danziger Bridge
Seabrook Railroad Bridge	bridgeName	Seabrook Railroad Bridge
Seabrook Bridge	bridgeName	Senator Ted Hickey Bridge
Green Bridge	bridgeName	Green Bridge
Fort Pike Bridge	bridgeName	Fort Pike Bridge
Craigmore Viaduct	bridgeName	Craigmore Viaduct
Rama VIII Bridge	bridgeName	Rama VIII Bridge
FEC Strauss Trunnion Bascule Bridge	bridgeName	FEC Strauss Trunnion Bascule Bridge
Chouteau Bridge	bridgeName	Chouteau Bridge
New Europe Bridge	bridgeName	New Europe Bridge
Severn River Bridge	bridgeName	Severn River Bridge
Naval Academy Bridge	bridgeName	U.S. Naval Academy Bridge
Cochrane–Africatown USA Bridge	bridgeName	Cochrane–Africatown USA Bridge
Vanport Bridge	bridgeName	Vanport Bridge
Shippingport Bridge	bridgeName	Shippingport Bridge
Wuhu Yangtze River Bridge	bridgeName	Wuhu Yangtze River Bridge
Henry Ford Bridge	bridgeName	Henry Ford Bridge
Bloukrans Bridge	bridgeName	Bloukrans Bridge
Nydeggbrücke	bridgeName	Nydeggbrücke
Upper Black Eddy–Milford Bridge	bridgeName	Upper Black Eddy&ndash;Milford Bridge
Mauricio Báez Bridge	bridgeName	Maurcio Báez Bridge
Trout River Bridge	bridgeName	Trout River Bridge
Roman Bridge	bridgeName	Roman Bridge
Roman Bridge	bridgeName	Römerbrücke
Pont Julien	bridgeName	Pont Julien
Pont Ambroix	bridgeName	Pont Ambroix
Podolsko Bridge	bridgeName	Podolsko Bridge
Cold Spring Canyon Arch Bridge	bridgeName	Cold Spring Canyon Arch Bridge
Pont-Saint-Martin	bridgeName	Pont-Saint-Martin
Ponte Pietra	bridgeName	Ponte Pietra
Pons Aemilius	bridgeName	Pons Aemilius
Roman Bridge	bridgeName	Roman Bridge
Vista Bridge	bridgeName	Vista Bridge
Vantage Bridge	bridgeName	Vantage Bridge
Bayard Bridge	bridgeName	Bayard Bridge
Ponte di Tiberio	bridgeName	Ponte di Tiberio
Ponte das Taipas	bridgeName	Ponte das Taipas
Mooney Mooney Bridge	bridgeName	Mooney Mooney Bridge
Centre Street Bridge	bridgeName	Centre Street Bridge
Burnside's Bridge	bridgeName	Burnside's Bridge
Osney Bridge	bridgeName	Osney Bridge
Ma Wan Viaduct	bridgeName	Ma Wan Viaduct
Albertus L. Meyers Bridge	bridgeName	Albertus L. Meyers Bridge
French King Bridge	bridgeName	French King Bridge
Moulsford Railway Bridge	bridgeName	Moulsford Railway Bridge
Magnolia Bridge	bridgeName	Magnolia Bridge
Chirundu Bridge	bridgeName	Otto Beit Bridge
Virginia Dare Memorial Bridge	bridgeName	Virginia Dare Memorial Bridge
Bahia Honda Rail Bridge	bridgeName	Bahia Honda Rail Bridge
Staines Bridge	bridgeName	Staines Bridge
High Steel Bridge	bridgeName	High Steel Bridge
Yanghwa Bridge	bridgeName	Yanghwa Bridge
Stone Bridge	bridgeName	Stone Bridge
Lansdowne Bridge Rohri	bridgeName	Lansdowne Bridge
Laigh Milton Viaduct	bridgeName	Laigh Milton Viaduct
Skansen Bridge	bridgeName	Skansen Bridge
Liberty Bend Bridge	bridgeName	Liberty Bend Bridge
Pont de Grenelle	bridgeName	Pont de Grenelle
Pont de Bir-Hakeim	bridgeName	Pont de Bir-Hakeim
Pont Rouelle	bridgeName	Pont Rouelle
Boonslick Bridge	bridgeName	Boonville Bridge
Hermann Bridge	bridgeName	Hermann Bridge
Avon Bridge	bridgeName	AvonBridge
McClugage Bridge	bridgeName	McClugage Bridge
Bob Michel Bridge	bridgeName	Bob Michel Bridge
Cedar Street Bridge	bridgeName	Cedar Street Bridge
Shade–Lohmann Bridge	bridgeName	Shade–Lohmann Bridge
Saigon Bridge	bridgeName	Saigon Bridge
Thủ Thiêm Bridge	bridgeName	Thủ Thiêm Bridge
Broadway Bridge	bridgeName	Little Falls Broadway Bridge
Walden Veterans' Memorial Bridge	bridgeName	Walden Veterans' Memorial Bridge
Shillingford Bridge	bridgeName	Shillingford Bridge
Bi-State Vietnam Gold Star Bridges	bridgeName	The Twin Bridges
Sheridan Bridge	bridgeName	Sheridan Bridge
Victoria Bridge, Malaysia	bridgeName	Sungai Perak Railway Bridge
Incheondaegyo	bridgeName	Incheondaegyo
Thanlwin Bridge	bridgeName	Thanlwin  Bridge
Manette Bridge	bridgeName	Manette Bridge
Alconétar Bridge	bridgeName	Alconétar Bridge
Taba Border Crossing	bridgeName	Taba Crossing
Wadi Araba Crossing	bridgeName	Wadi Araba Crossing
Nitzana Border Crossing	bridgeName	Nitzana Crossing
Jordan River Crossing	bridgeName	Jordan River Crossing
Erez Crossing	bridgeName	Erez Crossing
La Crosse West Channel Bridge	bridgeName	La Crosse West Channel Bridge
Quneitra Crossing	bridgeName	Quneitra Crossing
Mcgees Bridge	bridgeName	McGee's Bridge
Second Hannibal Bridge	bridgeName	Second Hannibal Bridge
Perry Bridge	bridgeName	Perry Bridge
Abbotsford Bridge	bridgeName	Abbotsford Bridge
Yardley–Wilburtha Bridge	bridgeName	Yardley&ndash;Wilburtha Bridge
Girard Point Bridge	bridgeName	Girard Point Bridge
Chords Bridge	bridgeName	Chords Bridge
Morell Bridge	bridgeName	Morell Bridge
Newbridge, River Thames	bridgeName	New Bridge
Don N. Holt Bridge	bridgeName	Don Holt Bridge
Bewdley Bridge	bridgeName	Bewdley Bridge
James B. Edwards Bridge	bridgeName	Wando River Bridge
Fulton Road Bridge	bridgeName	Fulton Road Bridge
Seaway International Bridge	bridgeName	North Channel Span of Seaway International Bridge
Seaway International Bridge	bridgeName	South Channel Bridge of Three Nations Crossing
C.B. Robinson Bridge	bridgeName	C.B. Robinson Bridge
Nature Road Bridge	bridgeName	Nature Road Bridge
Larpool Viaduct	bridgeName	Larpool Viaduct
Cornish–Windsor Covered Bridge	bridgeName	Cornish–Windsor Covered Bridge
George C. Platt Bridge	bridgeName	George C. Platt Memorial Bridge
Riegelsville Bridge	bridgeName	Riegelsville Bridge
Riverton–Belvidere Bridge	bridgeName	Riverton–Belvidere Bridge
Fullers Bridge	bridgeName	Fullers  Bridge
Cortland Street Drawbridge	bridgeName	Cortland Street Drawbridge
Liberty Bridge at Falls Park on the Reedy	bridgeName	Liberty Bridge at Falls Park on the Reedy
Thelwall Viaduct	bridgeName	Thelwall Viaduct
George Washington Carver Bridge	bridgeName	George Washington Carver Bridge
Poinsett Bridge	bridgeName	Poinsett Bridge
Pont de Sully	bridgeName	Pont de Sully
Vanšu Bridge	bridgeName	Vanšu Bridge
World Trade International Bridge	bridgeName	World Trade International Bridge
Laredo–Colombia Solidarity International Bridge	bridgeName	Laredo-Colombia Solidarity International Bridge
Gateway to the Americas International Bridge	bridgeName	Gateway to the Americas International Bridge
Juárez–Lincoln International Bridge	bridgeName	Juarez-Lincoln International Bridge
Texas Mexican Railway International Bridge	bridgeName	Texas Mexican Railway International Bridge
Gazela Bridge	bridgeName	Gazela Bridge
Gazela Bridge	bridgeName	Mост Газела
Gazela Bridge	bridgeName	Most Gazela
Sozh Floating Bridge	bridgeName	Sozh Floating Bridge
Queen Emma Bridge	bridgeName	Queen Emma Bridge
Carter Glass Memorial Bridge	bridgeName	Carter Glass Memorial Bridge
Branko's Bridge	bridgeName	Branko's Bridge
Branko's Bridge	bridgeName	Бранков мост
Branko's Bridge	bridgeName	Brankov most
Schenley Bridge	bridgeName	Schenley Bridge
Panther Hollow Bridge	bridgeName	Panther Hollow Bridge
Sidney Sherman Bridge	bridgeName	Sidney Sherman Bridge
Cobden Bridge	bridgeName	Cobden Bridge
Theodor Heuss Bridge	bridgeName	Theodor Heuss Bridge
Belden Bly Bridge	bridgeName	Belden G. Bly Bridge
Dom Luís I Bridge	bridgeName	Dom Luís I Bridge
Pearl Harbor Memorial Bridge	bridgeName	Pearl Harbor Memorial Bridge
Bertrand Road suspension bridge	bridgeName	Bertrand Road suspension bridge
Passyunk Avenue Bridge	bridgeName	Passyunk Avenue Bridge
Star City Bridge	bridgeName	Star City Bridge
Walton Bridge	bridgeName	Walton Bridge
M3 Chertsey Bridge	bridgeName	M3 Chertsey Bridge
Staines Railway Bridge	bridgeName	Staines Railway Bridge
M25 Runnymede Bridge	bridgeName	M25 Runnymede Bridge
Albert Bridge, Datchet	bridgeName	Albert Bridge
Ann W. Richards Congress Avenue Bridge	bridgeName	Ann W. Richards Congress Avenue Bridge
Boone Bridge	bridgeName	Boone Bridge
Mid-Delaware Bridge	bridgeName	Mid-Delaware Bridge
Honeymoon Bridge	bridgeName	Upper Steel Arch Bridge
Honeymoon Bridge	bridgeName	Honeymoon Bridge
Krotz Springs Bridge	bridgeName	Krotz Springs Bridge
Lexington Bridge	bridgeName	Lexington Bridge
Burlington Northern Railroad Bridge 9.6	bridgeName	Burlington Northern Railroad Bridge 9.6
Wharncliffe Viaduct	bridgeName	Wharncliffe Viaduct
Victoria Bridge, Datchet	bridgeName	Victoria Bridge
ASEAN Bridge	bridgeName	Batang Baram Bridge
Vermillion–Newcastle Bridge	bridgeName	Vermillion&ndash;Newcastle Bridge
Chief Standing Bear Memorial Bridge	bridgeName	Chief Standing Bear Memorial Bridge
East Haddam Bridge	bridgeName	East Haddam Swing Bridge
Dudley B. Menzies Bridge	bridgeName	Dudley B. Menzies Bridge
Agen aqueduct	bridgeName	Pont-canal d'Agen
Yangpu Bridge	bridgeName	Yangpu Bridge
Business Bay Crossing	bridgeName	Business Bay Crossing\nمعبر الخليج التجاري
Mehmed Paša Sokolović Bridge	bridgeName	Mehmed Paša Sokolović Bridge
Mill Avenue Bridges	bridgeName	Mill Avenue Bridges
Baudette–Rainy River International Bridge	bridgeName	Baudette – Rainy River International Bridge
Cut River Bridge	bridgeName	Heath M. Robinson Memorial Cut River Bridge
Tioronda Bridge	bridgeName	Tioronda Bridge
Kate Shelley High Bridge	bridgeName	Kate Shelley High Bridge
Kate Shelley High Bridge	bridgeName	New Kate Shelley Bridge
Verige bridge	bridgeName	Verige bridge
Deir ez-Zor suspension bridge	bridgeName	Deir ez-Zor suspension bridge
Deir ez-Zor suspension bridge	bridgeName	جسر دير الزور المعلق
Teodoro Moscoso Bridge	bridgeName	Teodoro Moscoso Bridge
Mark Clark Bridge	bridgeName	Mark Clark Bridge
Fehmarn Sound Bridge	bridgeName	Fehmarn Sound Bridge
Ward's Bridge	bridgeName	Ward's Bridge
Bodine's Bridge	bridgeName	Bodine's Bridge
Lyndon Bridge	bridgeName	Lyndon Bridge
King Street Bridge	bridgeName	King Street Bridge
Providence & Worcester railroad bridge	bridgeName	Providence & Worcester bridge at Middletown
Fades viaduct	bridgeName	Fades viaduct
Connecticut Southern railroad bridge	bridgeName	Connecticut Southern Railroad bridge
Memorial Bridge	bridgeName	Memorial Bridge
Haikou Century Bridge	bridgeName	Haikou Century Bridge
Penobscot River Bridge	bridgeName	Penobscot River Bridge
Grand Glaize Bridge	bridgeName	Grand Glaize Bridge
Kittanning Citizens Bridge	bridgeName	Kittanning Citizens Bridge
Dorothy Barnes Pelote Bridge	bridgeName	Dorothy Barnes Pelote Bridge
Foxburg Bridge	bridgeName	Foxburg Bridge
Veterans Memorial Bridge	bridgeName	Veterans Memorial Bridge
Nelson Mandela Bridge	bridgeName	Nelson Mandela Bridge
Suklingphaa	bridgeName	Kolia_Bhomora_Setu
Suklingphaa	bridgeName	কলীয়াভোমোৰা সেতু
Monivong Bridge	bridgeName	Monivong Bridge
Oregon Trunk Rail Bridge	bridgeName	Oregon Trunk Bridge
Juan Pablo II Bridge	bridgeName	Juan Pablo II Bridge
Eiffel Bridge, Zrenjanin	bridgeName	Eiffel Bridge
Brookport Bridge	bridgeName	Brookport Bridge
Meridian Highway Bridge	bridgeName	Meridian Highway Bridge
I-35W Minnesota River bridge	bridgeName	I-35W Minnesota River bridge
Bloomington Ferry Bridge	bridgeName	Bloomington Ferry Bridge
35th Street Bridge	bridgeName	35
Pedro de Valdivia Bridge	bridgeName	Pedro de Valdivia Bridge
Pensacola Bay Bridge	bridgeName	Pensacola Bay Bridge
I-35W Saint Anthony Falls Bridge	bridgeName	Saint Anthony Falls Bridge
Flehe Bridge	bridgeName	Fleher Brücke
Memorial Bridge	bridgeName	Memorial Bridge
Denver Millennium Bridge	bridgeName	Denver Millennium Bridge
Red Bridge	bridgeName	Red Bridge
Snake River Bridge	bridgeName	Snake River Bridge
Discovery Bridge	bridgeName	Discovery Bridge
Shard Bridge	bridgeName	Shard Bridge
Israel LaFleur Bridge	bridgeName	Israel LaFleur Bridge
Calcasieu River Bridge	bridgeName	I-10 Calcasieu River Bridge
Río Cruces Bridge	bridgeName	Río Cruces Bridge
Buster Boyd Bridge	bridgeName	Buster Boyd Bridge
Red Cliff Bridge	bridgeName	Red Cliff Bridge
Waldo Covered Bridge	bridgeName	Waldo CB
Creve Coeur Lake Memorial Park Bridge	bridgeName	Creve Coeur Lake Memorial Park Bridge
South Canon Bridge	bridgeName	South Canon Bridge
Cherry Creek Bridge	bridgeName	Cherry Creek Bridge
Jiujiang Yangtze River Bridge	bridgeName	Jiujiang Yangtze River Bridge
Maroon Creek Bridge	bridgeName	Historic Maroon Creek Bridge
Maroon Creek Bridge	bridgeName	New Maroon Creek Bridge
Corpus Christi Harbor Bridge	bridgeName	Corpus Christi Harbor Bridge
Slade's Ferry Bridge	bridgeName	Slade's Ferry Bridge
Swann Covered Bridge	bridgeName	Swann CB
Coldwater Covered Bridge	bridgeName	Coldwater CB
Victory Bridge, Yerevan	bridgeName	Victory Bridge
Pančevo Bridge	bridgeName	Pančevo Bridge
Pančevo Bridge	bridgeName	Панчевачки мост
Pančevo Bridge	bridgeName	Pančevački most
Clarkson–Legg Covered Bridge	bridgeName	Clarkson–Legg CB
John T. Loughran Bridge	bridgeName	John T. Loughran Bridge
Horton Mill Covered Bridge	bridgeName	Horton Mill CB
Easley Covered Bridge	bridgeName	Easley CB
Kymulga Mill & Covered Bridge	bridgeName	Kymulga CB
CSX Rigolets Pass Bridge	bridgeName	CSX Rigolets Pass Bridge
Chef Menteur Bridge	bridgeName	Chef Menteur Bridge
Salem-Shotwell Covered Bridge	bridgeName	Salem-Shotwell CB
Columbia Bridge	bridgeName	Columbia Bridge
Mount Orne Covered Bridge	bridgeName	Mount Orne Bridge
Alamuchee-Bellamy Covered Bridge	bridgeName	Alamuchee-Bellamy CB
Frederick Douglass–Susan B. Anthony Memorial Bridge	bridgeName	Frederick Douglass–Susan B. Anthony Memorial Bridge
Gilliland-Reese Covered Bridge	bridgeName	Gilliland-Reese CB
Igelsta Bridge	bridgeName	Igelsta Bridge
Old Union Crossing Covered Bridge	bridgeName	Old Union Crossing CB
Market Street Bridge	bridgeName	Market Street Bridge
Ponquogue Bridge	bridgeName	Ponquogue Bridge
Martin Olav Sabo Bridge	bridgeName	Martin Olav Sabo Bridge
Lechmere Viaduct	bridgeName	Lechmere Viaduct
Matanzas Pass Bridge	bridgeName	Matanzas Pass Bridge
Bedell Covered Bridge	bridgeName	Bedell Bridge
South Carolina Highway 30	bridgeName	Robert B. Scarborough Bridge
MacRitchie Viaduct	bridgeName	MacRitchie Viaduct
Old Blenheim Bridge	bridgeName	Old Blenheim Bridge
Grays River Covered Bridge	bridgeName	Grays River Covered Bridge
Bridgeport Covered Bridge	bridgeName	Bridgeport Covered Bridge
Governor Thomas Johnson Bridge	bridgeName	Governor Thomas Johnson Bridge
Tappan Bridge	bridgeName	Tappan Bridge
Forge Bridge	bridgeName	Forge Bridge
Hamden Bridge	bridgeName	Hamden Bridge
Eagleville Bridge	bridgeName	Eagleville Bridge
Rexleigh Bridge	bridgeName	Rexleigh Bridge
Salisbury Center Bridge	bridgeName	Salisbury Center Bridge
Copeland Bridge	bridgeName	Copeland Covered Bridge
Bonita Beach Causeway	bridgeName	Bonita Beach Causeway
Tuscarora Club Bridge	bridgeName	Tuscarora Club Bridge
Fitches Bridge	bridgeName	Fitch's Bridge
Newfield Bridge	bridgeName	Newfield bridge
Hyde Hall Bridge	bridgeName	Hyde Hall Bridge
Grants Mills Bridge	bridgeName	Grant Mills Bridge
Halls Mills Bridge	bridgeName	Halls Mills Bridge
Jay Bridge	bridgeName	Jay Bridge
Bendo Bridge	bridgeName	Bendo Bridge
Van Tran Flat Bridge	bridgeName	Van Tran Flat or Livingston Manor Bridge
Jamestown Viaduct	bridgeName	Jamestown Viaduct
Tuthilltown Bridge	bridgeName	Tuthilltown Bridge
Papineau-Leblanc Bridge	bridgeName	Papineau-Leblanc Bridge
Commodore Isaac Hull Memorial Bridge	bridgeName	Commodore Hull Bridge
Igor I. Sikorsky Memorial Bridge	bridgeName	Sikorsky Memorial Bridge
Brady Street Bridge	bridgeName	Brady Street Bridge
Parker Bridge	bridgeName	Parker Bridge
Edison Bridge	bridgeName	Edison Bridge
Nectar Covered Bridge	bridgeName	Nectar CB
Halfpenny Bridge	bridgeName	Halfpenny Bridge
Chikugo River Lift Bridge	bridgeName	Chikugo River Lift Bridge
Chikugo River Lift Bridge	bridgeName	筑後川昇開橋
Cần Thơ Bridge	bridgeName	Cần Thơ Bridge
Black Squirrel Creek Bridge	bridgeName	Black Squirrel Creek Bridge
Pont de l'Alma	bridgeName	Pont de l'Alma
Eiksund Bridge	bridgeName	Eiksund Bridge
Wilson Pigott Bridge	bridgeName	Wilson Pigott Bridge
Médéric Martin Bridge	bridgeName	Médéric Martin Bridge
Matlacha Bridge	bridgeName	Matlacha Bridge
Louis Bisson Bridge	bridgeName	Louis Bisson Bridge
Black Potts Railway Bridge	bridgeName	Black Potts Railway Bridge
Main Street Bridge	bridgeName	Main Street Bridge
M4 Thames Bridge	bridgeName	M4 Thames Bridge
Second Wuhan Yangtze River Bridge	bridgeName	Second Wuhan Yangtze River Bridge
Wuhan Yangtze River Bridge	bridgeName	Wuhan Yangtze River Bridge
Temple Footbridge	bridgeName	Temple Footbridge
Lafayette Avenue Bridge	bridgeName	Lafayette Avenue Bridge
Liberty Bridge	bridgeName	Liberty Bridge
Independence Bridge	bridgeName	Independence Bridge
Veterans Memorial Bridge	bridgeName	Veterans Memorial Bridge
Comer Bridge	bridgeName	B. B. Comer Bridge
Wabash Bridge	bridgeName	Wabash Bridge
Eysey Footbridge	bridgeName	Eysey Footbridge
St. John's Bridge, Lechlade	bridgeName	St John's Bridge
Water Eaton House Bridge	bridgeName	Water Eaton House Bridge
Tadpole Bridge	bridgeName	Tadpole Bridge
Tenfoot Bridge	bridgeName	Tenfoot Bridge
Świętokrzyski Bridge	bridgeName	Świętokrzyski Bridge
Charlestown Bridge	bridgeName	Charlestown Bridge
Pont du Carrousel	bridgeName	Pont du Carrousel
Appleford Railway Bridge	bridgeName	Appleford Railway Bridge
Washington Street Bridge	bridgeName	Washington Street Bridge
Sutton Bridge, Oxfordshire	bridgeName	Sutton Bridge
Abingdon Bridge	bridgeName	Abingdon Bridge
Abingdon Bridge	bridgeName	Burford Bridge
Kennington Railway Bridge	bridgeName	Kennington Railway Bridge
Nuneham Railway Bridge	bridgeName	Nuneham Railway Bridge
Walden Low Bridge	bridgeName	Walden Low Bridge
Isis Bridge	bridgeName	Isis Bridge
A34 Road Bridge	bridgeName	A34 Road Bridge
Shiplake Railway Bridge	bridgeName	Shiplake Railway Bridge
Sonning Backwater Bridges	bridgeName	Sonning Backwater Bridges
Moses Wheeler Bridge	bridgeName	Moses Wheeler Bridge
Octávio Frias de Oliveira Bridge	bridgeName	Octávio Frias de Oliveira Bridge
Pennsylvania Avenue Bridge	bridgeName	Pennsylvania Avenue Bridge
Île aux Tourtes Bridge	bridgeName	Île aux Tourtes Bridge
Galveston Causeway	bridgeName	Galveston Causeway
Wilsonville railroad bridge	bridgeName	Wilsonville railroad bridge
Pont des Invalides	bridgeName	Pont des Invalides
Des Plaines River Valley Bridge	bridgeName	Des Plaines River Valley Bridge
Ballochmyle Viaduct	bridgeName	Ballochmyle Viaduct
Alloa Swing Bridge	bridgeName	Alloa Swing Bridge
Calle-Calle Bridge	bridgeName	Calle-Calle Bridge
Passerelle Debilly	bridgeName	Passerelle Debilly
Veterans Memorial Bridge	bridgeName	Veterans Memorial Bridge
Pont d'Iéna	bridgeName	Pont d'Iéna
Summerleaze Footbridge	bridgeName	Summerleaze Footbridge
Dunlap's Creek Bridge	bridgeName	Dunlap's Creek Bridge
Corporation Bridge	bridgeName	Corporation Bridge
Oakachoy Covered Bridge	bridgeName	Oakachoy CB
Manchac Swamp Bridge	bridgeName	Manchac Swamp Bridge
Viaduc d'Austerlitz	bridgeName	Viaduc d'Austerlitz
Hares Hill Road Bridge	bridgeName	Hares Hill Road Bridge over French Creek
Ricobayo Dam Arch Bridge	bridgeName	Ricobayo Dam Arch Bridge
Low Level Bridge	bridgeName	Low Level Bridge
Bob White Covered Bridge	bridgeName	Bob White Covered Bridge
Main Street Bridge	bridgeName	Main Street Bridge
La Vicaria Arch Bridge	bridgeName	La Vicaria Arch bridge
Chenab Bridge	bridgeName	Chenab Bridge
Jack's Creek Covered Bridge	bridgeName	Jack's Creek Covered Bridge
Osney Rail Bridge	bridgeName	Osney Rail Bridge
Rama IX Bridge	bridgeName	Rama IX Bridge
Suffield and Thompsonville Bridge	bridgeName	Suffield and Thompsonville Bridge
Irondequoit Bay Bridge	bridgeName	Irondequoit Bay Bridge
Irondequoit Bay Outlet Bridge	bridgeName	Irondequoit Bay Outlet Bridge
Anacostia Railroad Bridge	bridgeName	Anacostia Railroad Bridge
Mile-Long Bridge	bridgeName	Mile-Long Bridge
Carl E. Stotz Memorial Little League Bridge	bridgeName	Carl E. Stotz Memorial Little League Bridge
Welland Canal, Bridge 15	bridgeName	Welland Canal, Bridge 15
Silverwater Bridge	bridgeName	Silverwater Bridge
Montrose Swing Bridge	bridgeName	Montrose Swing Bridge
Pont Charles-de-Gaulle	bridgeName	Pont Charles-de-Gaulle
Hi Carpenter Memorial Bridge	bridgeName	Hi Carpenter Memorial Bridge
New Martinsville Bridge	bridgeName	New Martinsville Bridge
Military Order of the Purple Heart Bridge	bridgeName	Military Order of the Purple Heart Bridge
Dutton Viaduct	bridgeName	Dutton Viaduct
6th October Bridge	bridgeName	--10-06
Maribyrnong River Viaduct	bridgeName	Maribyrnong River Viaduct
Kanchanaphisek Bridge	bridgeName	Kanchanaphisek Bridge
Krungthep Bridge	bridgeName	Krungthep Bridge
Rama III Bridge	bridgeName	Rama III Bridge
Taksin Bridge	bridgeName	Taksin Bridge
Fredericton Railway Bridge	bridgeName	Fredericton Railway Bridge
Aetnaville Bridge	bridgeName	Aetnaville Bridge
Millennium Bridge	bridgeName	Millennium Bridge
Kingsmead Viaduct	bridgeName	Kingsmead Viaduct
Pont Royal	bridgeName	Pont Royal
Pont amont	bridgeName	Upriver Bridge
Pont de l'Archevêché	bridgeName	Pont de l'Archevêché
Curlew Bridge	bridgeName	Curlew Bridge
Pont Marie	bridgeName	Pont Marie
Welland Canal, bridge 13	bridgeName	Welland Canal, Bridge 13
Nicholas Chain Bridge	bridgeName	Nicholas Chain Bridge
Nicholas Chain Bridge	bridgeName	(Николаевский цепной мост)
Bukit Bunga–Ban Buketa Bridge	bridgeName	Sungai Kolok Bridge
Charles River Bridge	bridgeName	Charles River Bridge
Leverett Circle Connector Bridge	bridgeName	Leverett Circle Connector
Kremsbrücke Pressingberg	bridgeName	Kremsbrücke Pressingberg
Jubilee Parkway	bridgeName	Jubilee Parkway
Battleship Parkway	bridgeName	Battleship Parkway
General W.K. Wilson Jr. Bridge	bridgeName	General W.K. Wilson Jr. Bridge
Unity Bridge	bridgeName	Unity Bridge
Phra Pok Klao Bridge	bridgeName	Phra Pok Klao Bridge
Krung Thon Bridge	bridgeName	Krung Thon Bridge
Canadian Northern Ontario Railway Federal Bridge	bridgeName	Canadian Northern Ontario Railway Federal Bridge
Pont d'Austerlitz	bridgeName	Pont d'Austerlitz
Ethel Kennedy Bridge	bridgeName	Ethel Kennedy Bridge
Edmundston–Madawaska Bridge	bridgeName	Edmundston–Madawaska Bridge
Pont de Bercy	bridgeName	Pont de Bercy
Slate Creek Bridge	bridgeName	Slate Creek Bridge
Dolores River Bridge	bridgeName	Dolores River Bridge
Amtrak Railroad Anacostia Bridge	bridgeName	Amtrak Railroad Anacostia Bridge
Bladensburg Road Bridge	bridgeName	Bladensburg Road Bridge
Skopje Aqueduct	bridgeName	Skopje Aqueduct
Stone Bridge	bridgeName	Stone Bridge
Stone Bridge	bridgeName	Камен Мост
Rama VI Bridge	bridgeName	Rama VI Bridge
Rama VII Bridge	bridgeName	Rama VII Bridge
Pont au Double	bridgeName	Pont au Double
Dedaye Bridge	bridgeName	Dedaye Bridge
Thegon Bridge	bridgeName	Thegon Bridge
Kattel Bridge	bridgeName	Kattel Bridge
Valens Aqueduct	bridgeName	Valens Aqueduct
Kurilpa Bridge	bridgeName	Kurilpa Bridge
Caracău Viaduct	bridgeName	Caracău Viaduct
Lotru Bridge	bridgeName	Lotru Bridge
Cernavodă Bridge	bridgeName	Cernavodă Bridge
Hart's Weir Footbridge	bridgeName	Hart's Weir Footbridge
Old Man's Bridge	bridgeName	Old Man's Bridge
Rande Bridge	bridgeName	Rande Bridge
Eaton Footbridge	bridgeName	Eaton Footbridge
Bloomers Hole Footbridge	bridgeName	Bloomers Hole Footbridge
Sale Swing Bridge	bridgeName	Sale Swing Bridge
James C. Nance Memorial Bridge	bridgeName	James C. Nance Memorial Bridge
Rantau Panjang–Sungai Golok Bridge	bridgeName	Sungai Golok Bridge
Valley View Bridge	bridgeName	Valley View Bridge
Pont Neuf, Toulouse	bridgeName	Pont Neuf, Toulouse
Rock Island Bridge	bridgeName	Chicago, Rock Island & Pacific Bridge
Kansas City Southern Bridge	bridgeName	Kansas City Southern Railway Bridge
Highline Bridge	bridgeName	Highline Bridge
Balclutha Road Bridge	bridgeName	Balclutha Road Bridge
Pencoyd Railroad Bridge	bridgeName	Freight House Pedestrian Bridge
Pont Notre-Dame	bridgeName	Pont Notre-Dame
Pont d'Arcole	bridgeName	Pont d'Arcole
Petit Pont	bridgeName	Petit-Pont
Pont Saint-Michel	bridgeName	Pont Saint-Michel
Passerelle Léopold-Sédar-Senghor	bridgeName	Passerelle Léopold-Sédar-Senghor
Pont de la Concorde	bridgeName	Pont de la Concorde
Kaiserbrücke, Mainz	bridgeName	Emperor Bridge
Kaiserbrücke, Mainz	bridgeName	Kaiserbrücke
Parry Sound CPR Trestle	bridgeName	Parry Sound CPR Trestle
Sauvie Island Bridge	bridgeName	Sauvie Island Bridge
Sioux Narrows Bridge	bridgeName	Sioux Narrows Bridge
Pont Louis-Philippe	bridgeName	Pont Louis-Philippe
Pont Saint-Louis	bridgeName	Pont Saint-Louis
Portal Bridge	bridgeName	Portal Bridge
Pont Mirabeau	bridgeName	Pont Mirabeau
Pont du Garigliano	bridgeName	Pont du Garigliano
Pont aval	bridgeName	Pont Aval
Pont National	bridgeName	Pont National
Pont de Tolbiac	bridgeName	Pont de Tolbiac
Passerelle Simone-de-Beauvoir	bridgeName	Passerelle Simone-de-Beauvoir
Khodaafarin Bridges	bridgeName	Khodaafarin bridge
Casco Bay Bridge	bridgeName	Casco Bay Bridge
Woolsey Finnell Bridge	bridgeName	Woolsey Finnell Bridge
Hugh R. Thomas Bridge	bridgeName	Hugh R. Thomas Bridge
Sakonnet River rail bridge	bridgeName	Sakonnet River rail bridge
Rex T. Barber Veterans Memorial Bridge	bridgeName	Rex T. Barber
Rex T. Barber Veterans Memorial Bridge	bridgeName	Veterans Memorial Bridge
Swithland Viaduct	bridgeName	Swithland Viaduct
Akmens tilts	bridgeName	Stone Bridge
Łazienkowski Bridge	bridgeName	Łazienkowski Bridge
Kinzie Street railroad bridge	bridgeName	Kinzie Street railroad bridge
Sheikh Rashid bin Saeed Crossing	bridgeName	Sheikh Rashid bin Saeed Crossing
23rd Street viaduct	bridgeName	23
18th Street Expressway Bridge	bridgeName	18
Intercity Viaduct	bridgeName	Lewis and Clark Viaduct
Union Pacific Bridge	bridgeName	Union Pacific Bridge
7th Street Trafficway Bridge	bridgeName	7
James Street Bridge	bridgeName	James Street Bridge
McMillin Bridge	bridgeName	McMillin Bridge
Fairfax Bridge	bridgeName	Fairfax Bridge
East 34th Street Bridge	bridgeName	East 34th Street Bridge
Ponte della Costituzione	bridgeName	Ponte della Costituzione
Christopher S. Bond Bridge	bridgeName	Christopher S. Bond Bridge
Walnut Lane Bridge	bridgeName	Walnut Lane Bridge
Gasworks Bridge	bridgeName	Gasworks Bridge
Greenpoint Avenue Bridge	bridgeName	Greenpoint Avenue Bridge
Queshi Bridge	bridgeName	Queshi Bridge
Memorial Bridge	bridgeName	Memorial Bridge
Jordan River Bridge	bridgeName	Jordan River Bridge
CSX Bellwood Subdivision James River Bridge	bridgeName	CSX Bellwood Subdivision James River Bridge
Norfolk Southern James River Bridge	bridgeName	Norfolk Southern James River Bridge
CSX A-Line Bridge	bridgeName	CSX A-Line Bridge
Richmond and Petersburg Railroad Bridge	bridgeName	Richmond and Petersburg Railroad Bridge
Half Chance Iron Bridge	bridgeName	Half Chance Bridge
Atlantic Coast Line Railroad Bridge	bridgeName	Atlantic Coast Line Railroad Bridge
Elwha River Bridge	bridgeName	Elwha River Bridge
Saint-Nazaire Bridge	bridgeName	Saint-Nazaire Bridge
Pont du Diable	bridgeName	Pont du Diable
Peninsula Subdivision Trestle	bridgeName	Peninsula Subdivision Trestle
Rivanna Subdivision Trestle	bridgeName	Rivanna Subdivision Trestle
Fleisch Bridge	bridgeName	Fleisch Bridge
Fleisch Bridge	bridgeName	Fleischbrücke
Mont Clare Bridge	bridgeName	Mont Clare Bridge
Pont del Diable	bridgeName	Pont del Diable
Central Avenue Bridge	bridgeName	Central Avenue Bridge
Missouri Pacific Bridge	bridgeName	Missouri Pacific Railroad Bridge
Union Pacific Intermodal Bridge	bridgeName	Union Pacific Intermodal Bridge
Interlachen Bridge	bridgeName	Interlachen Bridge
12th Street Bridge	bridgeName	12
Kansas Avenue Bridge	bridgeName	Kansas Avenue Bridge
Arkadiko Bridge	bridgeName	Arkadiko Bridge
Interstate 635 Bridge	bridgeName	Interstate 635 Bridge
Turner Bridge	bridgeName	K-32 Turner Bridge
Interstate 435 Bridge	bridgeName	Interstate 435 Bridge
K-7 Bridge	bridgeName	K-7 Bridge
Eudora Kaw River Bridge	bridgeName	Eudora Kaw River Bridge
U.S. 40 and 59 Bridges	bridgeName	U.S. 40 and U.S. 59 Bridges
Kansas Turnpike Bridges	bridgeName	Kansas Turnpike Bridges
Schoharie Bridge	bridgeName	Schoharie Bridge
Lecompton Road Bridge	bridgeName	Lecompton Road Bridge
Oakland Expressway Bridge	bridgeName	Oakland Expressway Bridge
Sardou Bridge	bridgeName	Sardou Bridge
North Kansas Avenue Bridge	bridgeName	North Kansas Avenue Bridge
Dragon Bridge	bridgeName	Dragon Bridge
United States Navy Seabees Bridge	bridgeName	United States Navy Seabees Bridge
United States Navy Seabees Bridge	bridgeName	and Justice Harlan Fiske Stone Bridge
Puh Bridge	bridgeName	Puh Bridge
Fužine Bridge	bridgeName	Fužine Bridge
Bomarsund Bridge	bridgeName	Bomarsund Bridge
Kuokkala Bridge	bridgeName	Kuokkala Bridge
Siekierkowski Bridge	bridgeName	Siekierkowski Bridge
Brotherhood Bridge	bridgeName	Brotherhood Bridge
Slateford Aqueduct	bridgeName	Slateford Aqueduct
Fairfield Bridge	bridgeName	Fairfield Bridge
Stone Bridge	bridgeName	Stone Bridge
Stone Bridge	bridgeName	Каменный Мост
Meghna Bridge	bridgeName	Meghna Bridge
I-670 Viaduct	bridgeName	Interstate 670 Viaduct
Argentine Bridge	bridgeName	Argentine Boulevard Bridge
Aldford Iron Bridge	bridgeName	Aldford Iron Bridge
Chollerford Bridge	bridgeName	Chollerford Bridge
Perth Bridge	bridgeName	Perth Bridge
Northgate, Chester	bridgeName	Northgate
Watergate, Chester	bridgeName	Watergate
Farndon Bridge	bridgeName	Farndon Bridge
Hulme Arch Bridge	bridgeName	Hulme Arch Bridge
Niagara Clifton Bridge	bridgeName	Niagara Clifton Bridge
Lake Oswego Railroad Bridge	bridgeName	Lake Oswego Railroad Bridge
Sunniberg Bridge	bridgeName	Sunniberg Bridge
New I-94 and Highway 10 Interregional Connection Bridge	bridgeName	Highway 24 Bridge
Atchafalaya Basin Bridge	bridgeName	Atchafalaya Basin Bridge
Biloxi Bay Bridge	bridgeName	Biloxi Bay Bridge
Pascagoula River High Rise Bridge	bridgeName	Pascagoula River High Rise Bridge
St. Louis Bay Bridge	bridgeName	St. Louis Bay Bridge
Groat Bridge	bridgeName	Groat Bridge
Quesnell Bridge	bridgeName	Quesnell Bridge
James MacDonald Bridge	bridgeName	James MacDonald Bridge
Shoreham Tollbridge	bridgeName	Shoreham Tollbridge
Merrill P. Barber Bridge	bridgeName	Merrill P. Barber Bridge
Edison Bridge	bridgeName	Edison Bridge
Red Skelton Memorial Bridge	bridgeName	Red Skelton Memorial Bridge
Daly's bridge	bridgeName	Daly's Bridge
Sebastian Inlet Bridge	bridgeName	Sebastian Inlet Bridge
17th Street Bridge	bridgeName	17
Wabasso Bridge	bridgeName	Wabasso Causeway Bridge
Walnut Street Bridge	bridgeName	Walnut Street Bridge
Ponte de Praia da Barra	bridgeName	Bridge of Praia da Barra
Abdoun Bridge	bridgeName	Abdoun Bridge
Judge Perez Bridge	bridgeName	Judge Perez Bridge
Ellsworth Street Bridge	bridgeName	Ellsworth Street Bridge
Mactan-Mandaue Bridge	bridgeName	1
Eastvale Bridge	bridgeName	Eastvale Bridge
Moselle Viaduct	bridgeName	Moselle Viaduct
Union Street Railroad Bridge	bridgeName	Union Street Railroad Bridge
Ponte Coperto	bridgeName	Ponte Coperto
Dunham Bridge	bridgeName	Dunham Bridge
Scotswood Bridge	bridgeName	Scotswood Bridge
Scotswood Railway Bridge	bridgeName	Scotswood Railway Bridge
Blaydon Bridge	bridgeName	Blaydon Bridge
Crumlin Viaduct	bridgeName	Crumlin Viaduct
John F. Limehouse Memorial Bridge	bridgeName	Limehouse Memorial Bridge
Shanghai Yangtze River Tunnel and Bridge	bridgeName	Shanghai Yangtze River Bridge
Shanghai Yangtze River Tunnel and Bridge	bridgeName	上海长江大桥
Carter Bridge	bridgeName	Carter Bridge
Masnaa Border Crossing	bridgeName	Masnaa Border Crossing
Pond Eddy Bridge	bridgeName	Pond Eddy Bridge
All-America Bridge	bridgeName	All-America Bridge
Topolog Viaduct	bridgeName	Topolog Viaduct
Makupa Causeway	bridgeName	Makupa Causeway
Clover Bar Bridge	bridgeName	Clover Bar Bridge
Mattancherry Bridge	bridgeName	Mattancherry Bridge
Eglinton Tournament Bridge	bridgeName	Eglinton Tournament Bridge
Brig o' Doon	bridgeName	Brig o' Doon
Nichols Bridgeway	bridgeName	Nichols Bridgeway
Livermore Bridge	bridgeName	Livermore Bridge
Medley Footbridge	bridgeName	Medley Footbridge
Beverly Railroad Bridge	bridgeName	Beverly Railroad Bridge
Moyie River Canyon Bridge	bridgeName	Moyie River Bridge
University Avenue Bridge	bridgeName	University Avenue Bridge
Little Wittenham Bridge	bridgeName	Little Wittenham Bridge
Hartford Bridge, Cheshire	bridgeName	Hartford Bridge
Monkwearmouth Railway Bridge	bridgeName	Monkwearmouth railway bridge
Hylton Viaduct	bridgeName	Hylton Viaduct
Victoria Viaduct	bridgeName	Victoria Viaduct
Cox Green Footbridge	bridgeName	Cox Green Footbridge
Chartershaugh Bridge	bridgeName	Chartershaugh Bridge
Pasco–Kennewick Bridge	bridgeName	Pasco–Kennewick Bridge
Interstate 182 Bridge	bridgeName	Interstate 182 Bridge
Hannington Bridge	bridgeName	Hannington Bridge
Castle Eaton Bridge	bridgeName	Castle Eaton Bridge
BP Pedestrian Bridge	bridgeName	BP Pedestrian Bridge
Walterdale Bridge	bridgeName	Walterdale Bridge
Dawson Bridge	bridgeName	Dawson Bridge
Meiko Nishi Ohashi roadway bridges	bridgeName	Meiko Nishi Ohashi roadway bridges
Cricklade Town Bridge	bridgeName	Cricklade Town Bridge
Avon Aqueduct	bridgeName	Avon Aqueduct
33rd Street Railroad Bridge	bridgeName	33
Braunstone Gate Bridge	bridgeName	Bowstring Bridge
Onepoto Bridge	bridgeName	Onepoto Bridge
Puente Colgante	bridgeName	Puente Colgante
Thames River Bridge	bridgeName	Thames River Bridge
Grandpont Bridge	bridgeName	Grandpont Bridge
Bayview Bridge	bridgeName	Bayview Bridge
Long–Allen Bridge	bridgeName	Long–Allen Bridge
Long–Allen Bridge	bridgeName	Long–Allen Bridge
Al Waleed border crossing	bridgeName	Al Waleed border crossing
Dungeness River Bridge	bridgeName	Dungeness River Bridge
Tinkers Creek Aqueduct	bridgeName	Tinkers Creek Aqueduct
Camino Real International Bridge	bridgeName	Camino Real International Bridge
La Linda International Bridge	bridgeName	La Linda International Bridge
Bridge of the Americas	bridgeName	Bridge of the Americas
Strawberry Mansion Bridge	bridgeName	Strawberry Mansion Bridge
Minnesota Highway 371 Bridge	bridgeName	Minnesota Highway 371 Bridge
Vernita Bridge	bridgeName	Vernita Bridge
Umatilla Bridge	bridgeName	Umatilla Bridge
Falls Bridge	bridgeName	Falls Bridge
Wylam Bridge	bridgeName	Wylam Bridge
Newburn Bridge	bridgeName	Newburn Bridge
DB Draw	bridgeName	DB Draw
Tom 'Diver' Derrick Bridge	bridgeName	'Diver' Derrick Bridge
Flats Industrial Railroad	bridgeName	Flats Industrial Railroad
Flats Industrial Railroad	bridgeName	vertical lift bridge
Constantine's Bridge	bridgeName	Constantine's Bridge
Alcántara Bridge	bridgeName	Alcántara Bridge
Jacques Bizard Bridge	bridgeName	Jacques Bizard Bridge
Potseluev Bridge	bridgeName	Potseluev Bridge
Potseluev Bridge	bridgeName	Поцелуев Мост
Saint-Laurent Railway Bridge	bridgeName	Saint-Laurent Railway Bridge
Galipeault Bridge	bridgeName	Galipeault Bridge
Nyali Bridge	bridgeName	Nyali Bridge
Nyali Bridge	bridgeName	Old Nyali Bridge
Queens Bridge	bridgeName	Queens Bridge
Charles Grimes Bridge	bridgeName	Charles Grimes Bridge
Church Street Bridge	bridgeName	Church Street Bridge
Spencer Street Bridge	bridgeName	Spencer Street Bridge
MacRobertson Bridge	bridgeName	MacRobertson Bridge
Nivedita Setu	bridgeName	Nivedita Setu
Nivedita Setu	bridgeName	নিবেদিতা সেতু
Ponte di Quintodecimo	bridgeName	Ponte di Quintodecimo
Beška Bridge	bridgeName	Beška Bridge
Beška Bridge	bridgeName	Мост код Бешке
Beška Bridge	bridgeName	Most kod Beške
Rosh HaNikra Crossing	bridgeName	Rosh HaNikra Crossing
John F. Kennedy Memorial Causeway	bridgeName	John F. Kennedy Memorial Causeway
Tilikum Crossing	bridgeName	Tilikum Crossing
Monongahela City Bridge	bridgeName	Monongahela City Bridge
Locust Creek Covered Bridge	bridgeName	Locust Creek Covered Bridge
19th Street Bridge	bridgeName	19
Warehouse Point railroad bridge	bridgeName	Warehouse Point railroad bridge
Highlands – Sea Bright Bridge	bridgeName	Highlands-Sea Bright Bridge
Robert H. Mollohan-Jefferson Street Bridge	bridgeName	Jefferson Street Bridge
Third Street Bridge	bridgeName	Third Street Bridge
John B. Whealton Memorial Causeway	bridgeName	John B. Whealton Memorial Causeway
West Cornwall Covered Bridge	bridgeName	West Cornwall Covered Bridge
Sultan Ahmad Shah Bridge	bridgeName	Sungai Pahang Bridge
Olivier-Charbonneau Bridge	bridgeName	Olivier Charbonneau Bridge
Selinsgrove Bridge	bridgeName	Selinsgrove Bridge
Veterans Memorial Bridge	bridgeName	Veterans Memorial Bridge
P.W. & B. Railroad Bridge	bridgeName	P.W. & B. Railroad Bridge
Le Gardeur Bridge	bridgeName	Le Gardeur Bridge
Charles de Gaulle Bridge	bridgeName	Charles de Gaulle Bridge
Laurier Railway Bridge	bridgeName	Laurier Railway Bridge
Long Beach Bridge	bridgeName	Long Beach Bridge
Shaw Bridge	bridgeName	Shaw Bridge
Qasr al-Nil Bridge	bridgeName	Qasr al-Nil Bridge
Wakwella Bridge	bridgeName	Wakwella Bridge
Tees Viaduct	bridgeName	Tees Viaduct
Julia Butler Hansen Bridge	bridgeName	Julia Butler Hansen Bridge
Demidov Bridge	bridgeName	Demidov Bridge
Demidov Bridge	bridgeName	Демидов Мост
Flour Bridge	bridgeName	Flour Bridge
Flour Bridge	bridgeName	Мучной мост
Reading Festival Bridge	bridgeName	Reading Festival Bridge
Peter Guice Memorial Bridge	bridgeName	Peter Guice Memorial Bridge
Crittenden Bridge	bridgeName	Crittenden Bridge
Hermitage Bridge	bridgeName	Hermitage Bridge
Euharlee Covered Bridge	bridgeName	Euharlee Covered Bridge
Sennoy Bridge	bridgeName	Hay Bridge
Sennoy Bridge	bridgeName	Сенной мост
Novo-Konyushenny Bridge	bridgeName	Novo-Konyushenny Bridge
Novo-Konyushenny Bridge	bridgeName	Ново-Конюшенный мост
Kokushkin Bridge	bridgeName	Kokushkin Bridge
Kokushkin Bridge	bridgeName	Кокушкин мост
Sangarius Bridge	bridgeName	Sangarius Bridge
Samuel Beckett Bridge	bridgeName	Samuel Beckett Bridge
CSX Bridge	bridgeName	CSX Painesville, Ohio
Blair Bridge	bridgeName	Blair Bridge
Blair Bridge	bridgeName	Blair Bridge
Blair Bridge	bridgeName	Blair Bridge
Yavuz Sultan Selim Bridge	bridgeName	Yavuz Sultan Selim Bridge
Kichi Sipi Bridge	bridgeName	Kichi Sipi Bridge
Netafim Border Crossing	bridgeName	Netafim Crossing
Cherry Street Strauss Trunnion Bascule Bridge	bridgeName	Cherry Street Strauss Trunnion Bascule Bridge
Homeland Bridge	bridgeName	Homeland Bridge
Suplacu de Barcău Viaduct	bridgeName	Suplacu de Barcǎu Viaduct
Fred G. Redmon Bridge	bridgeName	Fred G. Redmon Bridge
Mersey Gateway	bridgeName	Mersey Gateway
Dodger Point Bridge	bridgeName	Dodger Point Bridge
Puddefjord Bridge	bridgeName	Puddefjord Bridge
River Suir Bridge	bridgeName	River Suir Bridge
Les Ferreres Aqueduct	bridgeName	Les Ferreres Aqueduct
Les Ferreres Aqueduct	bridgeName	Aqüeducte de les Ferreres
Dornoch Firth Bridge	bridgeName	Dornoch Firth Bridge
Washington Bridge	bridgeName	Washington Bridge
Pelham Bay Bridge	bridgeName	Pelham Bay Bridge
Rouge River Bridge	bridgeName	Rouge River Bridge
Hal W. Adams Bridge	bridgeName	Hal W. Adams Bridge
Queen's Bridge	bridgeName	Queen's Bridge
Pont Gustave-Flaubert	bridgeName	Pont Gustave-Flaubert
Aigi Bridge	bridgeName	Aigioohashi Bridge
Aigi Bridge	bridgeName	愛岐大橋
Watertown Bridge	bridgeName	Watertown Bridge
Platte River Bridge	bridgeName	Platte River Bridge
Highland Bridge	bridgeName	Highland Bridge
Eggner's Ferry Bridge	bridgeName	Eggner's Ferry Bridge
Pont de Recouvrance	bridgeName	Pont de Recouvrance
Pont National	bridgeName	Pont National
Isle of Palms Connector Bridge	bridgeName	Isle of Palms Connector Bridge
Campbell's Covered Bridge	bridgeName	Campbell's Covered Bridge
Ben Sawyer Bridge	bridgeName	Ben Sawyer Bridge
Satok Bridge	bridgeName	Sungai Sarawak Bridge
Datuk Patinggi Haji Abdul Rahman Bridge	bridgeName	Sungai Sarawak Bridge
River Street Bridge	bridgeName	River Street Bridge
Western Avenue Bridge	bridgeName	Western Avenue Bridge
John W. Weeks Bridge	bridgeName	John W. Weeks Bridge
Eliot Bridge	bridgeName	Eliot Bridge
Riparius Bridge	bridgeName	Riparius Bridge
North Creek Bridge	bridgeName	North Creek Bridge
The Glen Bridge	bridgeName	The Glen Bridge
Thurman Station Bridge	bridgeName	Thurman Station Bridge
Mechanicville Bridge	bridgeName	Mechanicville Bridge
Rock Island Swing Bridge	bridgeName	Rock Island Swing Bridge
Locke Avenue Bridge	bridgeName	Locke Avenue Bridge
Hurricane Deck Bridge	bridgeName	Hurricane Deck Bridge
Metropolis Bridge	bridgeName	Metropolis Bridge
Niangua Bridge	bridgeName	Niangua Bridge
Niangua Arm US 54 Bridge	bridgeName	Niangua Arm US 54 Bridge
Van Veghten's Bridge	bridgeName	Van Veghten's Bridge
Giurgeni–Vadu Oii Bridge	bridgeName	Giurgeni–Vadu Oii Bridge
Pont sur la Laye	bridgeName	Pont sur la Laye
Pont des Marchands	bridgeName	Pont des Marchands
Gemarrin Bridge	bridgeName	Gemarrin Bridge
Roman Bridge	bridgeName	Roman Bridge
Constantine's Bridge	bridgeName	Constantine's Bridge
Leontes Bridge	bridgeName	Leontes Bridge
White Bridge	bridgeName	White Bridge
Ponte del Gran Caso	bridgeName	Ponte del Gran Caso
Ponte di Pioraco	bridgeName	Ponte di Pioraco
Cedar Canyon Bridge	bridgeName	Cedar Canyon Bridge
Corduroy Creek Bridge	bridgeName	Corduroy Creek Bridge
St. Charles Air Line Bridge	bridgeName	St. Charles Air Line Bridge
Kharaba Bridge	bridgeName	Kharaba Bridge
Pont de Pierre	bridgeName	Pont de Pierre
Walney Bridge	bridgeName	Walney Bridge
Bridge at Nimreh	bridgeName	Bridge at Nimreh
Langley Covered Bridge	bridgeName	Langley Covered Bridge
Aomori Bay Bridge	bridgeName	Aomori Bay Bridge
Pont d'Aël	bridgeName	Pont d'Aël
Ponte San Lorenzo	bridgeName	Ponte San Lorenzo
Thornton viaduct	bridgeName	Thornton viaduct
Eurymedon Bridge	bridgeName	Eurymedon Bridge
Weidendammer Bridge	bridgeName	Weidendammer Bridge
Weidendammer Bridge	bridgeName	Weidendammer Brücke
Ganter Bridge	bridgeName	Ganter Bridge
Mears Memorial Bridge	bridgeName	Mears Memorial Bridge
Bridge near Limyra	bridgeName	Bridge near Limyra
Indooroopilly Railway Bridge	bridgeName	Indooroopilly Railway
Puente Transbordador	bridgeName	Puente Transbordador
C215 Viaduct	bridgeName	C215 Viaduct
Schuylerville Bridge	bridgeName	Schuylerville Bridge
Nysa Bridge	bridgeName	Nysa Bridge
Port Orange Causeway	bridgeName	Port Orange Causeway
Granada Bridge	bridgeName	Granada Bridge
Baishazhou Yangtze River Bridge	bridgeName	Baishazhou Yangtze River Bridge
Qingchuan Bridge	bridgeName	Qingchuan Bridge
Derby-Shelton Bridge	bridgeName	Derby-Shelton Bridge
Pentele Bridge	bridgeName	Pentele Bridge
Puente Rodolfo Robles	bridgeName	Puente Rodolfo Robles
Turnbridge Lift Bridge	bridgeName	Turnbridge Lift Bridge
Shawneetown Bridge	bridgeName	Shawneetown Bridge
Jinan Yellow River Bridge	bridgeName	Jinan Yellow River Bridge
Capilano Bridge	bridgeName	Capilano Bridge
Marion Street Bridge	bridgeName	Marion Street Bridge
Center Street Bridge	bridgeName	Center Street Bridge
Dietz Covered Bridge	bridgeName	Bergstresser Covered Bridge
Paper Mill Village Bridge	bridgeName	Paper Mill Village Bridge
Tähtiniemi Bridge	bridgeName	Tähtiniemi Bridge
Ravenna Bridge	bridgeName	Ravenna Bridge
8 November Bridge	bridgeName	--11-08
Arida Border Crossing	bridgeName	Arida Border Crossing
Daraa Border Crossing	bridgeName	Daraa Border Crossing
Nasib Border Crossing	bridgeName	Nasib Border Crossing
Schoharie Creek Bridge collapse	bridgeName	Schoharie Creek Bridge
Schierstein Bridge	bridgeName	Schierstein Bridge
John Frost Bridge	bridgeName	John Frost Bridge
Breydon Viaduct	bridgeName	Breydon Viaduct
Tauranga Harbour Bridge	bridgeName	Tauranga Harbour Bridge
Rock Island Railroad Bridge	bridgeName	Rock Island Railroad Bridge
Sidu River Bridge	bridgeName	Sidu River Bridge
All-American Canal Bridge	bridgeName	All-American Canal Bridge
McKeesport Connecting Railroad Bridge	bridgeName	McKeesport Connecting Railroad Bridge
Coast Meridian Overpass	bridgeName	Coast Meridian Overpass
Huangpu Bridge	bridgeName	Huangpu Bridge
McKinley Washington Jr. Bridge	bridgeName	Dawhoo River Bridge
Lansky station crossover	bridgeName	Lansky station crossover
Malir River Bridge	bridgeName	Malir River Bridge
Innerbelt Bridge	bridgeName	Innerbelt Bridge
Hosur Road Elevated Expressway	bridgeName	Bangalore Elevated Tollway
Hosur Road Elevated Expressway	bridgeName	Hosur Road Elevated Expressway
Jarun Bridge	bridgeName	Jarun Bridge
Busan–Geoje Fixed Link	bridgeName	Busan–Geoje Fixed Link
Rodoferroviária Bridge	bridgeName	Rodoferroviária Bridge
Putnam Street Bridge	bridgeName	Putnam Street Bridge
Pont Serme	bridgeName	Pont Serme
Pont de Neuilly	bridgeName	Pont de Neuilly
Flat Bridge	bridgeName	Flat Bridge
Flintshire Bridge	bridgeName	Flintshire Bridge
Skytrail	bridgeName	Skytrail
Anthony Wayne Bridge	bridgeName	Anthony Wayne Bridge
Liteyny bridge, Sestroretsk	bridgeName	Liteyny railway bridge
Bridge near Kemer	bridgeName	Bridge near Seydikemer
London Road viaduct	bridgeName	London Road Viaduct
Lady Wimborne Bridge	bridgeName	The Lady Wimborne
Fleming Park Bridge	bridgeName	Fleming Park Bridge
Zavodskaya sestra crossover	bridgeName	Zavodskaya sestra crossover
Macestus Bridge	bridgeName	Macestus Bridge
Susitna River Bridge	bridgeName	Susitna River Bridge
Little Equinunk Bridge	bridgeName	Little Equinunk Bridge
Narrowsburg–Darbytown Bridge	bridgeName	Narrowsburg-Darbytown Bridge
Skinners Falls–Milanville Bridge	bridgeName	Skinners Falls – Milanville Bridge
Puente Romano, Mérida	bridgeName	Puente Romano
Chain Bridge	bridgeName	Chain Bridge
Pont Flavien	bridgeName	Pont Flavien
Four bridges on three support	bridgeName	Bolshoy Sampsoinevsky crossover
Tea Gardens-Hawks Nest Bridge	bridgeName	Tea Gardens-Hawks Nest Bridge
Lakhtinsky crossover	bridgeName	Lakhtinsky crossover
Barryville–Shohola Bridge	bridgeName	Barryville&ndash;Shohola Bridge
English Bridge	bridgeName	English Bridge
English Bridge	bridgeName	Английский мост
Adriatic Bridge	bridgeName	Adriatic Bridge
Ypsilon	bridgeName	Ypsilon Bridge
Rạch Miễu Bridge	bridgeName	Rạch Miễu Bridge
Museum Covered Bridge	bridgeName	Museum Covered Bridge
Minato Bridge	bridgeName	Minato Bridge
Hàn River Bridge	bridgeName	Han River Bridge
Great South Bay Bridge	bridgeName	Great South Bay Bridges
Smith Point Bridge	bridgeName	Smith Point Bridge
City to Sea Bridge	bridgeName	City to Sea Bridge
Hill to Hill Bridge	bridgeName	Hill to Hill Bridge
Cardè Bridge	bridgeName	Cardè Bridge
Gallox Bridge, Dunster	bridgeName	Gallox Bridge
Lewis Bandt Bridge	bridgeName	Lewis Bandt Bridge
Arsenal Street Bridge	bridgeName	Arsenal Street Bridge
North Beacon Street Bridge	bridgeName	North Beacon Street Bridge
Stevenson Dam Bridge	bridgeName	Stevenson Dam Bridge
Hannam Bridge	bridgeName	Hannam Bridge
Banpo Bridge	bridgeName	Banpo Bridge
Shaikh Isa Causeway	bridgeName	Shaikh Isa Causeway
Minsi Trail Bridge	bridgeName	Minsi Trail Bridge
Philip J. Fahy Memorial Bridge	bridgeName	Phillip J. Fahy Memorial Bridge
Van Stadens Bridge	bridgeName	Van Stadens Bridge
Paul Sauer Bridge	bridgeName	Paul Sauer Bridge
Pont y Werin	bridgeName	Pont y Werin
Chevelon Creek Bridge	bridgeName	Chevelon Creek Bridge
Canal Street railroad bridge	bridgeName	Canal Street railroad bridge
Infinity Bridge	bridgeName	Infinity Bridge
Kentucky Route 2014 Bridge	bridgeName	Kentucky Route 2014 Bridge
Kentucky Route 2014 Bridge	bridgeName	Bridge #007B00129N
Cherry Avenue Bridge	bridgeName	Cherry Avenue Bridge
Pergamon Bridge	bridgeName	Pergamon Bridge
Nansemond River Bridge	bridgeName	Nansemond River Bridge
Layton Bridge	bridgeName	Layton Bridge
Tulip Viaduct	bridgeName	Tulip Viaduct
Karamagara Bridge	bridgeName	Karamagara Bridge
Aesepus Bridge	bridgeName	Aesepus Bridge
Ponte Nomentano	bridgeName	Ponte Nomentano
Ponte di San Francesco	bridgeName	Ponte di San Francesco
Baling River Bridge	bridgeName	Baling River Bridge
Freixo Bridge	bridgeName	Ponte do Freixo
Ponte Salario	bridgeName	Ponte Salario
Ponte Altinate	bridgeName	Ponte Altinate
Ponte Molino	bridgeName	Ponte Molino
Ponte Corvo	bridgeName	Ponte Corvo
Siouxland Veterans Memorial Bridge	bridgeName	Siouxland Veterans Memorial Bridge
Interstate Bridge	bridgeName	Interstate Bridge
Wabash Avenue Bridge	bridgeName	Wabash Avenue Bridge
Banghwa Bridge	bridgeName	Banghwa Bridge
Penkalas Bridge	bridgeName	Penkalas Bridge
Old Youngs Bay Bridge	bridgeName	Old Youngs Bay Bridge
Bluff Dale Suspension Bridge	bridgeName	Bluff Dale Suspension Bridge
Dollis Brook Viaduct	bridgeName	Dollis Brook Viaduct
Kennedy Bridge	bridgeName	Kennedy-Brücke
Malaysia–Singapore Third Crossing	bridgeName	Malaysia-Singapore Third Crossing
Labuan–Menumbok Bridge	bridgeName	Labuan–Menumbok Bridge
Jonathon Hulton Bridge	bridgeName	Jonathon Hulton Bridge
Allegheny River Turnpike Bridge	bridgeName	Allegheny River Turnpike Bridge
Koilwar Bridge	bridgeName	Koilwar Bridge
Sturgeon Bay Bridge	bridgeName	Sturgeon Bay Bridge
Corbridge Bridge	bridgeName	Corbridge Bridge
Hexham Bridge	bridgeName	Hexham Bridge
Gray's Ferry Bridge	bridgeName	Grays Ferry Avenue Bridge
Holt-Bragg Bridge	bridgeName	Holt-Bragg Bridge
Hexham Old Bridge	bridgeName	Hexham Old Bridge
Constantius Bridge	bridgeName	Constantius Bridge
Border Counties Bridge	bridgeName	Border Counties Bridge
Third Thai–Lao Friendship Bridge	bridgeName	Third Thai–Lao Friendship Bridge
Eleanor Ward Bridge	bridgeName	Eleanor Ward Bridge
Snow-Reed Swing Bridge	bridgeName	11
Lennox Bridge, Glenbrook	bridgeName	Lennox Bridge
Thomas Creek Bridge	bridgeName	Thomas Creek Bridge
Cathedral Green Footbridge	bridgeName	Cathedral Green Footbridge
Exeter Bridge	bridgeName	Exeter Bridge - Derby
Wadi el Kuf Bridge	bridgeName	Wadi el Kuf Bridge
Main Avenue Bridge	bridgeName	Main Avenue Bridge
Ligovsky overpass	bridgeName	Ligovsky overpass
Langkawi Sky Bridge	bridgeName	Langkawi Sky Bridge
Iron Bridge, Satu Mare	bridgeName	Iron Bridge
Phú Mỹ Bridge	bridgeName	Phú Mỹ Bridge
Styford Bridge	bridgeName	Styford Bridge
Novo-kamenniy Bridge	bridgeName	Novo-kamenniy Bridge
Bywell Bridge	bridgeName	Bywell Bridge
Jamsu Bridge	bridgeName	Jamsu Bridge
Kallestadsundet Bridge	bridgeName	Kallestadsundet Bridge
Wadi Leban Bridge	bridgeName	Wadi Leban Bridge
Bridge L-158	bridgeName	Bridge L-158
Waalbrug	bridgeName	Waalbrug
Railway Bridge, Riga	bridgeName	Railway Bridge
Island Bridge, Riga	bridgeName	Island Bridge
Southern Bridge	bridgeName	Southern Bridge
Shahi Bridge, Jaunpur	bridgeName	Shahi Bridge
Shahi Bridge, Jaunpur	bridgeName	शाही पुल
Knippelsbro	bridgeName	Knippelsbro
Novo-Admiralteysky Bridge	bridgeName	Novo-Admiralteysky Bridge
Maiden Lane Bridge	bridgeName	Maiden Lane Bridge
Great River Bridge	bridgeName	Great River Bridge
Silver Bridge	bridgeName	Silver Bridge
Topeka Boulevard Bridge	bridgeName	Topeka Boulevard Bridge
Westgate Bridge	bridgeName	Westgate/Highway 75 Bridge
Willard Bridge	bridgeName	Willard Bridge
Maple Hill Bridge	bridgeName	Maple Hill Bridge
K-99 Wamego Bridge	bridgeName	K-99 Wamego Bridge
Taipei Bridge	bridgeName	Taipei Bridge
Taipei Bridge	bridgeName	台北大橋
Ostrovul Mare Bridge	bridgeName	Ostrovul Mare Bridge
Stolma Bridge	bridgeName	Stolma Bridge
Bryggebroen	bridgeName	Bryggebroen
Southdown Road Skew Bridge	bridgeName	Southdown Road Skew Bridge
Dan Patch Line Bridge	bridgeName	Dan Patch Line Bridge
Fossil Creek Bridge	bridgeName	Fossil Creek Bridge
Verde River Bridge	bridgeName	Verde River Bridge
Perkinsville Bridge	bridgeName	Perkinsville Bridge
Neidpath Viaduct	bridgeName	Neidpath Viaduct
Frederick W. Panhorst Bridge	bridgeName	Russian Gulch Bridge
Taschereau Bridge	bridgeName	Taschereau Bridge
Opawa River Bridge	bridgeName	Opawa River Bridge
Princess of Wales Bridge	bridgeName	Princess of Wales Bridge
Rock Creek Canyon Bridge	bridgeName	Rock Creek Canyon Bridge
Teesquay Millennium Footbridge	bridgeName	Teesquay Millennium Footbridge
Lyne Viaduct	bridgeName	Lyne Viaduct
Kielder Viaduct	bridgeName	Kielder Viaduct
Norfolk Southern Lake Pontchartrain Bridge	bridgeName	Norfolk Southern Lake Pontchartrain Bridge
Broadmeadow viaduct	bridgeName	Broadmeadow viaduct
Diocletianus Aqueduct	bridgeName	Dioklecijanov akvadukt
Diocletianus Aqueduct	bridgeName	Diocletianus Aqueduct
Caneadea Bridge	bridgeName	Caneadea Bridge
Confusion Hill Bridges	bridgeName	Confusion Hill Bridges
New Wear bridge	bridgeName	New Wear Bridge
Kettle Falls Bridges	bridgeName	Kettle Falls Bridges
Church Street Covered Bridge	bridgeName	Church Street Covered Bridge
Peace Bridge	bridgeName	Peace Bridge
Maple Street Covered Bridge	bridgeName	Maple Street Covered Bridge
Browns River Covered Bridge	bridgeName	Browns River Covered Bridge
Gates Farm Covered Bridge	bridgeName	Gates Farm Covered Bridge
Beebe Bridge	bridgeName	Beebe Bridge
Arch Bridge	bridgeName	Arch Bridge
Kizuna Bridge	bridgeName	Kizuna bridge
Thanlyin Bridge	bridgeName	Thanlyin Bridge
Thanlyin Bridge	bridgeName	သန်လျင် တံတား
Thanlyin Bridge 2	bridgeName	Thanlyin Bridge
Thanlyin Bridge 2	bridgeName	သန်လျင် တံတား အမှတ်
Hacho Bridge	bridgeName	Hacho Bridge
Louise Bridge	bridgeName	Louise Bridge
East Fairfield Covered Bridge	bridgeName	East Fairfield Covered Bridge
Poland Covered Bridge	bridgeName	Poland Covered Bridge
Grist Mill Covered Bridge	bridgeName	Grist Mill Covered Bridge
Hereford Road Skew Bridge	bridgeName	Hereford Road Skew Bridge
Baluarte Bridge	bridgeName	Baluarte Bridge
Sultan Yusuf Bridge	bridgeName	Sungai Perak Bridge
Iskandariah Bridge	bridgeName	Sungai Perak Bridge
Sultan Abdul Jalil Shah Bridge	bridgeName	Sungai Perak Bridge
Abu Bakar Bridge	bridgeName	Sungai Pahang Bridge
Sultan Azlan Shah Bridge	bridgeName	Sungai Perak Bridge
Sultan Idris Shah II Bridge	bridgeName	Sungai Perak Bridge
Sultan Salahuddin Abdul Aziz Shah Bridge	bridgeName	Sungai Selangor Bridge
Fourth Thai–Lao Friendship Bridge	bridgeName	Fourth Thai–Lao Friendship Bridge
Prek Tamak Bridge	bridgeName	Prek Tamak Bridge
Horkstow Bridge	bridgeName	Horkstow Bridge
Zacatal Bridge	bridgeName	Zacatal Bridge
Ferry Street Bridge	bridgeName	Ferry Street Bridge
Power House Covered Bridge	bridgeName	Power House Covered Bridge
Scribner Covered Bridge	bridgeName	Scribner Covered Bridge
Van Buren Street Bridge	bridgeName	Van Buren Street bridge
Jisr Jindas	bridgeName	Jisr Jindas
Yibna Bridge	bridgeName	Yibna Bridge
Hadley Parabolic Bridge	bridgeName	Hadley Parabolic Bridge
Victoria Bridge, Townsville	bridgeName	Victoria Bridge, Townsville
Phan Phiphop Lila Bridge	bridgeName	Phan Phiphop Lila Bridge
Bridge in West Earl Township	bridgeName	Bridge in West Earl Township
Amtrak Old Saybrook – Old Lyme Bridge	bridgeName	Amtrak Old Saybrook – Old Lyme Bridge
Bigelow Bridge	bridgeName	Bigelow Bridge
Cornwall Bridge	bridgeName	Cornwall Bridge
Bull's Bridge	bridgeName	Bull's Bridge
Lover's Leap Bridge	bridgeName	Lover's Leap Bridge
Cheonho Bridge	bridgeName	Cheonho Bridge
Hite Crossing Bridge	bridgeName	Hite Crossing Bridge
Fyksesund Bridge	bridgeName	Fyksesund Bridge
Ted Smout Memorial Bridge	bridgeName	Ted Smout Memorial Bridge
North Bridge, Halifax	bridgeName	North Bridge
Loren Bridge	bridgeName	Bridge through Loren
Biryulka	bridgeName	Ice bridge in the selo of Biryulka
Galena Creek Bridge	bridgeName	Galena Creek Bridge
Russky Bridge	bridgeName	Russky Bridge
Langebro	bridgeName	Langebro
Jiak Kim Bridge	bridgeName	Jiak Kim Bridge
Jalan Buroh Extradosed Bridge	bridgeName	Jalan Buroh Extradosed Bridge
Hathaway Bridge	bridgeName	Hathway Bridge
Valley Bridge	bridgeName	Valley Bridge
Firefighters' Memorial Bridge	bridgeName	Water Street Bridge
Terzijski Bridge	bridgeName	Terzijski Bridge
Penponds Viaduct	bridgeName	Penponds Viaduct
Carmine Liberta Bridge	bridgeName	Carmine Liberta Bridge
Barker Crossing	bridgeName	Barker Crossing
Borden Bridge	bridgeName	Borden Bridge
Canadian Northern Railway Bridge	bridgeName	Canadian Northern Railway Bridge
Crooked Bridge	bridgeName	Old Nipawin Bridge
Arapsu Bridge	bridgeName	Arapsu Bridge
St. Louis Bridge	bridgeName	St. Louis  Bridge
Eurymedon Bridge	bridgeName	Eurymedon Bridge
Grand Coulee Bridge	bridgeName	Grand Coulee Bridge
E. J. %22Lionel%22 Grizzaffi Bridge	bridgeName	E. J. \
Berwick Bay Bridge	bridgeName	Berwick Bay Bridge
Long–Allen Bridge	bridgeName	Long–Allen Bridge
Union Railroad Port Perry Bridge	bridgeName	Union Railroad Port Perry Bridge
PRR Port Perry Bridge	bridgeName	PRR Port Perry Bridge
McKeesport-Duquesne Bridge	bridgeName	McKeesport-Duquesne Bridge
W.D. Mansfield Memorial Bridge	bridgeName	W.D. Mansfield Memorial Bridge
Clairton-Glassport Bridge	bridgeName	Clairton-Glassport Bridge
Union Railroad Clairton Bridge	bridgeName	Union Railroad Clairton Bridge
Regis R. Malady Bridge	bridgeName	Regis R. Malady Bridge
Herr's Island Railroad Bridge	bridgeName	Herr's Island Railroad Bridge
30th Street Bridge	bridgeName	Thirtieth Street Bridge
31st Street Bridge	bridgeName	Thirty-First Street Bridge
Washington Crossing Bridge	bridgeName	Washington Crossing Bridge
Highland Park Bridge	bridgeName	Highland Park Bridge
Senator Robert D. Fleming Bridge	bridgeName	Senator Robert D. Fleming Bridge
Brilliant Branch Railroad Bridge	bridgeName	Brilliant Branch Railroad Bridge
Bessemer & Lake Erie Railroad Bridge	bridgeName	Bessemer & Lake Erie Railroad Bridge
C.L. Schmitt Bridge	bridgeName	C.L. Schmitt Bridge
George D. Stuart Bridge	bridgeName	George D. Stuart Bridge
Donald R. Lobaugh Bridge	bridgeName	Donald R. Lobaugh Bridge
Donora-Webster Bridge	bridgeName	Donora-Webster Bridge
Bridge of Glass	bridgeName	Bridge of Glass
Benjamin Franklin Bridge	bridgeName	Benjamin Franklin Bridge
Walt Whitman Bridge	bridgeName	Walt Whitman Bridge
Ballachulish Bridge	bridgeName	Ballachulish Bridge
Robber's Bridge	bridgeName	Robber's Bridge
Ain Diwar Bridge	bridgeName	Ain Diwar Bridge
Langevin Bridge	bridgeName	Langevin Bridge
Emlenton Bridge	bridgeName	Emlenton Bridge
Jintang Bridge	bridgeName	Jintang Bridge
Jintang Bridge	bridgeName	金塘大桥
Allegheny Aqueduct	bridgeName	Allegheny Aqueduct
Chamberlin Mill Covered Bridge	bridgeName	Chamberlin Mill Covered Bridge
Swing Bridge, River Neath	bridgeName	Swingbridge over the River Neath
Taoyaomen Bridge	bridgeName	Taoyaomen Bridge
Taoyaomen Bridge	bridgeName	桃夭门大桥
Tongji Bridge	bridgeName	Tongji Bridge
Tongji Bridge	bridgeName	通濟橋
Xijin Bridge	bridgeName	Xijin Bridge
Xijin Bridge	bridgeName	西津桥
Tongji Bridge	bridgeName	Tongji Bridge
Tongji Bridge	bridgeName	通濟橋
Chengyang Bridge	bridgeName	Chengyang Wind-Rain Bridge
Chengyang Bridge	bridgeName	程陽風雨橋
Guyue Bridge	bridgeName	Guyue Bridge
Guyue Bridge	bridgeName	古月橋
Colleges Crossing	bridgeName	College’s Crossing
Broad River Bridge	bridgeName	Broad River Bridge
Clifton Bridge	bridgeName	Clifton Bridge
Saugatuck River Bridge	bridgeName	Saugatuck River Bridge
Harrington Bridge	bridgeName	Harrington Bridge
Slauerhoffbrug	bridgeName	Slauerhoffbrug
Gunthorpe Bridge	bridgeName	Gunthorpe Bridge
Bridge in Cumberland Township	bridgeName	Cunningham Bridge
Anping Bridge	bridgeName	Anping Bridge
Wilford Suspension Bridge	bridgeName	Wilford Suspension Bridge
Wilford Toll Bridge	bridgeName	Wilford Toll Bridge
Rectory Junction Viaduct	bridgeName	Rectory Junction Viaduct
Pont-y-Cafnau	bridgeName	Pont-y-Cafnau
Keadby Bridge	bridgeName	Keadby Bridge
Trent Bridge, Gainsborough	bridgeName	Trent Bridge, Gainsborough
Arapuni Suspension Bridge	bridgeName	Arapuni Suspension Bridge
Sheikh Zayed Bridge	bridgeName	Sheikh Zayed Bridge
Speers Railroad Bridge	bridgeName	Speers Railroad Bridge
Viaducto de Montabliz	bridgeName	Viaduct of Montabliz
Barton Road Swing Bridge	bridgeName	Barton Road Swing Bridge
Jacob Beltzhoover	bridgeName	Monongahela Bridge
Cochin Bridge	bridgeName	Cochin Bridge
Sherwood Forest Bridge	bridgeName	Sherwood Forest Bridge
Park Bridge	bridgeName	Park Bridge
Hegigio Gorge Pipeline Bridge	bridgeName	Hegigio Gorge Pipeline Bridge
Beipan River Guanxing Highway Bridge	bridgeName	Beipan River Guanxing Highway Bridge
Beipan River Hukun Expressway Bridge	bridgeName	Beipanjiang River 2009 Bridge
Liuguanghe Bridge	bridgeName	Liuguanghe Bridge
Beipan River Shuibai Railway Bridge	bridgeName	Beipan River Shuibai Railway Bridge
Zhijing River Bridge	bridgeName	Zhijing River Bridge
Third Millennium John Paul II Bridge	bridgeName	Third Millennium John Paul II Bridge
West Brownsville Junction Bridge	bridgeName	West Brownsville Junction Bridge
Lane Bane Bridge	bridgeName	Lane Bane Bridge
Brownsville Bridge	bridgeName	Brownsville Bridge
Elm Street Stone Arch Bridge	bridgeName	Elm Street Stone Arch Bridge
Highland Park Bridge	bridgeName	Highland Park Bridge
John Paul II Bridge, Puławy	bridgeName	John Paul II Bridge
Attaran Bridge	bridgeName	Attaran Bridge
Sino-Nepal Friendship Bridge	bridgeName	Friendship Bridge
Brighouse Bridge	bridgeName	Brighouse Bridge
Rastrick Bridge	bridgeName	Rastrick Bridge
Blakeborough's Bridge	bridgeName	Blakeborough's Bridge
Currin Bridge	bridgeName	Currin Bridge
Foxburg Bridge	bridgeName	Foxburg Bridge
Ledgard Bridge	bridgeName	Ledgard Bridge
Reynolds Bridge	bridgeName	Reynolds Bridge
Ponte da Varela	bridgeName	Ponte da Varela
Ponte Velha do Vouga	bridgeName	Ponte Velha do Vouga
Ponte de Porto Cavalos	bridgeName	Ponte de Cavalos
Ponte de Coronados	bridgeName	Ponte de Coronados
Ponte do Castelo do Mau Vizinho	bridgeName	Ponte do Castelo
Ponte Velha de Padastros	bridgeName	Ponte Velha
Ponte da Palhaça	bridgeName	Palhaça Bridges
Ponte da Fontinha	bridgeName	Bridge of Fontinha
Ponte Pedonal Circular	bridgeName	Ponte Pedonal Circular
Ponte do Bico	bridgeName	Ponte do Bico
Ponte Romana do Rio Brenhas	bridgeName	Roman bridge of Rio Brenhas
Ponte da Ribeira de Cobres	bridgeName	Ribeira de Cobres Bridge
Ponte de Barcelos	bridgeName	Ponte de Barcelos
Ponte D. Maria	bridgeName	D. Maria Bridge
Ponte da Mizarela	bridgeName	Ponte da Mizarela
Ponte do Arco de Baúlhe	bridgeName	Ponte do Arco de Baúlhe
Ponte de Cavez do Rio Tâmega	bridgeName	Ponte de Cavez
Ponte de Mértola	bridgeName	Old Bridge of Mértola
Ponte de Gimonde	bridgeName	Ponte de Gimonde
Ponte de Serves	bridgeName	Ponte de Serves
Ponte do Rio Ave	bridgeName	Ponte do Rio Ave
Ponte de Lagoncinha	bridgeName	Ponte de Lagoncinha
Ponte de Frieira	bridgeName	Ponte de Frieira
Ponte de Prozelo	bridgeName	Bridge of Prozelo
Ponte Romana	bridgeName	Ponte Romana
Ponte Ferroviária do Pocinho	bridgeName	Ponte Ferroviária do Pocinho
Ponte de Portas de Ródão	bridgeName	Ponte de Portas de Ródão
Ponte de Segura	bridgeName	Ponte de Segura
Ponte de Ázere	bridgeName	Ponte de Ázere
Ponte do Paul	bridgeName	Paul Bridge
Ponte de Vilela	bridgeName	Ponte de Vilela
Ponte de Vilar de Mouros	bridgeName	Ponte de Vilar de Mouros
Ponte de Varziela	bridgeName	Ponte de Varziela
Ponte Almirante Sarmento Rodrigues	bridgeName	Ponte Almirante Sarmento Rodrigues
Ponte de Mem Gutierres	bridgeName	Ponte de Mem Gutierres
Ponte de Assureira	bridgeName	Ponte de Assureira
Ponte de Dorna	bridgeName	Ponte de Dorna
Ponte metálica de Fão	bridgeName	Fão Bridge, Bridge at Fão
Ponte do Arquinho	bridgeName	Ponte do Arquinho
Ponte do Rio Vade	bridgeName	Ponte do Rio Vade
Ponte Eiffel	bridgeName	Ponte Eiffel
Ponte da Ribeira de Meimoa	bridgeName	Ribeira de Meimoa Bridge
Ponte da Barbeita	bridgeName	Bridge of Barbeita
Ponte Velha de São Pedro da Tore	bridgeName	Old Bridge of São Pedro da Tore
Ponte Nova da Cava da Velha	bridgeName	Ponte Nova da Cava da Velha
Ponte das Caínheiras	bridgeName	Bridge of Caínheiras
Ponte Antiga de Santo Adrião	bridgeName	Old Bridge of Santo Adrião
Shaeffer Campbell Covered Bridge	bridgeName	Shaeffer Campbell Covered Bridge
Saraçhane Bridge	bridgeName	Saraçhane Bridge
Culham Bridge	bridgeName	Culham Bridge
Mill Street Stone Arch Bridge	bridgeName	Mill Street Stone Arch Bridge
Lipcani-Rădăuți Bridge	bridgeName	Lipcani-Rădăuți
Landing Masonry Bridge	bridgeName	Landing Masonry Bridge
Lowell Bridge	bridgeName	Lowell Covered Bridge
Deh Cho Bridge	bridgeName	Deh Cho Bridge
Dragon Bridge	bridgeName	Dragon Bridge
Jules Wijdenbosch Bridge	bridgeName	Jules Wijdenbosch Bridge
Coppename Bridge	bridgeName	Coppename Bridge
Oyapock River Bridge	bridgeName	Oyapock River Bridge
Basarab Overpass	bridgeName	Basarab Overpass
Michaelson Road Bridge	bridgeName	Michaelson Road Bridge
Holzbrücke Rapperswil-Hurden	bridgeName	Holzbrücke Rapperswil-Hurden
Nutty Narrows Bridge	bridgeName	Nutty Narrows Bridge
Dickabram Bridge	bridgeName	Dickabram Bridge
Myllysilta	bridgeName	Myllysilta
Myllysilta	bridgeName	Myllysilta 1975–2010
Forgan Bridge	bridgeName	Forgan Bridge
Edmund Pettus Bridge	bridgeName	Edmund Pettus Bridge
Denison Bridge	bridgeName	Denison Bridge
Bridge of Flowers	bridgeName	Bridge of Flowers
Wissahickon Memorial Bridge	bridgeName	Wissahickon Memorial Bridge
Unity Bridge 2	bridgeName	Unity Bridge 2
Urangan Pier	bridgeName	Urangan Pier
Windward Viaducts	bridgeName	Windward Viaducts
Lamington Bridge	bridgeName	Lamington Bridge
Burt County Missouri River Bridge	bridgeName	Burt County Missouri River Bridge
Pont de Brotonne	bridgeName	Brotonne Bridge
Old Godavari Bridge	bridgeName	Old Godavari Bridge
Godavari Arch Bridge	bridgeName	Godavari Arch Bridge
Tianxingzhou Yangtze River Bridge	bridgeName	Tianxingzhou Bridge
Tavy Bridge	bridgeName	Tavy Bridge
Roydhouse Bridge	bridgeName	Roydhouse Bridge
Chaotianmen Bridge	bridgeName	Chaotianmen Bridge
Cane Hill Road Bridge	bridgeName	Cane Hill Road Bridge
Nijmegen railway bridge	bridgeName	Nijmegen Railway Bridge
Sault Ste. Marie Bridge Company	bridgeName	Sault Ste. Marie International Railroad Bridge
Manayunk Bridge	bridgeName	Manayunk Bridge
Mary Avenue Bridge	bridgeName	Mary Avenue Bridge
Cadishead Viaduct	bridgeName	Cadishead Viaduct
Pecos River High Bridge	bridgeName	Pecos River High Bridge
Upper Bay Bridge	bridgeName	Upper Bay Bridge
Stillwater Bridge	bridgeName	Stillwater Bridge
Coral Springs Covered Bridge	bridgeName	Coral Springs Covered Bridge
Girard Avenue Bridge	bridgeName	Girard Avenue Bridge
Pennsylvania Railroad, Connecting Railway Bridge	bridgeName	Pennsylvania Railroad, Connecting Railway Bridge
Harrison Avenue Bridge	bridgeName	Harrison Avenue Bridge
Spider Bridge at Falls of Schuylkill	bridgeName	Spider Bridge at Falls of Schuylkill
Yi Sun-sin Bridge	bridgeName	Yi Sun-sin Bridge
Namdang Stone Bridge	bridgeName	Namdang Stone Bridge
Philadelphia and Reading Railroad, Schuylkill River Viaduct	bridgeName	Reading Railroad Bridge over Schuylkill River
Twin Bridges	bridgeName	Twin Bridges
Jiangyin Yangtze River Bridge	bridgeName	Jiangyin Bridge
José Leon de Carranza Bridge	bridgeName	Jose Leon de Carranza Bridge
Chain Bridge at Falls of Schuylkill	bridgeName	Chain Bridge at Falls of Schuylkill
Band-e Kaisar	bridgeName	Band-e Kaisar
Eiffel Bridge, Ungheni	bridgeName	Eiffel Bridge
Hochmoselbrücke	bridgeName	Hochmoselbrücke
Patapat Viaduct	bridgeName	Patapat Viaduct Esta
Philadelphia and Reading Railroad, Bridge at West Falls	bridgeName	Philadelphia and Reading Railroad, Bridge at West Falls
Candaba Viaduct	bridgeName	Candaba Viaduct
Red Bridge, Yerevan	bridgeName	Red Bridge
Diefenbaker Bridge	bridgeName	Diefenbaker Bridge
Malviya Bridge	bridgeName	Malviya Bridge
Burr's Ferry Bridge	bridgeName	Burr's Ferry Bridge
Bridge of Don	bridgeName	Bridge of Don
Pit River Bridge	bridgeName	Pit River Bridge
Yangluo Yangtze River Bridge	bridgeName	Yangluo Bridge
John O'Connell Bridge	bridgeName	John O'Connell Bridge
Viaduct Považská Bystrica	bridgeName	Estakáda Považská Bystrica
Kalemouth Suspension Bridge	bridgeName	Kalemouth Suspension Bridge
White Bridge	bridgeName	White Bridge
Lebaan Bridge	bridgeName	Lebaan Bridge
Grand Rapids Swing Bridge	bridgeName	Grand Rapids Swing Bridge
Black Boys Bridge	bridgeName	Black Boys Bridge
IHNC Lake Borgne Surge Barrier	bridgeName	Inner Harbor Navigation Canal Lake Borgne Surge Barrier
Demirköprü	bridgeName	Demirköprü
Assawoman Bay Bridge	bridgeName	Assawoman Bay Bridge
Harry W. Kelley Memorial Bridge	bridgeName	Harry W. Kelley Memorial Bridge
Veterans Memorial Bridge	bridgeName	Veterans Memorial Bridge
St. Louis-San Francisco Overpass	bridgeName	Imboden Bridge
Peats Ferry Bridge	bridgeName	Peats Ferry Bridge
Maslenica Bridge	bridgeName	Maslenica Bridge
Langwieser Viaduct	bridgeName	Langwieser Viaduct
Gründjitobel Viaduct	bridgeName	Gründjitobel Viaduct
Randøy Bridge	bridgeName	Randøy Bridge
Snowden Bridge	bridgeName	Snowden Bridge
La Pepa Bridge	bridgeName	Constitution of 1812 Bridge
Maslenica Bridge	bridgeName	Maslenica Bridge
Bloomfield Bridge	bridgeName	Bloomfield Bridge
Tomlinson Lift Bridge	bridgeName	Tomlinson Lift Bridge
Solis Viaduct	bridgeName	Solis Viaduct
Wiesen Viaduct	bridgeName	Wiesen Viaduct
Schmittentobel Viaduct	bridgeName	Schmittentobel Viaduct
Brusio spiral viaduct	bridgeName	Brusio spiral viaduct
Crook Point Bascule Bridge	bridgeName	Crook Point Bascule Bridge
Columbia Railroad Bridge	bridgeName	Columbia Railroad Bridge
Dyssebroen	bridgeName	Dyssebroen
Charleroi-Monessen Bridge	bridgeName	John K. Tener Memorial Bridge
Castielertobel Viaduct	bridgeName	Castielertobel Viaduct
Lyon Street Bridge	bridgeName	Lyon Street Bridge
Maha Chesadabodindranusorn Bridge	bridgeName	Maha Chesadabodindranusorn Bridge
E. L. Patton Yukon River Bridge	bridgeName	E. L. Patton Yukon River Bridge
Jones Bridge	bridgeName	Jones Bridge
Pont Briwet	bridgeName	Pont Briwet
Outlook Bridge	bridgeName	Outlook Bridge
B&O Railroad Bridge	bridgeName	B&O Railroad Bridge
John S. Thompsonbrug	bridgeName	John S. Thompson Bridge
Bukit Merah Lake Railway Bridge	bridgeName	Bukit Merah Lake Railway Bridge
Padma Bridge	bridgeName	Padma Multipurpose Bridge
Spadina Crescent Bridge	bridgeName	Spadina Crescent Bridge
Mulwala Bridge	bridgeName	Mulwala Bridge
Jubilee Bridge	bridgeName	Jubilee Bridge
Surtees Bridge	bridgeName	Surtees Bridge
Mes Bridge	bridgeName	Mes Bridge
Struve Railroad Bridge	bridgeName	Struve Railroad Bridge
Struve Railroad Bridge	bridgeName	(Железнодорожный мост Струве)
Victoria Bridge	bridgeName	Victoria Jubilee Bridge
Rendsburg High Bridge	bridgeName	Rendsburg High Bridge
Pont De Rennes bridge	bridgeName	Pont De Rennes Bridge
Gulf Intracoastal Waterway West Closure Complex	bridgeName	Gulf Intracoastal Waterway West Closure Complex
Pequonnock River Railroad Bridge	bridgeName	Pequonnock River Railroad Bridge
Mohaka Viaduct	bridgeName	Mohaka viaduct
Schuylkill Arsenal Railroad Bridge	bridgeName	Schuylkill Arsenal Railroad Bridge
La Salle Street Bridge	bridgeName	La Salle Street Bridge
Gdański Bridge	bridgeName	Gdański Bridge
Gediminas Bridge	bridgeName	Gediminas Bridge
Devon Bridge	bridgeName	Devon Bridge
Browns Bridge	bridgeName	Browns Bridge
General William C. Westmoreland Bridge	bridgeName	Westmoreland Bridge
President Bridge	bridgeName	President Bridge
Tukey's Bridge	bridgeName	Tukey's Bridge
Stoney Creek Bridge	bridgeName	Stoney Creek Bridge
Vine Street Expressway Bridge	bridgeName	Vine Street Expressway Bridge
John F. Kennedy Boulevard Bridge	bridgeName	John F. Kennedy Boulevard Bridge
Durra Border Crossing	bridgeName	Durra Border Crossing
Ždrelac Bridge	bridgeName	Ždrelac Bridge
Cisco Bridges	bridgeName	CNR Cisco Bridge
Cisco Bridges	bridgeName	CPR Cisco Bridge
Albion River Bridge	bridgeName	Albion River Bridge
Franjo Tuđman Bridge	bridgeName	Franjo Tuđman Bridge
West River Drive Bridge	bridgeName	West River Drive Bridge
Eleutherna Bridge	bridgeName	Eleutherna Bridge
Susegana Bridge	bridgeName	Susegana Bridge
Krka Bridge	bridgeName	Krka Bridge
Gacka Bridge	bridgeName	Gacka Bridge
Bar Aqueduct	bridgeName	Bar Aqueduct
Schuylkill Expressway Bridge	bridgeName	Schuylkill Expressway Bridge
Lytton CNR Thompson Bridge	bridgeName	Lytton CNR Fraser Bridge
Lytton CNR Fraser Bridge	bridgeName	Lytton CNR Fraser Bridge
Jiefang Bridge	bridgeName	Jiefang Bridge
Huanan Bridge	bridgeName	Huanan Bridge
Haizhu Bridge	bridgeName	Haizhu Bridge
Guangzhou Bridge	bridgeName	Guangzhou Bridge
Renmin Bridge	bridgeName	Renmin Bridge
Haiyin Bridge	bridgeName	Haiyin Bridge
Jiangwan Bridge	bridgeName	Jiangwan Bridge
Pazhou Bridge	bridgeName	Pazhou Bridge
Drežnik Viaduct	bridgeName	Drežnik Viaduct
Jezerane Viaduct	bridgeName	Jezerane Viaduct
Dabar Bridge	bridgeName	Dabar Bridge
Queensferry Crossing	bridgeName	Queensferry Crossing
Tanners' Bridge	bridgeName	Tanner's Bridge
Tanners' Bridge	bridgeName	Ura e Tabakëve
Raja Muda Nazrin Bridge	bridgeName	Tasik Raban Bridge
Einasleigh River Bridge	bridgeName	Einasleigh River Bridge
Little Crystal Creek Bridge	bridgeName	Little Crystal Creek Bridge
Seabrook Floodgate	bridgeName	Seabrook Floodgate
Te Rewa Rewa Bridge	bridgeName	Te Rewa Rewa Bridge
Srijane Viaduct	bridgeName	Srijane Viaduct
Dobra Bridge	bridgeName	Dobra Bridge
Rašćane Viaduct	bridgeName	Rašćane Viaduct
Šare Viaduct	bridgeName	Šare Viaduct
Pukete Bridge	bridgeName	Pukete Bridge
Integration Bridge	bridgeName	International Bridge of Integration
Moskovskyi Bridge	bridgeName	Moskovskyi Bridge
Kömürhan Bridge	bridgeName	Kömürhan Bridge
Kiev Metro Bridge	bridgeName	Metro Bridge
Victoria Bridge, Hamilton	bridgeName	Victoria Bridge
Pivdennyi Bridge	bridgeName	Pivdennyi Bridge
Pivdennyi Bridge	bridgeName	Kiev City Southern Bridge
Mirna Bridge	bridgeName	Mirna Bridge
Jesús Izcoa Moure Bridge	bridgeName	Jesús Izcoa Moure Bridge
Rhodes Footbridge	bridgeName	Rhodes Footbridge
O Street Viaduct	bridgeName	O Street Viaduct
Endeavour Bridge	bridgeName	Endeavour Bridge
Crawford Street Bridge	bridgeName	Crawford Street Bridge
Harbord Street Bridge	bridgeName	Harbord Street Bridge
Sava River Bridge	bridgeName	Sava Bridge
Granite City Crossing	bridgeName	Granite City Crossing
Most Ljubavi	bridgeName	Bridge of Love
Rača Bridge	bridgeName	Rača Bridge
Severinske Drage Viaduct	bridgeName	Severinske Drage Viaduct
Zečeve Drage Viaduct	bridgeName	Zečeve Drage Viaduct
Golubinjak Viaduct	bridgeName	Golubinjak Viaduct
Bajer Bridge	bridgeName	Bajer Bridge
Kamačnik Bridge	bridgeName	Kamačnik Bridge
Bãi Cháy Bridge	bridgeName	Bai Chay Bridge
Duisburg-Hochfeld Railway Bridge	bridgeName	Duisburg–Hochfeld railway bridge
West Liberty Covered Bridge	bridgeName	West Liberty Covered Bridge
Bính Bridge	bridgeName	Bính Bridge
Whipple Cast and Wrought Iron Bowstring Truss Bridge	bridgeName	Whipple Cast and Wrought Iron
Whipple Cast and Wrought Iron Bowstring Truss Bridge	bridgeName	Bowstring Truss Bridge
Benton City – Kiona Bridge	bridgeName	Benton City – Kiona Bridge
Powerscourt Covered Bridge	bridgeName	Percy Covered Bridge
Colonel Patrick O'Rorke Memorial Bridge	bridgeName	Colonel Patrick O'Rorke Memorial Bridge
New Jinja Bridge	bridgeName	New Jinja Bridge
Rio Negro Bridge	bridgeName	Manaus—Iranduba Bridge
Darebin Creek Bridge	bridgeName	Darebin Creek Bridge
Bulla Bridge	bridgeName	Bulla Bridge
PC&Y Railroad Bridge	bridgeName	PC&Y Railroad Bridge
Kineshma Bridge	bridgeName	Kineshma Bridge
Judge J. Frank Graff Bridge	bridgeName	Judge J. Frank Graff Bridge
Rochester-Beaver Railroad Bridge	bridgeName	Rochester-Beaver Railroad Bridge
Masontown Bridge	bridgeName	Masontown Bridge
Ford City Veterans Bridge	bridgeName	Ford City Veterans Bridge
Circle Drive South Bridge	bridgeName	Gordie Howe Bridge
New Geneva Bridge	bridgeName	New Geneva Bridge
Fairmont Railroad Bridge	bridgeName	Fairmont Railroad Bridge
Sergeant Carl F. Curran II Bridge	bridgeName	Sergeant Carl F. Curran II Bridge
Veterans Memorial Bridge	bridgeName	Veterans Memorial Bridge
Suleiman Bridge	bridgeName	Suleiman Bridge
Long Creek Bridge	bridgeName	Long Creek Bridge
Kennerdell Bridge	bridgeName	Kennerdell Bridge
Rosendale Trestle	bridgeName	Rosendale Trestle
Oil City Pennsylvania Railroad Bridge	bridgeName	Oil City Pennsylvania Railroad Bridge
San Antón Bridge	bridgeName	San Anton Bridge
Bras de la Plaine Bridge	bridgeName	Bras de la Plaine Bridge
Preston Pipe Bridge	bridgeName	Preston Pipe Bridge
Arenal Bridge	bridgeName	Arenal Bridge
Solidarity Bridge	bridgeName	Solidarity Bridge
Rhine Bridge, Kehl	bridgeName	The Rhine Bridge at Kehl
Cize–Bolozon viaduct	bridgeName	Cize–Bolozon viaduct
Legions of Marshal Józef Piłsudski Bridge	bridgeName	Legions of Marshal Józef Piłsudski Bridge
Airport Flyover, Brisbane	bridgeName	Airport Flyover
Green Bridge	bridgeName	Green Bridge
Fallston Bridge	bridgeName	Fallston Bridge
Smithton High-Level Bridge	bridgeName	Smithton High-Level Bridge
Boston Bridge	bridgeName	Boston Bridge
Memorial Bridge	bridgeName	Memorial Bridge
Blue Nile Road and Railway Bridge	bridgeName	Blue Nile Road and Railway Bridge
Malacca Strait Bridge	bridgeName	Malacca Strait Bridge
Emlenton Low Level Bridge	bridgeName	Emlenton Low Level Bridge
Eighth Street Bridge	bridgeName	Eighth Street Bridge
Petroleum Street Bridge	bridgeName	Petroleum Street Bridge
Veterans Memorial Bridge	bridgeName	Veterans Memorial Bridge
P&LE McKeesport Bridge	bridgeName	P&LE McKeesport Bridge
Bridge in Jefferson Borough	bridgeName	Cochran's Mill Road over Lick Run Bridge
Jerome Street Bridge	bridgeName	Jerome Street Bridge
Brickell Avenue Bridge	bridgeName	Brickell Avenue Bridge
Fifteenth Avenue Bridge	bridgeName	Fifteenth Avenue Bridge
Ampera Bridge	bridgeName	Ampera Bridge
P&LE Liberty Boro Bridge	bridgeName	P&LE Liberty Boro Bridge
Sutersville Bridge	bridgeName	Sutersville Bridge
West Newton Bridge	bridgeName	West Newton Bridge
Nagoya Port Drawbridge	bridgeName	Nagoya Port Drawbridge
Niantic River Bridge	bridgeName	Niantic River Railroad Bridge
Bugrinsky Bridge	bridgeName	Bugrinsky Bridge
Hunter Station Bridge	bridgeName	Hunter Station Bridge
Brooks Bridge	bridgeName	Brooks Bridge
Saint Alkmund's Way Footbridge	bridgeName	Saint Alkmunds Way Footbridge
Kama Bridge	bridgeName	Kama Bridge
Tionesta Bridge	bridgeName	Tionesta Bridge
West Hickory Bridge	bridgeName	West Hickory Bridge
Smithton Low-Level Bridge	bridgeName	Smithton Low-Level Bridge
Mill Bridge	bridgeName	Mill Bridge
Leechburg Bridge	bridgeName	Leechburg Bridge
Hartelkering	bridgeName	Hartelkering
Jiaozhou Bay Bridge	bridgeName	Jiaozhou Bay Bridge
Freeport Rail Bridge	bridgeName	Freeport Rail Bridge
New Harmony Toll Bridge	bridgeName	New Harmony Toll Bridge
Hubners Bridge	bridgeName	Hubners Bridge
Desmond Trannore Bridge	bridgeName	Desmond Trannore Bridge
Jungfern Bridge	bridgeName	Jungfern Bridge
Memorial Bridge	bridgeName	Memorial Bridge
Göta älvbron	bridgeName	Götaälvbron
Third Nanjing Yangtze Bridge	bridgeName	Third Nanjing Yangtze Bridge
Krossnessundet Bridge	bridgeName	Krossnessundet Bridge
Onehunga Harbour Road Bridge	bridgeName	Onehunga Harbour Road Bridge
Petrofka Bridge	bridgeName	Petrofka Bridge
Martin Bridge	bridgeName	Martin Bridge
Berbice Bridge	bridgeName	Berbice Bridge
Worli-Haji Ali Sea Link	bridgeName	Worli-Haji Ali Sea Link
Worli-Haji Ali Sea Link	bridgeName	वरळी हाजी अली सागरी सेतू
Andrew Nixon Bridge	bridgeName	Andrew Nixon Bridge
Vidyasagar Setu	bridgeName	Vidyasagar Setu
Vidyasagar Setu	bridgeName	বিদ্যাসাগর সেতু
Go Between Bridge	bridgeName	Go Between Bridge
Rory O'More Bridge	bridgeName	Rory O'More Bridge
High Road Bridge	bridgeName	High Road Bridge
Macleay River Bridge	bridgeName	Macleay Valley Bridge
Isis River Bridge	bridgeName	Isis River Bridge
Ozimek Suspension Bridge	bridgeName	Ozimek Suspension Bridge
Reiman Bridge	bridgeName	Reiman Bridge
Juneau–Douglas Bridge	bridgeName	Douglas Bridge
Granville Bridge, Maryborough	bridgeName	Granville Bridge
Illinois Central Missouri River Bridge	bridgeName	Illinois Central Missouri River Bridge
Ponte Buriano	bridgeName	Ponte Buriano
Charlie Earp Bridge	bridgeName	Charlie Earp Bridge
Göltzsch Viaduct	bridgeName	Göltzsch Viaduct
Hagwilget Canyon Bridge	bridgeName	Hagwilget Canyon Bridge
Christine Falls Bridge	bridgeName	Christine Falls Bridge
Tokyo Gate Bridge	bridgeName	Tokyo Gate Bridge
Goteik viaduct	bridgeName	Goteik viaduct
Goteik viaduct	bridgeName	ဂုတ်ထိပ်တံတား
Mahakam Bridge	bridgeName	Mahakam Bridge
Bowker Overpass	bridgeName	Philip G. Bowker Overpass
Grand Junction Railroad Bridge	bridgeName	Grand Junction Railroad Bridge
Don River Bridge, Rannes	bridgeName	Don River Bridge
Don River Bridge, Bowen	bridgeName	Don River Bridge
Persian Gulf Bridge	bridgeName	Persian Gulf Bridge
William Walter Mason Bridge	bridgeName	William Walter Mason Bridge
Mungindi Bridge	bridgeName	Mungindi Bridge
Cowen Park Bridge	bridgeName	Cowen Park Bridge
20th Avenue NE Bridge	bridgeName	20
Chamberlain Bridge	bridgeName	Chamberlain Bridge
Schmitz Park Bridge	bridgeName	Schmitz Park Bridge
Sam White Bridge	bridgeName	Sam White Bridge
Cathedral Bridge	bridgeName	Cathedral Bridge
Yiling Yangtze River Bridge	bridgeName	Yiling Yangtze River Bridge
North Queen Anne Drive Bridge	bridgeName	North Queen Anne Drive Bridge
Seohae Bridge	bridgeName	Seohae Bridge
Tsurumi Tsubasa Bridge	bridgeName	Tsurumi Tsubasa Bridge
Naranarayan Setu	bridgeName	Naranarayan Setu
Iskandar Coastal Bridge	bridgeName	Iskandar Coastal Bridge
Jacobs Ladder Bridge	bridgeName	Jacobs Ladder Bridge
Bow Bridge	bridgeName	Bow Bridge
Manchester Bridge	bridgeName	Manchester Bridge
Wilton Bridge	bridgeName	Wilton Bridge
Outer Drive Bridge	bridgeName	Outer Drive Bridge
Maryland Bridge	bridgeName	Maryland Bridge
The Bridge of Peace	bridgeName	Bridge of Peace
The Bridge of Peace	bridgeName	მშვიდობის ხიდი
High Bridge, Reading	bridgeName	High Bridge
Dronning Louises Bro	bridgeName	Dronning louises Bro
Holmes Creek Covered Bridge	bridgeName	Holmes Creek Covered Bridge
Quinlan's Covered Bridge	bridgeName	Quinlan's Covered Bridge
Spade Farm Covered Bridge	bridgeName	Spade Farm Covered Bridge
Pulp Mill Covered Bridge	bridgeName	Pulp Mill Covered Bridge
Halpin Covered Bridge	bridgeName	Halpin Covered Bridge
Three Countries Bridge	bridgeName	Three Countries Bridge
Gifford Covered Bridge	bridgeName	Gifford Covered Bridge
Kingsbury Covered Bridge	bridgeName	Kingsbury Covered Bridge
Braley Covered Bridge	bridgeName	Braley Covered Bridge
Scarborough Bridge	bridgeName	Scarborough Bridge
Baratashvili Bridge	bridgeName	Baratshvili Bridge
Baratashvili Bridge	bridgeName	ბარათაშვილის ხიდი
Ananuri Bridge	bridgeName	Ananuri Bridge
Ananuri Bridge	bridgeName	ანანურის ხიდი
Tianjin Grand Bridge	bridgeName	Tianjin Grand Bridge
Puente de España	bridgeName	Puente de España
Kinbuck Bridge	bridgeName	Kinbuck Bridge
Hawk Street Viaduct	bridgeName	Hawk Street Bridge
Stony Brook Covered Bridge	bridgeName	Stony Brook Covered Bridge
Northfield Falls Covered Bridge	bridgeName	Northfield Falls Covered Bridge
Slaughter House Covered Bridge	bridgeName	Slaughter House Covered Bridge
Lower Cox Brook Covered Bridge	bridgeName	Lower Cox Brook Covered Bridge
Upper Cox Brook Covered Bridge	bridgeName	Upper Cox Brook Covered Bridge
Pine Brook Covered Bridge	bridgeName	Pine Brook Covered Bridge
Great Eddy Covered Bridge	bridgeName	Great Eddy Covered Bridge
Warren Covered Bridge	bridgeName	Warren Covered Bridge
Robbins Nest Covered Bridge	bridgeName	Robbins Nest Covered Bridge
Jewfish Creek Bridge	bridgeName	Jewfish Creek Bridge
Kharkiv Metro Bridge	bridgeName	Metro Bridge
Nicosia aqueduct	bridgeName	Nicosia aqueduct
Berkley–Dighton Bridge	bridgeName	Berkley-Dighton Bridge
Cache River Bridge	bridgeName	Cache River Bridge
Old Rhine Bridge	bridgeName	Old Rhine Bridge at Konstanz
Moltke Bridge	bridgeName	Moltke Bridge
Nehru Setu	bridgeName	NEHRU SETU
Teston Bridge	bridgeName	Teston Bridge
Sequin Covered Bridge	bridgeName	Sequin Covered Bridge
Comstock Covered Bridge	bridgeName	Comstock Covered Bridge
Hopkins Covered Bridge	bridgeName	Hopkins Covered Bridge
Koshiji Bridge	bridgeName	Koshiji Bridge
Jawahar Setu	bridgeName	Jawahar Setu
Rajendra Setu	bridgeName	Rajendra Setu
Second Mahanadi Rail Bridge	bridgeName	Second Mahanadi Rail Bridge
Digha–Sonpur bridge	bridgeName	Digha–Sonpur rail–road bridge
West Hill Covered Bridge	bridgeName	West Hill Covered Bridge
Longley Covered Bridge	bridgeName	Longley Covered Bridge
Munger Ganga Bridge	bridgeName	Munger Ganga Bridge
Morgan Covered Bridge	bridgeName	Morgan Covered Bridge
Mill Covered Bridge	bridgeName	Mill Covered Bridge
Montgomery Covered Bridge	bridgeName	Montgomery Covered Bridge
Danyang–Kunshan Grand Bridge	bridgeName	Danyang–Kunshan Grand Bridge
Beijing Grand Bridge	bridgeName	Beijing Grand Bridge
Muskoday Bridge	bridgeName	Muskoday Bridge
Long-Sault Bridge	bridgeName	Long-Sault Bridge
Oregon Slough Railroad Bridge	bridgeName	Oregon Slough Railroad Bridge
Minpu Bridge	bridgeName	Minpu Bridge
Minpu Bridge	bridgeName	闵浦大桥
Maungatapu Bridge	bridgeName	Maungatapu Bridge
Donna–Río Bravo International Bridge	bridgeName	Donna - Río Bravo International Bridge
Jingyue Yangtze River Bridge	bridgeName	Jingyue Bridge
Xupu Bridge	bridgeName	Xupu Bridge
Limpapeh Bridge	bridgeName	Limpapeh Bridge
Ducharme Bridge	bridgeName	Ducharme Bridge
Lake Champlain Bridge	bridgeName	Lake Champlain Bridge
Higashi Kobe Bridge	bridgeName	Higashi Kobe Bridge
Higashi Kobe Bridge	bridgeName	東神戸大橋
Martholme Viaduct	bridgeName	Martholme Viaduct
Terenez bridge	bridgeName	Terenez bridge
Kinniya Bridge	bridgeName	Kinniya Bridge
Altenbeken Viaduct	bridgeName	Altenbeken Viaduct
Manampitiya Bridge	bridgeName	Manampitiya Bridge
Zrinski Bridge	bridgeName	Zrinski Bridge / Zrinyi Bridge
Kotezi Viaduct	bridgeName	Kotezi Viaduct
Irakkandi Bridge	bridgeName	Irakkandi Bridge
Sangupiddy Bridge	bridgeName	Sangupiddy Bridge
Rock O' the Range Bridge	bridgeName	Rock O' the Range Bridge
Senator George Sellar Bridge	bridgeName	Senator George Sellar Bridge
Columbia River Bridge	bridgeName	Columbia River Bridge
Pont de Wandre	bridgeName	Pont de Wandre
Hawthorn Railway Bridge	bridgeName	Hawthorn Railway Bridge
Munkholm Bridge	bridgeName	Storstrøm Bridge
Rędziński Bridge	bridgeName	Rędziński Bridge
Liberty Bridge, Zagreb	bridgeName	Liberty Bridge
Jubilee Bridge	bridgeName	Jubilee Bridge
Trent Viaducts	bridgeName	Trent Viaducts
Hengoed Viaduct	bridgeName	Hengoed Viaduct
Smaalenene Bridge	bridgeName	Smaalenene Bridge
Smaalenene Bridge	bridgeName	Smålenene Bru
Hollandse Brug	bridgeName	Hollandse Brug
Santa Cruz Bridge	bridgeName	Santa Cruz Bridge
Sheely Bridge	bridgeName	Sheely Bridge
Quezon Bridge	bridgeName	Quezon Bridge
Peace Bridge	bridgeName	Peace Bridge
Wilks Creek Bridge	bridgeName	Wilks Creek Bridge
Verugal Bridge	bridgeName	Verugal Bridge
Upparu Bridge	bridgeName	Upparu Bridge
Ralkuli Bridge	bridgeName	Ralkuli Bridge
Kayankerni Bridge	bridgeName	Kayankerni Bridge
Gangai Bridge	bridgeName	Gangai Bridge
Arippu Bridge	bridgeName	Arippu Bridge
Fernbridge	bridgeName	Fernbridge
Whitby Swing Bridge	bridgeName	Whitby Swing Bridge
New Tappan Zee Bridge	bridgeName	New Tappan Zee Bridge
Trinity Bridge, Greater Manchester	bridgeName	Trinity Bridge
Malo-Kalinkin Bridge	bridgeName	Malo-Kalinkin Bridge
Malo-Kalinkin Bridge	bridgeName	Мало-Калинкин мост
Hoddle Bridge	bridgeName	Hoddle Bridge
Victoria Bridge, Melbourne	bridgeName	Victoria Bridge
San Mateo–Hayward Bridge	bridgeName	San Mateo–Hayward Bridge
Media City Footbridge	bridgeName	Media City Footbridge
Karameh Border Crossing	bridgeName	Karameh Border Crossing
Victoria Bridge, Bath	bridgeName	Victoria Bridge
Cremorne Railway Bridge	bridgeName	Cremorne Railway Bridge
PATH Lift Bridge	bridgeName	PATH Lift Bridge
Sewells Road Bridge	bridgeName	Sewells Road Bridge
Woronora River Bridge	bridgeName	Woronora River Bridge
Kutai Kartanegara Bridge	bridgeName	Kutai Kartanegara Bridge
16th Avenue Bailey Bridge	bridgeName	16
Corporation Street Bridge	bridgeName	Corporation Street Bridge
Skerton Bridge	bridgeName	Skerton Bridge
Point Bridge	bridgeName	Point Bridge
Donora-Monessen Bridge	bridgeName	Donora-Monessen Bridge
Kerem Shalom border crossing	bridgeName	Kerem Shalom crossing
Conestoga Creek Viaduct	bridgeName	Conestoga Creek Viaduct
West Montrose Covered Bridge	bridgeName	West Montrose Covered Bridge
Varda Viaduct	bridgeName	Varda Viaduct
New Darnytskyi Bridge	bridgeName	New Darnytskyi Bridge
Ponte de São João	bridgeName	Ponte de São João
Handyside Bridge	bridgeName	Handyside Bridge - Derby
Walnut Tree Viaduct	bridgeName	Walnut Tree Viaduct
Lake Shore Drive Bridge	bridgeName	Lake Shore Drive Bridge
Wye Bridge, Monmouth	bridgeName	Wye Bridge
Eagle River Timber Bridge	bridgeName	Eagle River Timber Bridge
Scammonden Bridge	bridgeName	Scammonden Bridge
Reedham Swing Bridge	bridgeName	Reedham Swing Bridge
Puente de la Barqueta	bridgeName	Puente de la Barqueta
Prince Alfred Bridge	bridgeName	Prince Alfred Bridge
Monmouth Viaduct	bridgeName	Monmouth Viaduct
Dearborn River High Bridge	bridgeName	Dearborn River High Bridge
Podilsko-Voskresensky Bridge	bridgeName	Podilsko-Voskresensky Bridge
Cherry Street lift bridge	bridgeName	Cherry Street lift bridge
Westgate Pedestrian and Cycle Bridge	bridgeName	Westgate Pedestrian and Cycle Bridge
Hradecky Bridge	bridgeName	Hradecky Bridge, Mortuary Bridge
East Farleigh Bridge	bridgeName	East Farleigh Bridge
Stone Bridge	bridgeName	Regensburg Stone Bridge
Corby Bridge	bridgeName	Corby Bridge
Ringsend Bridge	bridgeName	Ringsend Bridge
London Bridge	bridgeName	London Bridge
Bathampton Toll Bridge	bridgeName	Bathampton Toll Bridge
Chiniot Bridge	bridgeName	Chiniot Bridge
Chund Bridge	bridgeName	Chund Bridge
Old Wye Bridge, Chepstow	bridgeName	Old Wye Bridge, Chepstow
New Bridge	bridgeName	New Bridge
Edong Yangtze River Bridge	bridgeName	Edong Bridge
Clonskeagh Bridge	bridgeName	Clonskeagh Bridge
Milltown Bridge	bridgeName	Milltown Bridge
Classon's Bridge	bridgeName	Classon's Bridge
Fifth Street Viaduct	bridgeName	Fifth Street Viaduct
Nine Arches Bridge	bridgeName	The Nine Arches Bridge
Glendale-Hyperion Bridge	bridgeName	Glendale-Hyperion Bridge
Fort Steuben Bridge	bridgeName	Fort Steuben Bridge
Victoria Bridge, Manchester	bridgeName	Victoria Bridge
Blackfriars Bridge, Manchester	bridgeName	Blackfriars Bridge
Albert Bridge, Manchester	bridgeName	Albert Bridge
Atatürk Bridge	bridgeName	Atatürk Bridge
Wulingshan Bridge	bridgeName	Wulingshan Bridge
Fabyan Trestle Bridge	bridgeName	Fabyan Trestle Bridge
Dimuhe River Bridge	bridgeName	Dimuhe River Bridge
Puli Bridge	bridgeName	Puli Bridge
Haliç Bridge	bridgeName	Haliç Bridge
Liuchong River Bridge	bridgeName	Liuchong River Bridge
Palatine Bridge, Salford	bridgeName	Palatine Bridge
Italia Viaduct	bridgeName	Italia Viaduct
Kota Chambal Bridge	bridgeName	Kota Bridge
Jiangjiehe Bridge	bridgeName	Jiangjiehe Bridge
Narayani Bridge	bridgeName	Narayani Bridge
Port à l'Anglais Bridge	bridgeName	Port à l'Anglais Bridge
NX Bridge	bridgeName	NX Bridge
Sfalassà Viaduct	bridgeName	Sfalassà Viaduct
Azhihe River Bridge	bridgeName	Azhihe River Bridge
WR Draw	bridgeName	WR Draw
Clawdd-du	bridgeName	Clawdd-du Bridge
Cala Galdana Bridge	bridgeName	Cala Galdana Stainless Steel Bridge
Seneca Rail Bridge	bridgeName	Seneca Rail Bridge
Morris Bridge	bridgeName	Morris Bridge
Marseilles Bridge	bridgeName	Marseilles Bridge
Veterans Memorial Bridge	bridgeName	Veterans Memorial Bridge
Ottawa Rail Bridge	bridgeName	Ottawa Rail Bridge
Utica Bridge	bridgeName	Utica Bridge
LaSalle Rail Bridge	bridgeName	LaSalle Rail Bridge
Shippingsport Bridge	bridgeName	Shippingsport Bridge
Teglværksbroen	bridgeName	Teglværksbroen
Lacon Bridge	bridgeName	Lacon Bridge
Ayub Bridge	bridgeName	Ayub Bridge
Peacock's Lock Viaduct	bridgeName	Peacock's Lock Viaduct
Maling River Shankun Expressway Bridge	bridgeName	Malinghe River Bridge
Furong River Bridge	bridgeName	Furong River Bridge
Lefty O'Doul Bridge	bridgeName	Lefty O'Doul Bridge
Assut de l'Or Bridge	bridgeName	Assut de l'Or Bridge
Xisha Bridge	bridgeName	Xisha Bridge
Fort Edmonton Footbridge	bridgeName	Fort Edmonton Footbridge
Zhuchanghe River Bridge	bridgeName	Zhuchanghe River Bridge
Atlantic Bridge, Panama	bridgeName	Third Bridge over Panama Canal
Indian River Inlet Bridge	bridgeName	Indian River Inlet Bridge
Jubilee Bridge	bridgeName	Jubilee Bridge
Putnam Bridge	bridgeName	Putnam Bridge
Abetxuko Bridge	bridgeName	Abetxuko Bridge
GFRP Lleida Pedestrian Bridge	bridgeName	FRP Lleida Pedestrian Bridge
Adomi Bridge	bridgeName	Adomi Bridge
Timber bridge	bridgeName	Truss bridge
Timber bridge	bridgeName	Beam bridge
River Cart Aqueduct	bridgeName	River Cart Aqueduct
Brecksville-Northfield High Level Bridge	bridgeName	Brecksville-Northfield High Level Bridge
Grand Narrows Bridge	bridgeName	Grand Narrows Bridge
Levensau High Bridge	bridgeName	Levensau High Bridge
Glaisnock Viaduct	bridgeName	Glaisnock Viaduct
Bybee Bridge	bridgeName	Bybee Bridge
Pawtucket River Bridge	bridgeName	Pawtucket River Bridge
Magapit Suspension Bridge	bridgeName	Magapit Suspension Bridge
Kallady Bridge	bridgeName	Kallady Bridge
Dorchester Bridge	bridgeName	Dorchester Bridge
Chelsea Street Bridge	bridgeName	Chelsea Street Bridge
Providence Viaduct	bridgeName	Providence Viaduct
Franjo Tuđman Bridge	bridgeName	Franjo Tuđman Bridge
Cao Lãnh Bridge	bridgeName	Cao Lãnh Bridge
McFarlane Bridge	bridgeName	McFarlane Bridge
Otowi Suspension Bridge	bridgeName	Otowi Suspension Bridge
Neubrügg	bridgeName	Neubrügg
Miljana Border Bridge	bridgeName	Miljana Border Bridge
PD Draw	bridgeName	PD Draw
Franjo Tuđman Bridge	bridgeName	Franjo Tuđman Bridge
Chamravattom Regulator-cum-Bridge	bridgeName	Chamravattom Regulator cum Bridge
Caledonian Railway Bridge	bridgeName	Caledonian Railway Bridge
Beaver River Bridge	bridgeName	Beaver River Bridge
Cameron Suspension Bridge	bridgeName	Cameron Suspension Bridge
Bab al-Hawa Border Crossing	bridgeName	Bab al-Hawa Border Crossing
Gervais Street Bridge	bridgeName	Gervais Street Bridge
Kylesku Bridge	bridgeName	Kylesku Bridge
Pedestrian bridge	bridgeName	Pedestrian bridge
Blažo Jovanović Bridge	bridgeName	Blažo Jovanović bridge
Rijeka Crnojevića bridge	bridgeName	Rijeka Crnojevića bridge
Rosie Hackett Bridge	bridgeName	Rosie Hackett Bridge
Barton Creek Bridge	bridgeName	Barton Creek Bridge
Newark Drawbridge	bridgeName	Newark Drawbridge
Mark Twain Memorial Bridge	bridgeName	Mark Twain Memorial Bridge
Jackson Street Bridge	bridgeName	Jackson Street Bridge
Clay Street Bridge	bridgeName	Clay Street Bridge
Florence Bridge	bridgeName	Florence Bridge
Point-No-Point Bridge	bridgeName	Point-No-Point Bridge
Hardin Bridge	bridgeName	Hardin Bridge
Loyn Bridge	bridgeName	Loyn Bridge
Beardstown Bridge	bridgeName	Beardstown Bridge
US 31–Island Lake Outlet Bridge	bridgeName	US 31–Island Lake Outlet Bridge
Blossomland Bridge	bridgeName	Blossomland Bridge
Lyndhurst Draw	bridgeName	Lyndhurst Draw
Avery Road–Galien River Bridge	bridgeName	Avery Road–Galien River Bridge
North Watervliet Road–Paw Paw Lake Outlet Bridge	bridgeName	North Watervliet Road–Paw Paw Lake Outlet Bridge
Second Street Bridge	bridgeName	Second Street Bridge
Trunk Line Bridge No. 237	bridgeName	Trunk Line Bridge No. 237
Chittenden Memorial Bridge	bridgeName	Chittenden Memorial Bridge
Phyllis J. Tilley Memorial Bridge	bridgeName	Phyllis J. Tilley Memorial Bridge
Cheboygan Bascule Bridge	bridgeName	Cheboygan Bascule Bridge
Avondale Bridge	bridgeName	Avondale Bridge
Pont de l'Iroise	bridgeName	Pont de l'Iroise
Lake Monroe Bridge	bridgeName	Lake Monroe Bridge
Fabiani Bridge	bridgeName	Fabiani Bridge
Labajin Bridge	bridgeName	Labajin Bridge
Stormbro	bridgeName	Stormbro
Højbro	bridgeName	Højbro
US 12–St. Joseph River Bridge	bridgeName	US 12–St. Joseph River Bridge
Astor Bridge	bridgeName	Astor Bridge
23 Mile Road–Kalamazoo River Bridge	bridgeName	23
12 Mile Road–Kalamazoo River Bridge	bridgeName	12
Peter DeFazio Bridge	bridgeName	Peter DeFazio Bridge
Anqing Yangtze River Bridge	bridgeName	Anqing Yangtze River Bridge
Tongling Yangtze River Bridge	bridgeName	Tongling Yangtze River Bridge
Taiping Lake Bridge	bridgeName	Taiping Lake Bridge
Redesdale Bridge	bridgeName	Redesdale Bridge
Yuzui Yangtze River Bridge	bridgeName	Yuzui Yangtze River Bridge
Francis P. Whitehair Bridge	bridgeName	Whitehair Bridge
Wushan Yangtze River Bridge	bridgeName	Wushan Yangtze River Bridge
Daning River Bridge	bridgeName	Daning River Bridge
Osteen Bridge	bridgeName	Osteen Bridge
Belleville Turnpike Bridge	bridgeName	Belleville Turnpike Bridge
Second Wanzhou Yangtze River Bridge	bridgeName	Second Wanzhou Bridge
Wanzhou Railway Bridge	bridgeName	Wanzhou Railway Bridge
Zhongxian Yangtze River Bridge	bridgeName	Zhongxian Yangtze River Bridge
Zhongzhou Yangtze River Bridge	bridgeName	Zhongzhou Yangtze River Bridge
Fengjie Yangtze River Bridge	bridgeName	Fengjie Yangtze  Bridge
Meixi River Bridge	bridgeName	Meixi River Bridge
Meixi River Expressway Bridge	bridgeName	Meixi River Expressway Bridge
Hanjiatuo Yangtze River Bridge	bridgeName	Hanjiatuo Yangtze River Bridge
Shiban'gou Yangtze River Bridge	bridgeName	Shiban'gou Yangtze River Bridge
Fuling Yangtze River Bridge	bridgeName	Fuling Yangtze River Bridge
Lidu Yangtze River Bridge	bridgeName	Lidu Bridge
Fuling Arch Bridge	bridgeName	Fuling Arch Bridge
Point Street Bridge	bridgeName	Point Street Bridge
Fuling Wujiang Bridge	bridgeName	Fuling Wujiang Bridge
Sheepwash Channel Railway Bridge	bridgeName	Sheepwash Channel Railway Bridge
Rewley Road Swing Bridge	bridgeName	Rewley Road Swing Bridge
Dicle Bridge	bridgeName	Dicle Bridge
Changshou Yangtze River Bridge	bridgeName	Changshou Yangtze River Bridge
Changshou Yangtze River Railway Bridge	bridgeName	Changshou Yangtze River Railway Bridge
US 31–Pentwater River Bridge	bridgeName	US 31–Pentwater River Bridge
Hackensack Drawbridge	bridgeName	Hackensack Drawbridge
Dafosi Bridge	bridgeName	Dafosi Bridge
New Yamuna Bridge	bridgeName	New Yamuna Bridge
Shibanpo Yangtze River Bridge	bridgeName	Shibanpo Yangtze River Bridge
Caiyuanba Bridge	bridgeName	Caiyuanba Bridge
Lijiatuo Yangtze River Bridge	bridgeName	Lijiatuo Yangtze River Bridge
Masangxi Bridge	bridgeName	Masangxi Bridge
Yudong Yangtze River Bridge	bridgeName	Yudong Bridge
Baishatuo Yangtze River Railway Bridge	bridgeName	Baishatuo Yangtze River Railway Bridge
Diwei Bridge	bridgeName	Diwei Bridge
Guanyinyan Bridge	bridgeName	Guanyinyan Bridge
Qingzhou Bridge	bridgeName	Qingzhou Bridge
Perlis-Langkawi Bridge	bridgeName	Perlis-Langkawi Bridge
Zhongshan Bridge	bridgeName	Zhongshan Bridge
Boca Grande Causeway	bridgeName	Boca Grande Causeway
Winant Avenue Bridge	bridgeName	Winant Avenue Bridge
Gaunless Bridge	bridgeName	Gaunless Bridge
Zhanjiang Bay Bridge	bridgeName	Zhanjiang Bay Bridge
Vignoles Bridge	bridgeName	Vignoles Bridge
Zolotoy Bridge	bridgeName	Zolotoy Bridge
Xinguang Bridge	bridgeName	Xinguang Bridge
Yajisha Bridge	bridgeName	Yajisha Bridge
Hedong Bridge	bridgeName	Hedong Bridge
Court Street Bridge	bridgeName	Court Street Bridge
Pingsheng Bridge	bridgeName	Pingsheng Bridge
Qi'ao Bridge	bridgeName	Qi'ao Bridge
Botley Bridge	bridgeName	Botley Bridge
Bulstake Bridge	bridgeName	Bulstake Bridge
Noordin Bridge	bridgeName	Sungai Perak Bridge
Malacca Coastal Bridge	bridgeName	Malacca Coastal Bridge
Dongpingshuidao Bridge	bridgeName	Dongpingshuidao Bridge
Vimy Memorial Bridge	bridgeName	Vimy Memorial Bridge
Chester New Bridge	bridgeName	Chester New Bridge
Holzbrücke Bad Säckingen	bridgeName	Holzbrücke Bad Säckingen
Jacob's Creek Bridge	bridgeName	Jacob's Creek Bridge
Bell Road Bridge	bridgeName	Bell Road Bridge
Delhi Bridge	bridgeName	Delhi Bridge
Portumna bridge	bridgeName	Portumna Bridge
Buntun Bridge	bridgeName	Buntun Bridge
Weaverland Bridge	bridgeName	Weaverland Bridge
Christina and John Markey Memorial Pedestrian Bridge	bridgeName	Christine and John Markey Memorial Pedestrian Bridge
Xixi Bridge	bridgeName	Xixi Bridge
Lincoln Highway Hackensack River Bridge	bridgeName	Lincoln Highway Bridge
Philadelphia, Wilmington and Baltimore Railroad Bridge No. 1	bridgeName	Philadelphia, Wilmington and Baltimore Railroad Bridge No. 1
Lyduvėnai Bridge	bridgeName	Lyduvėnai Bridge
Jonava Bridge	bridgeName	Jonava Bridge
Taurosta Bridge	bridgeName	Taurosta Bridge
Taizhou Yangtze River Bridge	bridgeName	Taizhou Bridge
Zunyi Bridge	bridgeName	Zunyi Bridge
Wujiang Viaduct	bridgeName	Wujiang Viaduct
Luojiao River Bridge	bridgeName	Luojiao River Bridge
Hutiaohe Bridge	bridgeName	Hutiao River Viaduct
Yangmingtan Bridge	bridgeName	Yangmingtan Bridge
Lincoln Highway Passaic River Bridge	bridgeName	Lincoln Highway Bridge
Keane Bridge	bridgeName	Keane Bridge
Dutton Horse Bridge	bridgeName	Dutton Horse Bridge
Crimple Valley Viaduct	bridgeName	Crimple Valley Viaduct
Carrollton–Prestonville Bridge	bridgeName	Carrollton–Prestonville Bridge
Singing Bridge	bridgeName	Singing Bridge
War Mothers Memorial Bridge	bridgeName	War Mothers Memorial Bridge
Pont Vell, Santa Eulària des Riu	bridgeName	Pont Vell
Lezíria Bridge	bridgeName	Lezíria Bridge
Yancopin Bridge	bridgeName	Yancopin Bridge
Cambridge Main Street Bridge	bridgeName	Cambridge Main Street Bridge
Market Street Bridge	bridgeName	Market St. Bridge
Governor's Bridge	bridgeName	Governor's Bridge
Guozigoui Bridge	bridgeName	Guozigoui Bridge
Guozigoui Bridge	bridgeName	Talki Bridge
Ikitsuki Bridge	bridgeName	Ikitsuki Bridge
Badong Yangtze River Bridge	bridgeName	Badong Yangtze River Bridge
Upper Twin Falls Bridge	bridgeName	Upper Twin Falls Bridge
Queen Anne Bridge	bridgeName	Queen Anne Bridge
Nhật Tân Bridge	bridgeName	Nhật Tân Bridge
Bình Triệu Bridge	bridgeName	Bình Triệu Bridge
Taemas Bridge	bridgeName	Taemas Bridge
Jalan Kinabalu Flyover	bridgeName	Jalan Kinabalu Flyover
Sultan Ahmad Shah III Bridge	bridgeName	Sungai Pahang Bridge
Lake Shore and Michigan Southern Railway, Bridge No. 6	bridgeName	Lake Shore and Michigan Southern Railway, Bridge No. 6
Çanakkale 1915 Bridge	bridgeName	Çanakkale 1915 Bridge
Envigado bridge	bridgeName	Peldar Bridge
Esperanto Bridge	bridgeName	Esperanto Bridge
Yichang Yangtze River Railway Bridge	bridgeName	Yichang Railway Bridge
Yunyang Yangtze River Bridge	bridgeName	Yunyang Bridge
Verrugas Bridge	bridgeName	Verrugas Bridge
Goz Abu Goma Bridge	bridgeName	Goz Abu Goma Bridge
Chien Tang River Bridge	bridgeName	Chien Tang River Bridge
The Triplets bridges	bridgeName	The Triplets Bridges
Hardy Bridge	bridgeName	Hardy Bridge
Omdurman Bridge	bridgeName	Omdurman Bridge
Desouk Bridge	bridgeName	Desouk Bridge
Alfred Beit Road Bridge	bridgeName	Alfred Beit Road Bridge
Algebuckina Bridge	bridgeName	Algebuckina Bridge
Zuari Bridge	bridgeName	Zuari Bridge
Sharavati Bridge	bridgeName	Sharavati Bridge
Sant Boi Bridge	bridgeName	Sant Boi Bridge over Llobregat River
Old Naini Bridge	bridgeName	Old Naini Bridge
Seafarers Bridge	bridgeName	Seafarers Bridge
Richard V. Woods Memorial Bridge	bridgeName	Woods Memorial Bridge
Zhicheng Yangtze River Bridge	bridgeName	Zhicheng Yangtze River Bridge
Jingzhou Yangtze River Bridge	bridgeName	Jingzhou Bridge
Wuhan Junshan Yangtze River Bridge	bridgeName	Wuhan Junshan Yangtze River Bridge
Linsum Bridge	bridgeName	Sungai Simin Bridge
High Speed Railway Bridge over AP7, Llinars del Valles	bridgeName	High Speed Railway Bridge in Llinars
Sant Feliu Pedestrian Bridge	bridgeName	Sant Feliu Pedestrian Bridge
Vilafant Bridge	bridgeName	Vilafant Bridge
Young's High Bridge	bridgeName	Young's High Bridge
Fingle Bridge	bridgeName	Fingle Bridge
Sixth Street Bridge	bridgeName	Sixth Street Bridge
Mkapa Bridge	bridgeName	Mkapa Bridge
Wami Bridge	bridgeName	Wami Bridge
New Ruvu Bridge	bridgeName	New Ruvu Bridge
Kigamboni Bridge	bridgeName	Kigamboni Bridge
Kilombero Bridge	bridgeName	Kilombero Bridge
Kikwete Bridge	bridgeName	Kikwete Bridge
Selander Bridge	bridgeName	Selander Bridge
Armando Emilio Guebuza Bridge	bridgeName	Armando Emilio Guebuza Bridge
Mozambique Island Bridge	bridgeName	Mozambique Island Bridge
Kirumi Bridge	bridgeName	Kirumi Bridge
Lion Bridge	bridgeName	Lion Bridge
Cheshire Bridge	bridgeName	Cheshire Bridge
Erqi Yangtze River Bridge	bridgeName	Erqi Bridge
Kyaka Bridge	bridgeName	Kyaka Bridge
Rusumo Bridge	bridgeName	Rusumo Bridge
Rusumo International Bridge	bridgeName	Rusumo International Bridge
Pont Jacques Chaban-Delmas	bridgeName	Pont Jacques Chaban-Delmas
Songwe Bridge	bridgeName	Songwe Bridge
Rosedale Valley Bridge	bridgeName	Rosedale Valley Bridge
Mbutu Bridge	bridgeName	Mbutu Bridge
Sibiti Bridge	bridgeName	Sibiti Bridge
Nandu River Iron Bridge	bridgeName	Nandu River Iron Bridge
Qiongzhou Bridge	bridgeName	Qiongzhou Bridge
Ehuang Yangtze River Bridge	bridgeName	Ehuang Yangtze River Bridge
Huangshi Yangtze River Bridge	bridgeName	Huangshi Bridge
Jiujiang Yangtze River Expressway Bridge	bridgeName	Jiujiang Yangtze River Expressway Bridge
Frances Appleton Bridge	bridgeName	Frances Appleton Bridge
Lanang Bridge	bridgeName	Lanang Bridge
Batang Mukah Bridge	bridgeName	Batang Mukah Bridge
Sitompok Bridge	bridgeName	Sungai Sitompok Bridge
Davtashen Bridge	bridgeName	Davtashen Bridge
Dashengguan Yangtze River Bridge	bridgeName	Dashengguan Bridge
Great Bridge of Hrazdan	bridgeName	Great Bridge of Hrazdan
Hrazdan Gorge Aqueduct	bridgeName	Hrazdan Gorge Aqueduct
Horns Bridge	bridgeName	Horns Bridge
Windsor Bridge	bridgeName	Windsor Bridge
Menangle Railway Bridge	bridgeName	Menangle Railway Bridge
Fledborough Viaduct	bridgeName	Fledborough Viaduct
Doe Lea Viaduct	bridgeName	Doe Lea Viaduct
Nashipur Rail Bridge	bridgeName	Nashipur Rail Bridge
Uzunköprü Bridge	bridgeName	Uzunköprü Bridge
Boythorpe Viaduct	bridgeName	Boythorpe Viaduct
Second Nanjing Yangtze Bridge	bridgeName	Second Nanjing Yangtze Bridge
Temburong Bridge	bridgeName	Temburong Bridge
Highway 2 Bridge	bridgeName	Highway 2 Bridge
Fourth Nanjing Yangtze Bridge	bridgeName	Fourth Nanjing Yangtze Bridge
Ma'anshan Yangtze River Bridge	bridgeName	Ma'anshan Yangtze River Bridge
Lidy Walker Covered Bridge	bridgeName	Lidy Walker CB
Durin Bridge	bridgeName	Durin Bridge
Cameron Street Bridge	bridgeName	Cameron Street Bridge
Bakulahi Bridge	bridgeName	Bakulahi Bridge
I-5 Skagit River Bridge collapse	bridgeName	I-5 Skagit River Bridge
Robert Craig Memorial Bridge	bridgeName	Craig Memorial Bridge
Bogibeel Bridge	bridgeName	Bogibeel Bridge
Ponte d'Augusto	bridgeName	Ponte d'Augusto
Dufferin Street bridges	bridgeName	Dufferin Street Truss Bridge/Dufferin Street Overpass
Tresfjord Bridge	bridgeName	Tresfjord Bridge
Selat Lumut-SKVE Bridge	bridgeName	Selat Lumut-SKVE Bridge
Bullards Bridge	bridgeName	Bullards Bridge
Taradale Viaduct	bridgeName	Taradale Viaduct
Barron Collier Bridge	bridgeName	Barron Collier Bridge
Gilchrist Bridge	bridgeName	Gilchrist Bridge
Stark Street Bridge	bridgeName	Stark Street Bridge
Markland Grips Viaduct	bridgeName	Markland Grips Viaduct
Malmsbury Viaduct	bridgeName	Malmsbury Viaduct
Mon–Fayette Expressway Bridge	bridgeName	Mon–Fayette Expressway Bridge
Bridge at Falling Creek	bridgeName	Bridge at Falling Creek
Jiaxing-Shaoxing Sea Bridge	bridgeName	Jiaxing-Shaoxing Sea Bridge
Anqing Yangtze River Railway Bridge	bridgeName	Anqing Railway Bridge
Thondamannar Bridge	bridgeName	Thondamannar Bridge
Lishui River Bridge	bridgeName	Lishui River Bridge
Yingwuzhou Yangtze River Bridge	bridgeName	Wuhan Yingwuzhou Yangtze River Bridge
Dinkey Creek Bridge	bridgeName	Dinkey Creek Bridge
Elgin Bridge	bridgeName	Elgin Bridge
Nanxi Bridge	bridgeName	Nanxi Bridge
Bosideng Bridge	bridgeName	Bosideng Bridge
Hejiang Bridge	bridgeName	Hejiang Bridge
Hoge Brug	bridgeName	Hoge Brug / Hoeg Brögk
SkyWalk	bridgeName	SkyWalk
East Bloomsburg Bridge	bridgeName	East Bloomsburg Bridge
Haus-Knipp railway bridge	bridgeName	Haus-Knipp railway bridge
Tuscarora Creek	bridgeName	Tuscarora Creek  bridge
Little Pipe Creek bridge and viaduct	bridgeName	Little Pipe Creek bridge and viaduct
Monocacy River bridge and viaduct	bridgeName	Monocacy river railroad bridge and viaduct
Bukit Putus Viaduct	bridgeName	Bukit Putus Viaduct
Lojing Viaduct	bridgeName	Lojing Viaduct
Paluh Hinai Bridge	bridgeName	Sungai Pahang Bridge
Endau Bridge	bridgeName	Sungai Endau Bridge
Kota Tinggi Second Bridge	bridgeName	Sungai Johor Bridge
Kota Bridge, Klang	bridgeName	Sungai Klang Bridge
Kota Bridge, Kota Tinggi	bridgeName	Sungai Johor Bridge
Luokou Yellow River Railway Bridge	bridgeName	Luokou Yellow River Railway Bridge
Tallahatchee Covered Bridge	bridgeName	Tallahatchee CB
Hamish Hay Bridge	bridgeName	Hamish Hay Bridge
Banting Bridge	bridgeName	Sungai Langat Bridge
Keppel Bay Bridge	bridgeName	Keppel Bay Bridge
Breydon Bridge	bridgeName	Breydon Bridge
SAFTI Link Bridge	bridgeName	SAFTI Link Bridge
Long–Allen Bridge	bridgeName	Long–Allen Bridge
Thornes Bridge	bridgeName	Thornes Bridge
Douvenant Viaduct	bridgeName	Douvenant Viaduct
Hardbrücke	bridgeName	Hardbrücke
San Luis Bridge	bridgeName	San Luis Bridge
Cáhuil Bridge	bridgeName	Cáhuil Bridge
U Bein Bridge	bridgeName	U Bein's Bridge
Irrawaddy Bridge	bridgeName	Irrawaddy Bridge
Irrawaddy Bridge	bridgeName	Ayeyarwady Bridge
Irrawaddy Bridge	bridgeName	Yadanabon Bridge
Ray Nitschke Memorial Bridge	bridgeName	Ray Nitschke Memorial Bridge
Knickerbocker Bicycle Bridge	bridgeName	Knickerbocker Bicycle Bridge
Dave and Lynn Frohnmayer Pedestrian and Bicycle Bridge	bridgeName	Dave and Lynn Frohnmayer Pedestrian and Bicycle Bridge
Chulachomklao Bridge	bridgeName	Chulachomklao bridge
100-metres Bridge, Thailand	bridgeName	100
Ban Mai Bridge	bridgeName	Ban Mai Bridge
Prachantakham River Bridge	bridgeName	Prachantakham River Bridge
Phra Prong Bridge	bridgeName	Phra Prong Bridge
Hanuman River Railway bridge	bridgeName	Hanuman River Railway bridge
Bueng Boraphet Railway bridge	bridgeName	Bueng Boraphet Railway bridge
Nong Pling Bridge	bridgeName	Nong Pling Bridge
Chakri Railway bridge	bridgeName	Chakri Railway bridge
Chawang River Railway bridge	bridgeName	Chawang River Railway bridge
Chi River Railway bridge	bridgeName	Chi River Railway bridge
Chulalongkorn Bridge	bridgeName	Chulalongkorn Bridge
Guang River Railway bridge	bridgeName	Guang River Railway bridge
Grand Street Bridge	bridgeName	Grand Street Bridge
Guillemard Bridge	bridgeName	Sungai Kelantan Railway Bridge
Tanah Merah Bridge	bridgeName	Sungai Kelantan Bridge
Foreshore Freeway Bridge	bridgeName	Foreshore Freeway Bridge
Pedestrian Bridge over Segre River	bridgeName	Lleida pedestrian bridge over Segre River
Karnali Bridge	bridgeName	Karnali Bridge
Duvall Bridge	bridgeName	Duvall Bridge
Atamurat-Kerkichi Bridge	bridgeName	Atamurat-Kerkichi Bridge
George V. Voinovich Bridges	bridgeName	George V. Voinovich Bridge westbound
George V. Voinovich Bridges	bridgeName	George V. Voinovich Bridge eastbound
Jade's Crossing	bridgeName	Jade's Crossing
Natural Pier Bridge	bridgeName	Natural Pier Bridge
Onerahi Causeway	bridgeName	Onerahi Causeway
Xiamen Zhangzhou Bridge	bridgeName	Xiamen Zhangzhou Bridge
Yadkin River Veterans Memorial Bridge	bridgeName	Yadkin River Veterans Memorial Bridge
Wil-Cox Bridge	bridgeName	Wil-Cox Bridge
Killaloe Bridge	bridgeName	Killaloe Bridge
Hamm Railway Bridge	bridgeName	Hamm Railway Bridge
Clackline Bridge	bridgeName	Clackline Bridge
South Bridge	bridgeName	South Bridge, Cologne
Shallowford Bridge	bridgeName	Shallowford Bridge
India Point Railroad Bridge	bridgeName	India Point Railroad Bridge
Zhuoshui Fengyu Bridge	bridgeName	Zhuoshui Fengyu Bridge
Snell's Bridge	bridgeName	Snell's Bridge
Xianshen River Bridge	bridgeName	Xianshen River Bridge
Pandaruan Bridge	bridgeName	Sungai Pandaruan Bridge
Dingshan Bridge	bridgeName	Dingshan Bridge
Macquarie Culvert	bridgeName	Macquarie Culvert
Liaohe Bridge	bridgeName	Liaohe Bridge
Maguo River Bridge	bridgeName	Maguo River Bridge
Aciliu Viaduct	bridgeName	Aciliu Viaduct
Warden Railway Bridge	bridgeName	Warden Railway Bridge
Warden Bridge	bridgeName	Warden Bridge
Haydon Bridge Viaduct	bridgeName	Haydon Bridge Viaduct
New Haydon Bridge	bridgeName	New Haydon Bridge
Old Haydon Bridge	bridgeName	Old Haydon Bridge
Lipwood Railway Bridge	bridgeName	Lipwood Railway Bridge
Ridley Bridge	bridgeName	Ridley Bridge
Ridley Railway Bridge	bridgeName	Ridley Railway Bridge
Millhouse Bridge	bridgeName	Millhouse Bridge
Herschel Lovett Bridge	bridgeName	Herschel Lovett Bridge
William H. Brantley Jr. Bridge	bridgeName	William H. Brantley Jr. Bridge
Ashton Avenue Bridge	bridgeName	Ashton Avenue Bridge
Marnan Bridge	bridgeName	Marnan Bridge
Crossman Bridge	bridgeName	Crossman Bridge
Ufa Rail Bridge	bridgeName	Ufa Rail Bridge
Forth Bridge	bridgeName	Forth Bridge
Pleasure Beach Bridge	bridgeName	Pleasure Beach Bridge
Congress Street Bridge	bridgeName	Congress Street Bridge
East Washington Avenue Bridge	bridgeName	East Washington Avenue Bridge
Bridge over Institute Street	bridgeName	Bridge over Institute Street
Beaver River Railroad Bridge	bridgeName	Beaver River Railroad Bridge
Haikou New East Bridge	bridgeName	Haikou New East Bridge
Laxford Bridge	bridgeName	Laxford Bridge
Kuala Berang Bridge	bridgeName	Sungai Terengganu Bridge
Golden Horn Metro Bridge	bridgeName	Golden Horn Metro Bridge
Fargo-Moorhead Toll Bridge	bridgeName	30
Al Ittihad Bridge	bridgeName	Dubai Smile / Al Ittihad Bridge
Pensford Viaduct	bridgeName	Pensford Viaduct
Bordeleau Bridge	bridgeName	Bordeleau bridge
Oddamavadi Bridge	bridgeName	Oddamavadi Bridge
Sungai Kebun Bridge	bridgeName	Sungai Kebun Bridge
Sultan Abdul Halim Muadzam Shah Bridge	bridgeName	Sultan Abdul Halim Muadzam Shah Bridge
Chacahoula Swamp Bridge	bridgeName	Chacahoula Swamp Bridge
Grand Street Bridge	bridgeName	Grand Street Bridge
Louisiana Highway 1 Bridge	bridgeName	Louisiana Highway 1 Bridge
LaBranche Wetlands Bridge	bridgeName	LaBranche Wetlands Bridge
I-10 Bonnet Carré Spillway Bridge	bridgeName	I-10 Bonnet Carré Spillway Bridge
Lekki-Ikoyi Link Bridge	bridgeName	Lekki-Ikoyi Link Bridge
CNR Bonnet Carré Spillway-McComb Bridge	bridgeName	CNR Bonnet Carré Spillway-McComb Bridge
Price–Legg Bridge	bridgeName	Price–Legg Bridge
Major Byron S. McGuire Sr. Memorial Bridge	bridgeName	Major Byron S. McGuire Sr. Memorial Bridge
B. Edward Tankersley Memorial Bridge	bridgeName	B. Edward Tankersley Memorial Bridge
G.B. %22Dip%22 Lamkin Bridge	bridgeName	G.B. \
Robert W. Pollard Bridge	bridgeName	Robert W. Pollard Bridge
Sand Bar Ferry Bridge	bridgeName	Sand Bar Ferry Bridge
Furys Ferry Bridge	bridgeName	Furys Ferry Bridge
William %22Billy%22 L. Powell Jr. Bridge	bridgeName	William \
Old Roosevelt Bridge	bridgeName	Old Roosevelt Bridge
Dr. J. Alvin Leaphart Sr. Memorial Bridge	bridgeName	Dr. J. Alvin Leaphart Sr. Memorial Bridge
Claxton Bridge	bridgeName	Claxton Bridge
U.S. 61 Bonnet Carré Spillway Bridge	bridgeName	U.S. 61 Bonnet Carré Spillway Bridge
Kansas City Southern Bonnet Carré Spillway Bridge	bridgeName	Kansas City Southern Bonnet Carré Spillway Bridge
CNR Bonnet Carré Spillway-Baton Rouge Bridge	bridgeName	CNR Bonnet Carré Spillway-Baton Rouge Bridge
CSX Chef Menteur Pass Bridge	bridgeName	CSX Chef Menteur Pass Bridge
Gamla bron	bridgeName	Gamla bron
Meldon Viaduct	bridgeName	Meldon Viaduct
Dr. J.A. Griffith Bridge	bridgeName	Dr. J.A. Griffith Bridge
Coogan Ray Bleodow Memorial Bridge	bridgeName	Coogan Ray Bleodow Memorial Bridge
Ciénega Bridge	bridgeName	Ciénega Bridge
Manmunai Bridge	bridgeName	Manmunai Bridge
Sloans Ferry Bridge	bridgeName	Sloans Ferry Bridge
Forrest L. Adair II Memorial Bridge	bridgeName	Forrest L. Adair II Memorial Bridge
Tegsbron	bridgeName	Tegsbron
Bethanga Bridge	bridgeName	Bethanga Bridge
Hill–Talley Bridge	bridgeName	Hill–Talley Bridge
Nissibi Euphrates Bridge	bridgeName	Nissibi Euphrates Bridge
Nissibi Euphrates Bridge	bridgeName	(Nissibi Köprüsü)
Ripson Bridge	bridgeName	Ripson Bridge
Longford Railway Bridge	bridgeName	Longford railway bridge
Dan Cameron Bridge	bridgeName	Dan Cameron Bridge
Cartland Bridge	bridgeName	Cartland Bridge
Northern Railway Bridge	bridgeName	Northern Railway Bridge
Haynes Inlet Bridge	bridgeName	Haynes Inlet Bridge
Bridge of Isabel II	bridgeName	Bridge of Isabel II
San Juan River Bridge	bridgeName	San Juan River Bridge
Pupin Bridge	bridgeName	Pupin Bridge
14th of July Bridge	bridgeName	--07-14
Lieutenant General James E. Gray Memorial Bridge	bridgeName	Lieutenant General James E. Gray Memorial Bridge
Brücke der Solidarität	bridgeName	Bridge of Solidarity
Ponte Giuseppe Mazzini	bridgeName	Ponte Giuseppe Mazzini
LTG Robert E. Gray Memorial Bridge	bridgeName	LTG Robert E. Gray Memorial Bridge
Pastor H.K. McKnight Sr. Bridge	bridgeName	Pastor H.K. McKnight Sr. Bridge
Ponte Garibaldi	bridgeName	Ponte Garibaldi
South Street Bridge	bridgeName	South Street Bridge
Ponte Palatino	bridgeName	Ponte Palatino
Ponte Testaccio	bridgeName	Ponte Testaccio
Lejonströmsbron	bridgeName	Lejonströmsbron
Al-Qa'im border crossing	bridgeName	Al-Qa'im border crossing
Bukit Kuang Bridge	bridgeName	Sungai Chukai Bridge
Ponte Punta Penna Pizzone	bridgeName	Ponte Punta Penna Pizzone
Mingo Creek Viaduct	bridgeName	Mingo Creek Viaduct
Penumudi–Puligadda Bridge	bridgeName	Penumudi–Puligadda Bridge
Geobukseon bridge	bridgeName	Geobukseon Bridge
Cheong poong bridge	bridgeName	Cheong Poong Bridge
Sepung Bridge	bridgeName	Sepung Bridge
Bakhtiyarpur–Tajpur bridge	bridgeName	Bakhtiyarpur–Tajpur bridge
Oregon Creek Covered Bridge	bridgeName	Oregon Creek Covered Bridge
John Ringling Causeway	bridgeName	John Ringling Causeway
S.S. Jolley Bridge	bridgeName	S.S. Jolley Bridge
A. Max Brewer Bridge	bridgeName	A. Max Brewer Bridge
Ravning Bridge	bridgeName	Ravning Bridge
Burguillo Reservoir Arch Bridge	bridgeName	Burguillo Reservoir Arch Bridge
Admiral T. J. Lopez Bridge	bridgeName	Admiral T. J. Lopez Bridge
Phil G. McDonald Bridge	bridgeName	Phil G. McDonald Bridge
Manwel Dimech Bridge	bridgeName	Manwel Dimech Bridge
Mousemill Bridge	bridgeName	Mousemill New Bridge
Mousemill Bridge	bridgeName	Mousemill Old Bridge
Eckington Bridge	bridgeName	Eckington Bridge
Diamond Jubilee Footbridge	bridgeName	Diamond Jubilee Footbridge
John Dunn Bridge	bridgeName	John Dunn Bridge
Dodhara Chandani Bridge	bridgeName	Dodhara Chandani Bridge
Dodhara Chandani Bridge	bridgeName	दोधारा चाँदनी पुल
Margaret McDermott Bridge	bridgeName	Margaret McDermott Bridge
Old Bridge, Hasankeyf	bridgeName	Old Bridge, Hasankeyf
Hall of Fame Bridge	bridgeName	Hall of Fame Bridge
Approuague Bridge	bridgeName	Approuague Bridge
Tsakona Arch Bridge	bridgeName	Tsakona Arch Bridge
Tsakona Arch Bridge	bridgeName	Τοξωτή Γέφυρα Τσακώνας
Malagonlong Bridge	bridgeName	Malagonlong Bridge
Kuala Linggi Bridge	bridgeName	Sungai Linggi Bridge
Morar Railway Viaduct	bridgeName	Morar Railway Viaduct
Callicoon Bridge	bridgeName	Callicoon Bridge
Luggie Aqueduct	bridgeName	Luggie Aqueduct
Shelford Bridge	bridgeName	Shelford bridge
Newbattle Viaduct	bridgeName	Newbattle Viaduct
Victoria Swing Bridge	bridgeName	Victoria Swing Bridge
Glen Loy Aqueduct	bridgeName	Glen Loy Aqueduct
Avon Viaduct	bridgeName	Avon Viaduct
Haji Mohd Lazim Bridge	bridgeName	Tanjung Sedili Bridge
Coat of Arms Bridge	bridgeName	Coat of Arms Bridge
Stampetta Bridge	bridgeName	Stampetta Bridge
Bolesławiec rail viaduct	bridgeName	Bolesławiec rail viaduct
Dinting Viaduct	bridgeName	Dinting Viaduct
Cochecton–Damascus Bridge	bridgeName	Cochecton–Damascus Bridge
EG LNG Pipeline Suspension Bridge	bridgeName	EG LNG Pipeline Suspension Bridge
Long Island Bridge	bridgeName	Long Island Bridge
Landacre Bridge	bridgeName	Landacre Bridge
Broadbottom Viaduct	bridgeName	Broadbottom Viaduct
Śląsko-Dąbrowski Bridge	bridgeName	Śląsko-Dąbrowski Bridge
Kierbedzia Bridge	bridgeName	Kierbedzia Bridge
Citadel Rail Bridge	bridgeName	Citadel Rail Bridge
Pancer Viaduct	bridgeName	Pancer Viaduct
The Celtic Gateway	bridgeName	Celtic Gateway Bridge
McMillans Bridge	bridgeName	McMillans bridge
Santa Quiteria Bridge	bridgeName	Santa Quiteria Bridge
Pitfield Bridge	bridgeName	Pitfield bridge
Banagher bridge	bridgeName	Banagher bridge
Glenmona Bridge	bridgeName	Glenmona bridge
White Cart Bridge	bridgeName	White Cart Bridge
Sigismund Augustus Bridge	bridgeName	Sigismund Augustus Bridge
Railway viaduct in Gorzów Wielkopolski	bridgeName	Railway flyover in Gorzów Wielkopolski
16th Street Bridge	bridgeName	16
Mystic River Railroad Bridge	bridgeName	Mystic River Railroad Bridge
Mariánský most	bridgeName	Mariánský most
Peak Walk	bridgeName	Peak Walk
Bradford Bridge	bridgeName	Bradford Bridge
Banning Railroad Bridge	bridgeName	Banning Railroad Bridge
The Living Bridge	bridgeName	The Living Bridge
General Stefan %22Grot%22 Rowecki Bridge	bridgeName	General Stefan \
Średnicowy Bridge	bridgeName	Średnicowy Bridge
James B. Garrison Bridge	bridgeName	James B. Garrison Bridge
Ohiopyle Low Bridge	bridgeName	Ohiopyle Low Bridge
Ohiopyle High Bridge	bridgeName	Ohiopyle High Bridge
Ohiopyle Highway Bridge	bridgeName	Ohiopyle Highway Bridge
Troja Bridge	bridgeName	Troja Bridge
Qinglan Bridge	bridgeName	Qinglan Bridge
Johnston Street Bridge	bridgeName	Johnston Street Bridge
Hanging Bridge at Chekaguda, Rayagada	bridgeName	Hanging Bridge at Chekaguda, Rayagada
Kangaroo Point Bridge	bridgeName	Kangaroo Point Bridge
Mabini Bridge	bridgeName	Mabini Bridge
Yachi River Bridge	bridgeName	Yachi Bridge
Qingshui River Bridge	bridgeName	Qingshui River Bridge
Dick Lane Bridge	bridgeName	Dick Lane Bridge
Ponte della Vittoria, Pisa	bridgeName	Ponte della Vittoria
Honeymoon Bridge	bridgeName	Honeymoon Bridge
Taku Bridge	bridgeName	Taku Bridge
Isleton Bridge	bridgeName	Isleton Bridge
Ramsey Harbour Swing Bridge	bridgeName	Ramsey Harbour Swing Bridge
Garratt Road Bridge	bridgeName	Garratt Road Bridge
Longjiang Bridge	bridgeName	Longjiang Bridge
Möljä Bridge	bridgeName	Möljä Bridge
Haselbury Bridge	bridgeName	Haselbury Bridge
Pill Bridge	bridgeName	Pill Bridge
Najiehe Railway Bridge	bridgeName	Najiehe Railway Bridge
Loch nan Uamh Viaduct	bridgeName	Loch nan Uamh Viaduct
Borrodale Viaduct	bridgeName	Borrodale Viaduct
Sluggan Bridge	bridgeName	Sluggan Bridge
Arnabol Viaduct	bridgeName	Arnabol Viaduct
Duge Bridge	bridgeName	Duge Bridge
Larichmore Viaduct	bridgeName	Larichmore Viaduct
Banavie Swing Bridge	bridgeName	Banavie Swing Bridge
Banavie Railway Swing Bridge	bridgeName	Banavie Railway Swing Bridge
Creag-an-Arnain Viaduct	bridgeName	Creag-an-Arnain Viaduct
Neak Loeung Bridge	bridgeName	Neak Loeung Bridge
Broomhill Bridge	bridgeName	Broomhill Bridge
Shin Railway Viaduct	bridgeName	Shin Railway Viaduct
Luding Yaye Expressway Bridge	bridgeName	Luding Yaye Expressway Bridge
Falls of Cruachan Railway Viaduct	bridgeName	Falls of Cruachan Railway Viaduct
Lancang River Railway Bridge	bridgeName	Lancang River Railway Bridge
Zongqihe Bridge	bridgeName	Zongqihe Bridge
Fshajt Bridge	bridgeName	Fshajt Bridge/Saint Bridge
Telescopic Bridge, Bridgwater	bridgeName	Telescopic rail bridge
Münsterbrücke, Zürich	bridgeName	Münsterbrücke
Rathausbrücke, Zürich	bridgeName	Rathausbrücke
Puente de Occidente	bridgeName	Puente de Occidente
Bahnhofbrücke, Zürich	bridgeName	Bahnhofbrücke
Allen Street Bridge disaster	bridgeName	Allen Street Bridge
Gueuroz Bridge	bridgeName	Gueuroz Bridge
New Youngs Bay Bridge	bridgeName	New Youngs Bay Bridge
Thornborough Bridge	bridgeName	Thornborough Bridge
Henri Konan Bédié Bridge	bridgeName	Henri Konan Bédié Bridge
Leamington Lift Bridge	bridgeName	Leamington Lift Bridge
Südbrücke, Mainz	bridgeName	Südbrücke
New York Avenue Bridge	bridgeName	New York Avenue Bridge
Skjeggestad Bridge	bridgeName	Skjeggestad Bridge
Arrah–Chhapra Bridge	bridgeName	Arrah–Chhapra Bridge
Raymond Lester Bridge	bridgeName	Raymond Lester Bridge
Zero Bridge	bridgeName	Zero Bridge
Billy's Creek Bridge	bridgeName	Billy's Creek Bridge
Bac de Roda Bridge	bridgeName	Bac de Roda Bridge
Eintveit Bridge	bridgeName	Eintveit Bridge
Luding Bridge	bridgeName	Luding Bridge
Jim Stynes Bridge	bridgeName	Jim Stynes Bridge
Zhaoqing Bridge	bridgeName	Xijiang Railway Bridge
Lower Guadiana International bridge	bridgeName	Lower Guadiana International Bridge
Our Lady of Help Bridge	bridgeName	Our Lady of Help Bridge
Dos Hermanos Bridge	bridgeName	Dos Hermanos Bridge
Novosibirsk Rail Bridge	bridgeName	The old railway bridge over the Ob
Belarusian rail bridge in Moscow	bridgeName	Belarusian rail bridge in Moscow
Tabiat Bridge	bridgeName	Tabi'at  Bridge
John Whitton Bridge	bridgeName	Meadowbank Bridge
Komsomolsk-on-Amur road-rail bridge	bridgeName	The bridge across the Amur River
Dhola-Sadiya bridge	bridgeName	Zero point bridge
Goondiwindi Border Bridge	bridgeName	Goondiwindi Border Bridge
Como railway bridge	bridgeName	Como Railway Bridge
Kostroma rail bridge	bridgeName	Kostroma rail bridge
Zhaozhuang Bridge	bridgeName	Zhaozhuang Bridge
Eighth Street Bridge	bridgeName	Eight Street Bridge
Sky Gate Bridge R	bridgeName	Sky Gate Bridge R
Khan Jahan Ali Bridge	bridgeName	Khan Jahan Ali Bridge
Morgan Draw	bridgeName	Morgan Draw
The American Bridge	bridgeName	The American Bridge
Nine Arches Bridge, Demodara	bridgeName	Nine Arches Bridge
Meshginshahr suspension bridge	bridgeName	Meshginshahr suspension bridge
Hinaki Eel Trap Bridge	bridgeName	Hinaki  Bridge
William B. Umstead Bridge	bridgeName	William B. Umstead Bridge
Wright Memorial Bridge	bridgeName	Wright Memorial Bridge
Gateway Bridge	bridgeName	Gateway Bridge
Swamp Meadow Bridge	bridgeName	Swamp Meadow Bridge
Batu 6 Bridge	bridgeName	Sungai Rui Bridge
Oddesund Bridge	bridgeName	Oddesund Bridge
Ayala Bridge	bridgeName	Ayala Bridge
Angle Vale Bridge	bridgeName	Angle Vale Bridge
Netravati Bridge	bridgeName	Netravati Bridge
Kiz Bridge	bridgeName	Kiz Bridge
Arroyo Simi Overhead	bridgeName	Arroyo Simi Overhead
Mintlaw Viaduct	bridgeName	Mintlaw Viaduct
Ayrton Senna Bridge	bridgeName	Ayrton Senna Bridge
Old Bridge	bridgeName	Old Bridge
Pont de Rei	bridgeName	Pont de Rei
Danjiang Bridge	bridgeName	Danjiang Bridge
Kacchi Dargah–Bidupur bridge	bridgeName	Kacchi Dargah–Bidupur bridge
Mindoro–Batangas Super Bridge	bridgeName	Mindoro–Batangas Super Bridge
Tabriz Cable Bridge	bridgeName	Tabriz Cable Bridge
Alice Okolo Bridge	bridgeName	Alice Okolo Bridge
Sagadahoc Bridge	bridgeName	Sagadahoc Bridge
Long Key Bridge	bridgeName	Long Key Bridge
McCallum Lock Gates	bridgeName	McCallum Lock Gates Bridge
Sauer Valley Bridge	bridgeName	Sauer Valley Bridge
Gregory Avenue Bridge	bridgeName	Gregory Avenue Bridge
Salisbury Viaduct	bridgeName	Salisbury Viaduct
Ponts Couverts, Strasbourg	bridgeName	Ponts Couverts
Altıgöz Bridge	bridgeName	Altıgöz Bridge
Temse Bridge	bridgeName	Temse Bridge
Merefa-Kherson bridge	bridgeName	Merefa-Kherson bridge
Kanuni Sultan Suleiman bridge	bridgeName	Kanuni Sultan Suleiman bridge
Viaduct of Moresnet	bridgeName	Viaduct of Moresnet
Viaduct of Moresnet	bridgeName	Geul Valley bridge
Hammer Bridge	bridgeName	Hammer Bridge
Execution Bridge	bridgeName	Execution/Decapitation Bridge
Itz Valley Autobahn Bridge	bridgeName	Itz Valley Autobahn Bridge
Merchant Square Footbridge	bridgeName	Merchant Square Footbridge.
Lansdowne Bridge	bridgeName	Lansdowne Bridge
Estrella–Pantaleon Bridge	bridgeName	Estrella–Pantaleon Bridge
Christchurch Bridge	bridgeName	Christchurch Bridge
Abraham Lincoln Bridge	bridgeName	Abraham Lincoln Bridge
East River Bridge	bridgeName	East River Bridge
Broadway Bridge	bridgeName	Broadway Bridge
Wetherby Bridge	bridgeName	Wetherby Bridge
Tadcaster Bridge	bridgeName	Tadcaster Bridge
Stung Treng Bridge	bridgeName	Stung Treng Bridge
Linton Bridge	bridgeName	Linton Bridge
Collingham Bridge	bridgeName	Collingham Bridge
Keekle Viaduct	bridgeName	Keekle Viaduct
Ponte de Aljezur	bridgeName	Bridge of Aljezur
Union Avenue Bridge	bridgeName	Union Avenue Bridge
Midtown Bridge	bridgeName	Midtown Bridge
Nu River Bridge	bridgeName	Nu River Bridge
Laguna Garzon Bridge	bridgeName	Laguna Garzón Bridge
Bridge of Jerveshtik	bridgeName	Bridge
Kordhocë bridge	bridgeName	The Kordhocë Bridge
Kordhocë bridge	bridgeName	Ura e Kordhocës
Brazil-Peru Integration Bridge	bridgeName	Brazil-Peru Integration Bridge
Nene Viaduct	bridgeName	Nene Viaduct
Friargate Bridge	bridgeName	Friargate Bridge
Fifth Thai–Lao Friendship Bridge	bridgeName	Fifth Thai–Lao Friendship Bridge
Chappel Viaduct	bridgeName	Chappel Viaduct
Anderson Street Bridge	bridgeName	Anderson Street Bridge
Starners Dam Bridge	bridgeName	Starners Dam Bridge
Lawas Bridge	bridgeName	Batang Lawas Bridge
Thorp Arch Bridge	bridgeName	Thorp Arch Bridge
Henderson Bridge	bridgeName	Henderson Bridge
Victoria Bridge, Hereford	bridgeName	Victoria Bridge
Briggs Bridge, Alberta	bridgeName	Briggs Bridge
Hurricane Gulch Bridge	bridgeName	Hurricane Gulch Bridge
Brouwersdam	bridgeName	Brouwersdam
Devlet Bahçeli Bridge	bridgeName	Devlet Bahçeli Bridge
Devlet Bahçeli Bridge	bridgeName	(Devlet Bahçeli Köprüsü)
Bennelong Bridge	bridgeName	Bennelong Bridge
Snake Creek Bridge	bridgeName	Snake Creek Bridge
Calvin Wesley Belcher Bridge	bridgeName	Calvin Wesley Belcher Bridge
Cap-Rouge trestle	bridgeName	Cap-Rouge viaduct
Greystone Bridge	bridgeName	Greystone Bridge
Powell Bridge	bridgeName	Powell Bridge
Baç Bridge	bridgeName	Baç Bridge
Batang Sadong Bridge	bridgeName	Batang Sadong Bridge
Batang Samarahan Bridge	bridgeName	Batang Samarahan Bridge
Taftsville Bridge	bridgeName	Taftsville Bridge
Ala Bridge	bridgeName	Ala Bridge
Kravga Bridge	bridgeName	Kravga Bridge
Stockton Bridge	bridgeName	Stockton Bridge
Makatote Viaduct	bridgeName	Makatote viaduct
Burlington Canal Lift Bridge	bridgeName	Burlington Canal Lift Bridge
Ronald Kirk Bridge	bridgeName	Ronald Kirk Pedestrian Bridge
Inderhavnsbroen	bridgeName	Inderhavnsbroen
Emirgan Pier	bridgeName	Emirgan Pier
Tees Bridge	bridgeName	Tees Rail Bridge
Ağın Bridge	bridgeName	Ağın Bridge
Claudelands Bridge	bridgeName	Claudelands Bridge
Cwm Prysor Viaduct	bridgeName	Cwm Prysor Viaduct
Acton swing bridge	bridgeName	Acton swing bridge
Alton Bridge	bridgeName	Alton Bridge
Stara Ćuprija	bridgeName	Stara Ćuprija
Bariura Old Bridge	bridgeName	Bariura Old Bridge
Bariura Old Bridge	bridgeName	বাড়িউড়া প্রাচীন পুল
Passaic Street Bridge	bridgeName	Passaic Street Bridge
Puqian Bridge	bridgeName	Puqian Bridge
Lillie Bridge	bridgeName	Lillie Bridge
