John Fisher	cardinalName	John Fisher
Henry Edward Manning	cardinalName	Henry Edward Manning
John O'Connor	cardinalName	John O'Connor
Terence Cooke	cardinalName	Terence Cooke
John McCloskey	cardinalName	John McCloskey
Edward Egan	cardinalName	Edward Egan
John Murphy Farley	cardinalName	John Murphy Farley
Patrick Joseph Hayes	cardinalName	Patrick Hayes
Francis Spellman	cardinalName	Francis Spellman
Joseph Bernardin	cardinalName	Joseph Bernardin
John Cody	cardinalName	John Cody
Albert Gregory Meyer	cardinalName	Albert Meyer
George Mundelein	cardinalName	George Mundelein
Samuel Stritch	cardinalName	Samuel Stritch
Franz König	cardinalName	Franz König
Angelo Sodano	cardinalName	Angelo Sodano
József Mindszenty	cardinalName	József Mindszenty
Jean-Marie Lustiger	cardinalName	Aaron Jean-Marie Lustiger
Stanisław Dziwisz	cardinalName	Stanisław Dziwisz
Bernardin Gantin	cardinalName	Bernardin Gantin
James Francis McIntyre	cardinalName	James McIntyre
Paul-Émile Léger	cardinalName	Paul-Émile Léger
Giovanni Benelli	cardinalName	Giovanni Benelli
Giovanni Lajolo	cardinalName	Giovanni Lajolo
Francis George	cardinalName	Francis George
Francis Arinze	cardinalName	Francis Arinze
John Francis O'Hara	cardinalName	John O'Hara
Dennis Joseph Dougherty	cardinalName	Dennis Dougherty
Joseph Zen	cardinalName	Joseph Zen
Anthony Bevilacqua	cardinalName	Anthony Bevilacqua
John Krol	cardinalName	John Krol
Raymond Leo Burke	cardinalName	Raymond Leo Burke
Aloysius Stepinac	cardinalName	Aloysius Stepinac
Edward Aloysius Mooney	cardinalName	Edward Mooney
Humberto Sousa Medeiros	cardinalName	Humberto Sousa Medeiros
Jaime Sin	cardinalName	Jaime L. Cardinal Sin
Cormac Murphy-O'Connor	cardinalName	Cormac Murphy-O'Connor
James Aloysius Hickey	cardinalName	James Hickey
Justin Francis Rigali	cardinalName	Justin Rigali
Godfried Danneels	cardinalName	Godfried Danneels
Stefan Wyszyński	cardinalName	Stefan Wyszyński
John J. Glennon	cardinalName	John Joseph Glennon
Dominik Duka	cardinalName	Dominik Duka
Dionigi Tettamanzi	cardinalName	Dionigi Tettamanzi
Cláudio Hummes	cardinalName	Cláudio Hummes
James Stafford	cardinalName	James Stafford
Juan Sandoval Íñiguez	cardinalName	Juan Sandoval Íñiguez
Francesco Marchetti Selvaggiani	cardinalName	Francesco Marchetti-Selvaggiani
Giovanni Battista Re	cardinalName	Giovanni Battista Re
Thomas Williams	cardinalName	Thomas Stafford Williams
William H. Keeler	cardinalName	William Henry Keeler
Gerald Emmett Carter	cardinalName	Emmett) Carter
Adam Maida	cardinalName	Adam Maida
Christoph Schönborn	cardinalName	Christoph Schönborn
Roger Mahony	cardinalName	Roger Mahony
Aloysius Ambrozic	cardinalName	Alojzij Ambrožič
Marc Ouellet	cardinalName	Marc Ouellet
Jean-Claude Turcotte	cardinalName	Jean-Claude Turcotte
Crescenzio Sepe	cardinalName	Crescenzio Sepe
Óscar Andrés Rodríguez Maradiaga	cardinalName	Óscar Andrés Rodríguez Maradiaga
Ivan Dias	cardinalName	Ivan Dias
José Policarpo	cardinalName	José da Cruz Policarpo
Geraldo Majella Agnelo	cardinalName	Geraldo Majella Agnelo
Norberto Rivera Carrera	cardinalName	Norberto Rivera Carrera
Lubomyr Husar	cardinalName	Lubomyr Husar
Tarcisio Bertone	cardinalName	Tarcisio Bertone
Francisco Javier Errázuriz Ossa	cardinalName	Francisco Errázuriz Ossa
Severino Poletto	cardinalName	Severino Poletto
Juan Luis Cipriani Thorne	cardinalName	Juan Luis Cipriani Thorne
Walter Kasper	cardinalName	Walter Kasper
Ignatius Kung Pin-Mei	cardinalName	Ignatius Kung
William Wakefield Baum	cardinalName	William Baum
Paul Shan Kuo-hsi	cardinalName	Paul Shan Kuo-hsi
Péter Erdő	cardinalName	Péter Erdő
Carlo Furno	cardinalName	Carlo Furno
Roger Etchegaray	cardinalName	Roger Etchegaray
Zenon Grocholewski	cardinalName	Zenon Grocholewski
Rodolfo Quezada Toruño	cardinalName	Rodolfo Quezada Toruño
Nicolás de Jesús López Rodríguez	cardinalName	Nicolás de Jesús López Rodríguez
Philippe Barbarin	cardinalName	Philippe Barbarin
Julius Darmaatmadja	cardinalName	Julius Riyadi Darmaatmadja
Jozef Tomko	cardinalName	Jozef Tomko
Lorenzo Antonetti	cardinalName	Lorenzo Cardinal Antonetti
Maurice Roy	cardinalName	Maurice Roy
Jaime Lucas Ortega y Alamino	cardinalName	Jaime Lucas Ortega y Alamino
Gaudencio Rosales	cardinalName	Gaudencio B. Cardinal Rosales
Marco Cé	cardinalName	Marco Cé
Josip Bozanić	cardinalName	Josip Bozanić
Marian Jaworski	cardinalName	Marian Jaworski
Joachim Meisner	cardinalName	Joachim Meisner
Renato Martino	cardinalName	Renato Martino
Salvatore De Giorgi	cardinalName	Salvatore De Giorgi
Julián Herranz Casado	cardinalName	Julián Herranz Casado
Miguel Obando y Bravo	cardinalName	Miguel Obando y Bravo
Vinko Puljić	cardinalName	Vinko Puljić
Adam Kozłowiecki	cardinalName	Adam Cardinal Kozłowiecki
Henryk Gulbinowicz	cardinalName	Henryk Gulbinowicz
Wilfrid Napier	cardinalName	Wilfrid Fox Napier
Telesphore Toppo	cardinalName	Telesphore Placidus Toppo
Jean-Louis Tauran	cardinalName	Jean-Louis Tauran
Javier Lozano Barragán	cardinalName	Javier Lozano Barragán
Adrianus Johannes Simonis	cardinalName	Adrianus Johannes Simonis
Ricardo Vidal	cardinalName	Ricardo J. Vidal
Antonio María Rouco Varela	cardinalName	Antonio Rouco Varela
José Saraiva Martins	cardinalName	José Saraiva Martins
Ernesto Corripio y Ahumada	cardinalName	Ernesto Corripio Ahumada
John Wu	cardinalName	John Wu
Johannes de Jong	cardinalName	Johannes de Jong
Seán Brady	cardinalName	Seán Brady
Julius Döpfner	cardinalName	Julius Döpfner
Franjo Šeper	cardinalName	Franjo Šeper
Jean-Marie Villot	cardinalName	Jean-Marie Villot
Rufino Santos	cardinalName	Rufino J. Cardinal Santos
Julio Rosales	cardinalName	Julio Rosales y Ras
Jose Tomas Sanchez	cardinalName	Jose Tomas Sanchez
Patrick O'Boyle	cardinalName	Patrick O'Boyle
Willem Marinus van Rossum	cardinalName	Willem van Rossum
John Wright	cardinalName	John Joseph Wright
Lucien Bonaparte	cardinalName	Lucien Cardinal Bonaparte
Pio Taofinu'u	cardinalName	Pio Taofinu'u
John Carberry	cardinalName	John Joseph Carberry
Paulo Evaristo Arns	cardinalName	Paulo Evaristo Arns
Timothy Manning	cardinalName	Timothy Manning
Jean-Pierre Ricard	cardinalName	Jean-Pierre Ricard
Jorge Liberato Urosa Savino	cardinalName	Jorge Urosa Savino
Nicolas Cheong Jin-suk	cardinalName	Nicholas Cheong Jin-Suk
Antonio Quarracino	cardinalName	Antonio Quarracino
Joseph Wendel	cardinalName	Joseph Wendel
Leonardo Sandri	cardinalName	Leonardo Sandri
Josyf Slipyj	cardinalName	Josyf Slipyj
Albert Vanhoye	cardinalName	Albert Vanhoye, SJ
Lawrence Shehan	cardinalName	Lawrence Shehan
Eugène Tisserant	cardinalName	Eugène Tisserant
Angelo Bagnasco	cardinalName	Angelo Bagnasco
Alfons Maria Stickler	cardinalName	Alfons Maria Stickler
Louis-Nazaire Bégin	cardinalName	Louis-Nazaire Bégin
Jean-Marie-Rodrigue Villeneuve	cardinalName	Jean-Marie-Rodrigue Villeneuve
Antonio José González Zumárraga	cardinalName	Antonio González Zumárraga
Désiré-Joseph Mercier	cardinalName	Désiré-Joseph Mercier
Leo Joseph Suenens	cardinalName	Leo Jozef Suenens
John Patrick Foley	cardinalName	John Foley
Luigi de Magistris	cardinalName	Luigi De Magistris
William Levada	cardinalName	William Joseph Levada
Eugênio Sales	cardinalName	Eugênio de Araújo Sales
Giulio Maria della Somaglia	cardinalName	Giulio Maria della Somaglia
Aloísio Lorscheider	cardinalName	Aloísio Lorscheider
Giovanni Cheli	cardinalName	Giovanni Cheli
Corrado Ursi	cardinalName	Corrado Ursi
Thomas Christopher Collins	cardinalName	Thomas Christopher Collins
James Charles McGuigan	cardinalName	James Charles McGuigan
Paolo Romeo	cardinalName	Paolo Romeo
Oswald Gracias	cardinalName	Oswald Gracias
Eduardo Martínez Somalo	cardinalName	Eduardo Martínez Somalo
Kazimierz Nycz	cardinalName	Kazimierz Nycz
Benedetto Aloisi Masella	cardinalName	Benedetto Aloisi Masella
Maurice Feltin	cardinalName	Maurice Feltin
Jean Marie Balland	cardinalName	Jean Marie Balland
Alfred Bengsch	cardinalName	Alfred Bengsch
Camillo Caccia Dominioni	cardinalName	Camillo Caccia-Dominioni
Francesco Battaglini	cardinalName	Francesco Battaglini
Enrique Pla y Deniel	cardinalName	Enrique Pla y Deniel
Pietro Respighi	cardinalName	Pietro Respighi
Mauro Piacenza	cardinalName	Mauro Piacenza
Juan Guevara	cardinalName	Juan Gualberto Guevara
Odilo Scherer	cardinalName	Odilo Scherer
Gabriel Acacius Coussa	cardinalName	Gabriel Acacius Coussa
François Marty	cardinalName	François Marty
Emmanuel Célestin Suhard	cardinalName	Emmanuel Suhard
Manuel Arteaga y Betancourt	cardinalName	Manuel Arteaga y Betancourt
Fernando Filoni	cardinalName	Fernando Filoni
Giovanni Panico	cardinalName	Giovanni Panico
Paul Yü Pin	cardinalName	Paul Yü Pin
Raffaele Farina	cardinalName	Raffaele Farina
Kurt Koch	cardinalName	Kurt Koch
Antonio Riberi	cardinalName	Antonio Riberi
José Sebastião de Almeida Neto	cardinalName	José Sebastião de Almeida Neto
Malcolm Ranjith	cardinalName	Albert Malcolm Ranjith
Francisco Robles Ortega	cardinalName	Francisco Robles Ortega
Théodore-Adrien Sarr	cardinalName	Théodore-Adrien Sarr
Paul Josef Cordes	cardinalName	Paul Cordes
Stanisław Ryłko	cardinalName	Stanisław Cardinal Ryłko
Agustín García-Gasco Vicente	cardinalName	Agustín García-Gasco Vicente
Lluís Martínez Sistach	cardinalName	Lluís Martínez Sistach
Gianfranco Ravasi	cardinalName	Gianfranco Ravasi
Urbano Navarrete Cortés	cardinalName	Urbano Navarrete Cortés
Estanislao Esteban Karlic	cardinalName	Estanislao Karlic
Reinhard Marx	cardinalName	Reinhard Marx
Giuseppe Mori	cardinalName	Giuseppe Mori
Ernesto Civardi	cardinalName	Ernesto Civardi
Francesco Borgongini Duca	cardinalName	Francesco Borgongini Duca
Baselios Cleemis	cardinalName	Baselios Cardinal Cleemis
Gaspard Mermillod	cardinalName	Gaspard Mermillod
Fortunato Baldelli	cardinalName	Fortunato Baldelli
Giuseppe Casoria	cardinalName	Giuseppe Casoria
Elio Sgreccia	cardinalName	Elio Sgreccia
Rubén Salazar Gómez	cardinalName	Rubén  Salazar Gómez
Robert Sarah	cardinalName	Robert Sarah
Paolo Sardi	cardinalName	Paolo Sardi
Walter Brandmüller	cardinalName	Walter Brandmüller
Domenico Bartolucci	cardinalName	Domenico Bartolucci
Luis Aponte Martínez	cardinalName	Luis Aponte Martínez
Lucian Mureșan	cardinalName	Lucian Mureșan
Raymundo Damasceno Assis	cardinalName	Raymundo Damasceno Assis
George Alencherry	cardinalName	George Alencherry
Luis Antonio Tagle	cardinalName	Luis Antonio Tagle
Jacques-Marie-Adrien-Césaire Mathieu	cardinalName	Jacques-Marie-Adrien-Césaire Mathieu
Pierre de Foix, le vieux	cardinalName	Peter of Foix
Joseph-Marie Trịnh Văn Căn	cardinalName	Joseph-Marie Trịnh Văn Căn
José Luis Lacunza Maestrojuán	cardinalName	José Luis Lacunza Maestrojuán, O.A.R.
