Looney Tunes	cartoonName	Looney Tunes
Duck Amuck	cartoonName	Duck Amuck
Gerald McBoing-Boing	cartoonName	Gerald McBoing-Boing
Magical Maestro	cartoonName	Magical Maestro
Porky in Wackyland	cartoonName	Porky in Wackyland
Snow-White	cartoonName	Betty Boop in Snow-White
What's Opera, Doc%3F	cartoonName	What's Opera, Doc?
The Wise Little Hen	cartoonName	The Wise Little Hen
Merrie Melodies	cartoonName	Merrie Melodies
One Froggy Evening	cartoonName	One Froggy Evening
Knighty Knight Bugs	cartoonName	Knighty Knight Bugs
Coal Black and de Sebben Dwarfs	cartoonName	Coal Black and de Sebben Dwarfs
Pigs in a Polka	cartoonName	Pigs in a Polka
The Dot and the Line	cartoonName	The Dot and the Line
The Dot and the Line	cartoonName	(A Romance in Lower Mathematics)
Donald's Cousin Gus	cartoonName	Donald's Cousin Gus
The Pink Phink	cartoonName	The Pink Phink
Rebel Rabbit	cartoonName	Rebel Rabbit
Catty Cornered	cartoonName	Catty Cornered
Golden Yeggs	cartoonName	Golden Yeggs
The Unmentionables	cartoonName	The Unmentionables
Bugsy and Mugsy	cartoonName	Bugsy and Mugsy
Robin Hood Daffy	cartoonName	Robin Hood Daffy
Mr. Duck Steps Out	cartoonName	Mr. Duck Steps Out
Runaway Brain	cartoonName	Runaway Brain
The Cat Concerto	cartoonName	The Cat Concerto
Knock Knock	cartoonName	Knock Knock
Porky's Duck Hunt	cartoonName	Porky's Duck Hunt
Duck Dodgers in the 24½th Century	cartoonName	Duck Dodgers in the 24½th Century
Bosko, the Talk-Ink Kid	cartoonName	Bosko, the Talk-Ink Kid
The Dover Boys	cartoonName	\
The Coo-Coo Nut Grove	cartoonName	The Coo-Coo Nut Grove
House Hunting Mice	cartoonName	House Hunting Mice
Rhapsody Rabbit	cartoonName	Rhapsody Rabbit
Bugs Bunny Nips the Nips	cartoonName	\
Gold Rush Daze	cartoonName	Gold Rush Daze
Fresh Hare	cartoonName	Fresh Hare
Hot Cross Bunny	cartoonName	Hot Cross Bunny
Bugs Bunny Gets the Boid	cartoonName	Bugs Bunny Gets the Boid
Hillbilly Hare	cartoonName	Hillbilly Hare
Southern Fried Rabbit	cartoonName	Southern Fried Rabbit
Scaredy Cat	cartoonName	Scaredy Cat
Pop 'im Pop!	cartoonName	Pop 'Im Pop!
The Mouse-Merized Cat	cartoonName	The Mouse-Merized Cat
Porky's Badtime Story	cartoonName	Porky's Badtime Story
Tweetie Pie	cartoonName	Tweetie Pie
A Tale of Two Kitties	cartoonName	A Tale of Two Kitties
Mouse Menace	cartoonName	Mouse Menace
Hare Brush	cartoonName	Hare Brush
Porky's Hare Hunt	cartoonName	Porky's Hare Hunt
Falling Hare	cartoonName	Falling Hare
I Haven't Got a Hat	cartoonName	I Haven't Got a Hat
Rabbit Fire	cartoonName	Rabbit Fire
Pigs Is Pigs	cartoonName	Pigs is Pigs
Tortoise Beats Hare	cartoonName	Tortoise Beats Hare
Noveltoons	cartoonName	Noveltoons
Tortoise Wins by a Hare	cartoonName	Tortoise Wins by a Hare
Hell-Bent for Election	cartoonName	Hell-Bent For Election
The Yankee Doodle Mouse	cartoonName	The Yankee Doodle Mouse
Popeye the Sailor Meets Sindbad the Sailor	cartoonName	Popeye Meets Sindbad the Sailor
Popeye the Sailor Meets Ali Baba's Forty Thieves	cartoonName	Popeye the Sailor Meets Ali Baba's Forty Thieves
Aladdin and His Wonderful Lamp	cartoonName	Aladdin and His Wonderful Lamp
A Wild Hare	cartoonName	A Wild Hare
Elmer's Pet Rabbit	cartoonName	Elmer's Pet Rabbit
Hiawatha's Rabbit Hunt	cartoonName	Hiawatha's Rabbit Hunt
The Heckling Hare	cartoonName	The Heckling Hare
Wabbit Twouble	cartoonName	Wabbit Twouble
Hold the Lion, Please	cartoonName	Hold the Lion, Please
Super-Rabbit	cartoonName	Super-Rabbit
The Night Watchman	cartoonName	The Night Watchman
Prest-O Change-O	cartoonName	Prest-O Change-O
Elmer's Candid Camera	cartoonName	Elmer's Candid Camera
Balloon Land	cartoonName	Balloon Land
I Love to Singa	cartoonName	I Love to Singa
Bully for Bugs	cartoonName	Bully for Bugs
Puss Gets the Boot	cartoonName	Puss Gets the Boot
Solid Serenade	cartoonName	Solid Serenade
Johann Mouse	cartoonName	Johann Mouse
The Bear That Wasn't	cartoonName	The Bear That Wasn't
Sunday Go to Meetin' Time	cartoonName	Sunday Go to Meetin' Time
Clean Pastures	cartoonName	Clean Pastures
The Isle of Pingo Pongo	cartoonName	The Isle of Pingo Pongo
Angel Puss	cartoonName	Angel Puss
Tin Pan Alley Cats	cartoonName	Tin Pan Alley Cats
Uncle Tom's Bungalow	cartoonName	Uncle Tom's Bungalow
Goldilocks and the Jivin' Bears	cartoonName	Goldilocks and the Jivin' Bears
What's Up, Doc%3F	cartoonName	What's Up, Doc?
Birds Anonymous	cartoonName	Birds Anonymous
The Two Mouseketeers	cartoonName	The Two Mouseketeers
She Was an Acrobat's Daughter	cartoonName	She Was an Acrobat's Daughter
Rabbit Seasoning	cartoonName	Rabbit Seasoning
Hare Trigger	cartoonName	Hare Trigger
Mayavi	cartoonName	Mayavi
Muscle Tussle	cartoonName	Muscle Tussle
Race Riot	cartoonName	Race Riot
Trolley Troubles	cartoonName	Trolley Troubles
All This and Rabbit Stew	cartoonName	All This and Rabbit Stew
Yankee Dood It	cartoonName	Yankee Dood It
Duck! Rabbit, Duck!	cartoonName	Duck! Rabbit, Duck!
Brave Little Tailor	cartoonName	Brave Little Tailor
The Great Piggy Bank Robbery	cartoonName	The Great Piggy Bank Robbery
Adventures of the Road Runner	cartoonName	Adventures of the Road Runner
Long-Haired Hare	cartoonName	Long-Haired Hare
High Diving Hare	cartoonName	High Diving Hare
Drip-Along Daffy	cartoonName	Drip-Along Daffy
Dough for the Do-Do	cartoonName	Dough for the Do-Do
Ballot Box Bunny	cartoonName	Ballot Box Bunny
The Scarlet Pumpernickel	cartoonName	The Scarlet Pumpernickel
Big Top Bunny	cartoonName	Big Top Bunny
Yankee Doodle Daffy	cartoonName	Yankee Doodle Daffy
Bugs Bunny and the Three Bears	cartoonName	Bugs Bunny and the Three Bears
Awful Orphan	cartoonName	Awful Orphan
Hair-Raising Hare	cartoonName	Hair-Raising Hare
Frigid Hare	cartoonName	Frigid Hare
Canary Row	cartoonName	Canary Row
Bunny Hugged	cartoonName	Bunny Hugged
For Scent-imental Reasons	cartoonName	For Scent-imental Reasons
Bugs Bunny Rides Again	cartoonName	Bugs Bunny Rides Again
French Rarebit	cartoonName	French Rarebit
Porky Chops	cartoonName	Porky Chops
No Smoking	cartoonName	No Smoking
How to Swim	cartoonName	How to Swim
Hockey Homicide	cartoonName	Hockey Homicide
Oily Hare	cartoonName	Oily Hare
Scrub Me Mama with a Boogie Beat	cartoonName	Scrub Me Mama with a Boogie Beat
Rabbit Hood	cartoonName	Rabbit Hood
To Beep or Not to Beep	cartoonName	To Beep or Not to Beep
Mouse Trouble	cartoonName	Mouse Trouble
Cat-Tails for Two	cartoonName	Cat-Tails for Two
Broom-Stick Bunny	cartoonName	Broom-Stick Bunny
Lady, Play Your Mandolin!	cartoonName	Lady, Play Your Mandolin!
The Old Grey Hare	cartoonName	The Old Grey Hare
A Corny Concerto	cartoonName	A Corny Concerto
Dog Pounded	cartoonName	Dog Pounded
Tweety and the Beanstalk	cartoonName	Tweety and the Beanstalk
Donald and Pluto	cartoonName	Donald and Pluto
Transylvania 6-5000	cartoonName	Transylvania 6-5000
Ducking the Devil	cartoonName	Ducking the Devil
Herr Meets Hare	cartoonName	Herr Meets Hare
Tick Tock Tuckered	cartoonName	Tick Tock Tuckered
Quiet Please!	cartoonName	Quiet Please!
The Little Whirlwind	cartoonName	The Little Whirlwind
Donald's Golf Game	cartoonName	Donald's Golf Game
Thru the Mirror	cartoonName	Thru the Mirror
Slick Hare	cartoonName	Slick Hare
Little Red Riding Rabbit	cartoonName	Little Red Riding Rabbit
Gorilla My Dreams	cartoonName	Gorilla My Dreams
Wackiki Wabbit	cartoonName	Wackiki Wabbit
Big House Bunny	cartoonName	Big House Bunny
Motor Mania	cartoonName	Motor Mania
Hare Tonic	cartoonName	Hare Tonic
The Wabbit Who Came to Supper	cartoonName	The Wabbit Who Came to Supper
Katnip Kollege	cartoonName	Katnip Kollege
Pecos Pest	cartoonName	Pecos Pest
Jerry's Cousin	cartoonName	Jerry's Cousin
Mucho Mouse	cartoonName	Mucho Mouse
Bunker Hill Bunny	cartoonName	Bunker Hill Bunny
Deduce, You Say!	cartoonName	Deduce, You Say!
Daffy Duck and the Dinosaur	cartoonName	Daffy Duck and the Dinosaur
Fraidy Cat	cartoonName	Fraidy Cat
The Little Orphan	cartoonName	The Little Orphan
Dr. Jekyll and Mr. Mouse	cartoonName	Dr. Jekyll and Mr. Mouse
Jeepers Creepers	cartoonName	Jeepers Creepers
8 Ball Bunny	cartoonName	8
Homeless Hare	cartoonName	\
Pent-House Mouse	cartoonName	Pent-House Mouse
Daffy Duck's Fantastic Island	cartoonName	Daffy Duck's Fantastic Island
Mississippi Hare	cartoonName	Mississippi Hare
Baby Buggy Bunny	cartoonName	Baby Buggy Bunny
Mutiny on the Bunny	cartoonName	Mutiny on the Bunny
Hoppy Go Lucky	cartoonName	Hoppy Go Lucky
King-Size Canary	cartoonName	King-Size Canary
Ali Baba Bunny	cartoonName	Ali Baba Bunny
Wet Hare	cartoonName	Wet Hare
Hollywood Steps Out	cartoonName	Hollywood Steps Out
Heavenly Puss	cartoonName	Heavenly Puss
Daffy Duck & Egghead	cartoonName	Daffy Duck and Egghead
Quentin Quail	cartoonName	Quentin Quail
Carrotblanca	cartoonName	Carrotblanca
Toby Tortoise Returns	cartoonName	Toby Tortoise Returns
The Old Man of the Mountain	cartoonName	The Old Man of the Mountain
Hare Force	cartoonName	Hare Force
Bushy Hare	cartoonName	Bushy Hare
Bonanza Bunny	cartoonName	Bonanza Bunny
Mouse in Manhattan	cartoonName	Mouse in Manhattan
A Feather in His Hare	cartoonName	A Feather in His Hare
Kitty Foiled	cartoonName	Kitty Foiled
The Spirit of '43	cartoonName	The Spirit of '43
Operation: Rabbit	cartoonName	Operation: Rabbit
The Midnight Snack	cartoonName	The Midnight Snack
You're an Education	cartoonName	You're An Education
Feedin' the Kiddie	cartoonName	Feedin' the Kiddie
Hare Remover	cartoonName	Hare Remover
Little Red Walking Hood	cartoonName	Little Red Walking Hood
Russian Rhapsody	cartoonName	Russian Rhapsody
Hatch Up Your Troubles	cartoonName	Hatch Up Your Troubles
What's Cookin' Doc%3F	cartoonName	What's Cookin' Doc?
Buccaneer Bunny	cartoonName	Buccaneer Bunny
Stage Door Cartoon	cartoonName	Stage Door Cartoon
Tale of Two Mice	cartoonName	Tale Of Two Mice
Jack-Wabbit and the Beanstalk	cartoonName	Jack-Wabbit and the Beanstalk
Aviation Vacation	cartoonName	Aviation Vacation
Rabbit's Kin	cartoonName	Rabbit's Kin
The First Bad Man	cartoonName	The First Bad Man
Sleepy-Time Tom	cartoonName	Sleepy-Time Tom
The Night Before Christmas	cartoonName	The Night Before Christmas
Polka-Dot Puss	cartoonName	Polka-Dot Puss
Walky Talky Hawky	cartoonName	Walky Talky Hawky
I Taw a Putty Tat	cartoonName	I Taw a Putty Tat
Roman Legion-Hare	cartoonName	Roman Legion-Hare
The Wearing of the Grin	cartoonName	The Wearing of the Grin
Thugs with Dirty Mugs	cartoonName	Thugs with Dirty Mugs
Touché, Pussy Cat!	cartoonName	Touché, Pussy Cat!
Hic-cup Pup	cartoonName	Hic-cup Pup
Cat and Dupli-cat	cartoonName	Cat and Dupli-cat
The Pink Blueprint	cartoonName	The Pink Blueprint
Case of the Missing Hare	cartoonName	Case of the Missing Hare
A Hare Grows in Manhattan	cartoonName	A Hare Grows in Manhattan
Popeye the Sailor	cartoonName	Popeye the Sailor
Stopping the Show	cartoonName	Stopping the Show
Betty Boop's Bamboo Isle	cartoonName	Betty Boop's Bamboo Isle
Daffy Duck Slept Here	cartoonName	Daffy Duck Slept Here
The Wild Chase	cartoonName	The Wild Chase
My Friend the Monkey	cartoonName	My Friend the Monkey
Riding the Rails	cartoonName	Riding the Rails
Making Friends	cartoonName	Making Friends
Happy You and Merry Me	cartoonName	Happy You and Merry Me
Pudgy Takes a Bow-Wow	cartoonName	Pudgy Takes a Bow-Wow
Ding Dong Doggie	cartoonName	Ding Dong Doggie
The Swing School	cartoonName	Betty Boop in the Swing School
Yip Yip Yippy	cartoonName	Yip Yip Yippy
Rhythm on the Reservation	cartoonName	Rhythm on the Reservation
Swim or Sink	cartoonName	Swim Or Sink
The Unruly Hare	cartoonName	The Unruly Hare
Hare Conditioned	cartoonName	Hare Conditioned
Be Human	cartoonName	Be Human
A Song a Day	cartoonName	A Song a Day
Betty Boop's Crazy Inventions	cartoonName	Betty Boop's Crazy Inventions
Chess-Nuts	cartoonName	Chess-Nuts
Stop That Noise	cartoonName	Stop That Noise
Swat the Fly	cartoonName	Swat The Fly
Not Now	cartoonName	Not Now
Musical Mountaineers	cartoonName	Musical Mountaineers
Betty in Blunderland	cartoonName	Betty in Blunderland
Parade of the Wooden Soldiers	cartoonName	Parade of the Wooden Soldiers
She Wronged Him Right	cartoonName	She Wronged Him Right
Out of the Inkwell	cartoonName	Out of the Inkwell
Betty Boop's Rise to Fame	cartoonName	Betty Boop's Rise to Fame
Betty Boop's Bizzy Bee	cartoonName	Betty Boop's Bizzy Bee
Betty Boop, M.D.	cartoonName	Betty Boop, M.D.
Betty Boop's Ups and Downs	cartoonName	Betty Boop's Ups and Downs
Betty Boop for President	cartoonName	Betty Boop for President
Betty Boop's Ker-Choo	cartoonName	Betty Boop's Ker-Choo
Betty Boop's Museum	cartoonName	Betty Boop's Museum
I'll Be Glad When You're Dead You Rascal You	cartoonName	I'll Be Glad When You're Dead
I'll Be Glad When You're Dead You Rascal You	cartoonName	You Rascal You
Is My Palm Read	cartoonName	Is My Palm Read
Betty Boop's Penthouse	cartoonName	Betty Boop's Penthouse
I Heard	cartoonName	I Heard
Morning, Noon and Night	cartoonName	Morning, Noon and Night
The Wacky Wabbit	cartoonName	The Wacky Wabbit
Barnacle Bill	cartoonName	Barnacle Bill
Cheese Chasers	cartoonName	Cheese Chasers
Gift Wrapped	cartoonName	Gift Wrapped
Poor Cinderella	cartoonName	Poor Cinderella
The Impractical Joker	cartoonName	The Impractical Joker
A Little Soap and Water	cartoonName	A Little Soap and Water
Dixieland Droopy	cartoonName	Dixieland Droopy
Baby Be Good	cartoonName	Baby Be Good
Betty Boop's Birthday Party	cartoonName	Betty Boop's Birthday Party
Betty Boop's Hallowe'en Party	cartoonName	Betty Boop's Hallowe'en Party
Betty Boop's Big Boss	cartoonName	Betty Boop's Big Boss
Mother Goose Land	cartoonName	Mother Goose Land
Red Hot Mamma	cartoonName	Red Hot Mamma
Ha! Ha! Ha!	cartoonName	Ha! Ha! Ha!
There's Something About a Soldier	cartoonName	There's Something About a Soldier
Keep in Style	cartoonName	Keep in Style
When My Ship Comes In	cartoonName	When My Ship Comes In
Betty Boop and the Little King	cartoonName	Betty Boop and the Little King
Making Stars	cartoonName	Making Stars
Betty Boop and Grampy	cartoonName	Betty Boop and Grampy
A Language All My Own	cartoonName	A Language All My Own
No! No! A Thousand Times No!!	cartoonName	No! No! A Thousand Times No!!
Judge for a Day	cartoonName	Judge for a Day
Betty Boop with Henry, the Funniest Living American	cartoonName	Betty Boop with Henry,
Betty Boop with Henry, the Funniest Living American	cartoonName	the Funniest Living American
Little Nobody	cartoonName	Little Nobody
More Pep	cartoonName	More Pep
House Cleaning Blues	cartoonName	House Cleaning Blues
Betty Boop's Trial	cartoonName	Betty Boop's Trial
Zula Hula	cartoonName	Zula Hula
Taking the Blame	cartoonName	Taking the Blame
Whoops! I'm a Cowboy	cartoonName	Whoops! I'm a Cowboy
The Hot Air Salesman	cartoonName	The Hot Air Salesman
Betty Boop's May Party	cartoonName	Betty Boop's May Party
Betty Boop's Life Guard	cartoonName	Betty Boop's Life Guard
Betty Boop and Little Jimmy	cartoonName	Betty Boop and Little Jimmy
Let's Sing with Popeye	cartoonName	Let's Sing With Popeye
Betty Boop's Little Pal	cartoonName	Betty Boop's Little Pal
Betty Boop's Prize Show	cartoonName	Betty Boop's Prize Show
	cartoonName	Bunny
Hare Ribbin'	cartoonName	Hare Ribbin'
The Bashful Buzzard	cartoonName	The Bashful Buzzard
Porky's Poultry Plant	cartoonName	Porky's Poultry Plant
Timber	cartoonName	Timber
From A to Z-Z-Z-Z	cartoonName	From A to Z-Z-Z-Z
Conrad the Sailor	cartoonName	Conrad the Sailor
Tot Watchers	cartoonName	Tot Watchers
Brother Brat	cartoonName	Brother Brat
Beanstalk Bunny	cartoonName	Beanstalk Bunny
Dr. Devil and Mr. Hare	cartoonName	Dr. Devil and Mr. Hare
Hare We Go	cartoonName	Hare We Go
From Hare to Heir	cartoonName	From Hare to Heir
Mad as a Mars Hare	cartoonName	Mad as a Mars Hare
The Abominable Snow Rabbit	cartoonName	The Abominable Snow Rabbit
My Bunny Lies over the Sea	cartoonName	My Bunny Lies over the Sea
Old Macdonald Had A Farm	cartoonName	Old MacDonald Had a Farm
Bimbo's Initiation	cartoonName	Bimbo's Initiation
Rooty Toot Toot	cartoonName	Rooty Toot Toot
Purr-Chance to Dream	cartoonName	The Purr-Chance to Dream
Cannery Rodent	cartoonName	Cannery Rodent
Switchin' Kitten	cartoonName	Switchin' Kitten
Baby Puss	cartoonName	Baby Puss
Sufferin' Cats!	cartoonName	Sufferin' Cats!
Carmen Get It!	cartoonName	Carmen Get It!
Bad Day at Cat Rock	cartoonName	A Bad Day at Cat Rock
The Great De Gaulle Stone Operation	cartoonName	The Great De Gaulle Stone Operation
Tabasco Road	cartoonName	Tabasco Road
The Stupid Cupid	cartoonName	The Stupid Cupid
The Zoot Cat	cartoonName	The Zoot Cat
The Bodyguard	cartoonName	The Bodyguard
Tee for Two	cartoonName	Tee for Two
Have You Got Any Castles%3F	cartoonName	Have You Got Any Castles?
Porky's Spring Planting	cartoonName	Porky's Spring Planting
The Blow Out	cartoonName	The Blow Out
Dog Trouble	cartoonName	Dog Trouble
Toot, Whistle, Plunk and Boom	cartoonName	Toot, Whistle, Plunk, and Boom
Puss n' Toots	cartoonName	Puss n' Toots
The Bowling Alley Cat	cartoonName	The Bowling Alley Cat
Salt Water Tabby	cartoonName	Salt Water Tabby
Part Time Pal	cartoonName	Part Time Pal
Blitz Wolf	cartoonName	Blitz Wolf
The Cat and the Mermouse	cartoonName	The Cat and the Mermouse
Mice Follies	cartoonName	Mice Follies
Jerry and the Lion	cartoonName	Jerry and the Lion
The Flying Sorceress	cartoonName	The Flying Sorceress
Catty-Cornered	cartoonName	Catty-Cornered
Two Little Indians	cartoonName	Two Little Indians
Mouse Cleaning	cartoonName	Mouse Cleaning
Flirty Birdy	cartoonName	Flirty Birdy
The Milky Waif	cartoonName	The Milky Waif
Cat Fishin'	cartoonName	Cat Fishin'
The Truce Hurts	cartoonName	The Truce Hurts
Safety Second	cartoonName	Safety Second
Pantry Panic	cartoonName	Pantry Panic
High Steaks	cartoonName	High Steaks
His Mouse Friday	cartoonName	His Mouse Friday
Landing Stripling	cartoonName	Landing Stripling
Springtime for Thomas	cartoonName	Springtime for Thomas
Rock 'n' Rodent	cartoonName	Rock 'n' Rodent
Nit-Witty Kitty	cartoonName	Nit-Witty Kitty
Puttin' on the Dog	cartoonName	Puttin' on the Dog
Smitten Kitten	cartoonName	Smitten Kitten
Milk and Money	cartoonName	Milk and Money
Don't Look Now	cartoonName	Don't Look Now
I Only Have Eyes for You	cartoonName	I Only Have Eyes for You
Scent-imental Over You	cartoonName	Scent-imental Over You
The Mouse Comes to Dinner	cartoonName	The Mouse Comes to Dinner
Daffy – The Commando	cartoonName	Daffy – The Commando
The Invisible Mouse	cartoonName	The Invisible Mouse
Zipping Along	cartoonName	Zipping Along
Stop! Look! And Hasten!	cartoonName	Stop! Look! And Hasten!
Going! Going! Gosh!	cartoonName	Going! Going! Gosh!
Ready, Set, Zoom!	cartoonName	Ready, Set, Zoom!
Beep, Beep	cartoonName	Beep, Beep
Whoa, Be-Gone!	cartoonName	Whoa, Be-Gone!
Zoom and Bored	cartoonName	Zoom and Bored
Superman	cartoonName	Superman
The Cat Above and the Mouse Below	cartoonName	The Cat Above and the Mouse Below
Boston Quackie	cartoonName	Boston Quackie
Scrap Happy Daffy	cartoonName	Scrap Happy Daffy
Techno-Cracked	cartoonName	Techno-Cracked
Hyde and Go Tweet	cartoonName	Hyde and Go Tweet
Casanova Cat	cartoonName	Casanova Cat
Texas Tom	cartoonName	Texas Tom
Symphony in Slang	cartoonName	Symphony in Slang
Christmas Comes But Once a Year	cartoonName	Christmas Comes But Once a Year
Wideo Wabbit	cartoonName	Wideo Wabbit
Don's Fountain of Youth	cartoonName	Don's Fountain of Youth
Life with Tom	cartoonName	Life with Tom
Surf-Bored Cat	cartoonName	Surf-Bored Cat
A Mouse in the House	cartoonName	A Mouse in the House
Jerry and Jumbo	cartoonName	Jerry and Jumbo
Boobs in the Woods	cartoonName	Boobs in the Woods
Tweety's S.O.S.	cartoonName	Tweety's S.O.S.
The Barber of Seville	cartoonName	The Barber of Seville
Rabbitson Crusoe	cartoonName	Rabbitson Crusoe
The Hasty Hare	cartoonName	The Hasty Hare
My Little Duckaroo	cartoonName	My Little Duckaroo
Rocket Squad	cartoonName	Rocket Squad
The Missing Mouse	cartoonName	The Missing Mouse
Fine Feathered Friend	cartoonName	Fine Feathered Friend
The Dog House	cartoonName	The Dog House
Shutter Bugged Cat	cartoonName	Shutter Bugged Cat
The Lonesome Mouse	cartoonName	The Lonesome Mouse
Trap Happy	cartoonName	Trap Happy
Lighter Than Hare	cartoonName	Lighter Than Hare
Hare Splitter	cartoonName	Hare Splitter
Captain Hareblower	cartoonName	Captain Hareblower
Piker's Peak	cartoonName	Piker's Peak
Professor Tom	cartoonName	Professor Tom
Old Rockin' Chair Tom	cartoonName	Old Rockin' Chair Tom
Triplet Trouble	cartoonName	Triplet Trouble
Baby Butch	cartoonName	Baby Butch
Designs on Jerry	cartoonName	Designs on Jerry
Rabbit Punch	cartoonName	Rabbit Punch
Rabbit Transit	cartoonName	Rabbit Transit
Mouse for Sale	cartoonName	Mouse for Sale
Love That Pup	cartoonName	Love That Pup
Tops with Pops	cartoonName	Tops with Pops
Slicked-up Pup	cartoonName	Slicked-up Pup
Mice Follies	cartoonName	Mice Follies
The Lion's Busy	cartoonName	The Lion's Busy
The Egg and Jerry	cartoonName	The Egg and Jerry
The Cat's Me-Ouch!	cartoonName	The Cat's Me-Ouch
Tennis Chumps	cartoonName	Tennis Chumps
Little Runaway	cartoonName	Little Runaway
Strife with Father	cartoonName	Strife with Father
Push-Button Kitty	cartoonName	Push-Button Kitty
Jerry's Diary	cartoonName	Jerry's Diary
The Magnetic Telescope	cartoonName	Magnetic Telescope
Japoteurs	cartoonName	Japoteurs
The Mechanical Monsters	cartoonName	The Mechanical Monsters
Cat Napping	cartoonName	Cat Napping
The Arctic Giant	cartoonName	The Arctic Giant
Billion Dollar Limited	cartoonName	Billion Dollar Limited
The Bulleteers	cartoonName	The Bulleteers
Electric Earthquake	cartoonName	Electric Earthquake
Fit to Be Tied	cartoonName	Fit to Be Tied
Volcano	cartoonName	Volcano
Smarty Cat	cartoonName	Smarty Cat
Puppy Tale	cartoonName	Puppy Tale
Terror on the Midway	cartoonName	Terror on the Midway
Tom and Jerry in the Hollywood Bowl	cartoonName	Tom and Jerry in the Hollywood Bowl
I Yam What I Yam	cartoonName	I Yam What I Yam
Pet Peeve	cartoonName	Pet Peeve
Saturday Evening Puss	cartoonName	Saturday Evening Puss
That's My Mommy	cartoonName	That's My Mommy
Cruise Cat	cartoonName	Cruise Cat
Busy Buddies	cartoonName	Busy Buddies
Down and Outing	cartoonName	Down and Outing
Mouse into Space	cartoonName	Mouse into Space
The Framed Cat	cartoonName	The Framed Cat
Neapolitan Mouse	cartoonName	Neapolitan Mouse
Robin Hoodwinked	cartoonName	Robin Hoodwinked
Give and Tyke	cartoonName	Give and Tyke
Cue Ball Cat	cartoonName	Cue Ball Cat
Timid Tabby	cartoonName	Timid Tabby
Matinee Mouse	cartoonName	Matinee Mouse
Tom's Photo Finish	cartoonName	Tom's Photo Finish
Barbecue Brawl	cartoonName	Barbecue Brawl
Little Quacker	cartoonName	Little Quacker
The Flying Cat	cartoonName	The Flying Cat
The Mouse from H.U.N.G.E.R.	cartoonName	The Mouse from H.U.N.G.E.R.
Happy Go Ducky	cartoonName	Happy Go Ducky
The Vanishing Duck	cartoonName	The Vanishing Duck
Scat Cats	cartoonName	Scat Cats
My Green Fedora	cartoonName	My Green Fedora
Downhearted Duckling	cartoonName	Downhearted Duckling
Blue Cat Blues	cartoonName	Blue Cat Blues
Just Ducky	cartoonName	Just Ducky
Tom and Chérie	cartoonName	Tom and Chérie
Southbound Duckling	cartoonName	Southbound Duckling
The Duck Doctor	cartoonName	The Duck Doctor
Jerry and the Goldfish	cartoonName	Jerry and the Goldfish
The Friendly Ghost	cartoonName	The Friendly Ghost
Pup on a Picnic	cartoonName	Pup on a Picnic
That's My Pup!	cartoonName	That's My Pup!
Muscle Beach Tom	cartoonName	Muscle Beach Tom
Back Alley Oproar	cartoonName	Back Alley Oproar
Satan's Waitin'	cartoonName	Satan's Waitin'
Little School Mouse	cartoonName	Little School Mouse
Advance and Be Mechanized	cartoonName	Advance and Be Mechanized
O-Solar Meow	cartoonName	O-Solar-Meow
Of Feline Bondage	cartoonName	Of Feline Bondage
I'm Just Wild About Jerry	cartoonName	I'm Just Wild About Jerry
Guided Mouse-ille	cartoonName	A Guided Mouse-ille
Duel Personality	cartoonName	Duel Personality
Posse Cat	cartoonName	Posse Cat
The A-Tom-Inable Snowman	cartoonName	The A-Tom-Inable Snowman
Royal Cat Nap	cartoonName	The Royal Cat Nap
Down Beat Bear	cartoonName	Down Beat Bear
Showdown	cartoonName	Showdown
Buddies Thicker Than Water	cartoonName	Buddies Thicker Than Water
Tall in the Trap	cartoonName	Tall in the Trap
Filet Meow	cartoonName	Filet Meow
A Pest in the House	cartoonName	A Pest in the House
Spaced Out Bunny	cartoonName	Spaced-Out-Bunny
Is There a Doctor in the Mouse%3F	cartoonName	Is There a Doctor in the Mouse?
The Mummy Strikes	cartoonName	The Mummy Strikes
Hittin' the Trail for Hallelujah Land	cartoonName	Hittin' the Trail for Hallelujah Land
Snowbody Loves Me	cartoonName	Snowbody Loves Me
The Brothers Carry-Mouse-Off	cartoonName	The Brothers Carry-Mouse-Off
Double Dribble	cartoonName	Double Dribble
Person to Bunny	cartoonName	Person to Bunny
Haunted Mouse	cartoonName	Haunted Mouse
The Hare-Brained Hypnotist	cartoonName	The Hare-Brained Hypnotist
Hare Do	cartoonName	Hare Do
Porky's Pet	cartoonName	Porky's Pet
Run, Run, Sweet Road Runner	cartoonName	Run, Run, Sweet Road Runner
Jerry, Jerry, Quite Contrary	cartoonName	Jerry, Jerry, Quite Contrary
Hurdy-Gurdy Hare	cartoonName	Hurdy-Gurdy Hare
Birth of a Notion	cartoonName	Birth of a Notion
People Are Bunny	cartoonName	People Are Bunny
Duck Dodgers and the Return of the 24½th Century	cartoonName	Duck Dodgers and the
Duck Dodgers and the Return of the 24½th Century	cartoonName	Return of the 24½th Century
Get Lost	cartoonName	Get Lost
Bear Feat	cartoonName	Bear Feat
Hot Rod Huckster	cartoonName	Hot Rod Huckster
Real Gone Woody	cartoonName	Real Gone Woody
Puss 'n' Boats	cartoonName	Puss 'n' Boats
The Underground World	cartoonName	The Underground World
Jerry-Go-Round	cartoonName	Jerry-Go-Round
Jasper and the Haunted House	cartoonName	Jasper and the Haunted House
The Foghorn Leghorn	cartoonName	The Foghorn Leghorn
Feather Dusted	cartoonName	Feather Dusted
Ain't That Ducky	cartoonName	Ain't That Ducky
The Night of the Living Duck	cartoonName	The Night of the Living Duck
Rabbit Every Monday	cartoonName	Rabbit Every Monday
When Magoo Flew	cartoonName	When Magoo Flew
Feline Frame-Up	cartoonName	Feline Frame-Up
Jungle Drums	cartoonName	Jungle Drums
Swing Wedding	cartoonName	Swing Wedding
Much Ado About Mousing	cartoonName	Much Ado About Mousing
The Unshrinkable Jerry Mouse	cartoonName	The Unshrinkable Jerry Mouse
Ah, Sweet Mouse-Story of Life	cartoonName	Ah, Sweet Mouse-Story of Life
Tom-ic Energy	cartoonName	Tom-ic Energy
The Year of the Mouse	cartoonName	The Year of the Mouse
Let It Be Me	cartoonName	Let It Be Me
Bingo Crosbyana	cartoonName	Bingo Crosbyana
No Parking Hare	cartoonName	No Parking Hare
Ain't We Got Fun	cartoonName	Ain't We Got Fun
One More Time	cartoonName	One More Time
Daffy Duck Hunt	cartoonName	Daffy Duck Hunt
The Karate Guard	cartoonName	The Karate Guard
Speedy Gonzales	cartoonName	Speedy Gonzales
It's Greek to Me-ow!	cartoonName	It's Greek to Me-ow!
Baton Bunny	cartoonName	Baton Bunny
Kit for Cat	cartoonName	Kit for Cat
I'm a Big Shot Now	cartoonName	I'm a Big Shot Now
Freddy the Freshman	cartoonName	Freddy the Freshman
Calypso Cat	cartoonName	Calypso Cat
Olive Oyl for President	cartoonName	Olive Oyl for President
Dicky Moe	cartoonName	Dicky Moe
The Tom and Jerry Cartoon Kit	cartoonName	The Tom and Jerry's Cartoon Kit
Sorry Safari	cartoonName	The Sorry Safari
Daffy Doodles	cartoonName	Daffy Doodles
Love Me, Love My Mouse	cartoonName	Love Me, Love My Mouse
Bottles	cartoonName	Bottles
Forward March Hare	cartoonName	Forward March Hare
Wagon Heels	cartoonName	Wagon Heels
The Cat That Hated People	cartoonName	The Cat That Hated People
To Hare Is Human	cartoonName	To Hare is Human
Slap Happy Lion	cartoonName	Slap Happy Lion
How to Hook Up Your Home Theater	cartoonName	How to Hook Up Your Home Theater
Rabbit Romeo	cartoonName	Rabbit Romeo
Dangerous Dan McFoo	cartoonName	Dangerous Dan McFoo
The Fella with the Fiddle	cartoonName	The Fella with the Fiddle
Holiday for Shoestrings	cartoonName	Holiday for Shoestrings
A Gruesome Twosome	cartoonName	A Gruesome Twosome
Touché and Go	cartoonName	Touché and Go
Ding Dog Daddy	cartoonName	Ding Dog Daddy
Bowery Bugs	cartoonName	Bowery Bugs
What Makes Daffy Duck%3F	cartoonName	What Makes Daffy Duck
Early to Bet	cartoonName	Early To Bet
Gonzales' Tamales	cartoonName	Gonzales Tamales
Chow Hound	cartoonName	Chow Hound
Destruction, Inc.	cartoonName	Destruction, Inc.
Land of the Midnight Fun	cartoonName	Land of the Midnight Fun
It's Tough to Be a Bird	cartoonName	It's Tough to Be a Bird
Mickey and the Seal	cartoonName	Mickey and The Seal
Mickey's Delayed Date	cartoonName	Mickey's Delayed Date
Swooner Crooner	cartoonName	Swooner Crooner
Knights Must Fall	cartoonName	Knights Must Fall
Injun Trouble	cartoonName	Injun Trouble
Donald's Dilemma	cartoonName	Donald's Dilemma
Lumber Jack-Rabbit	cartoonName	Lumber Jack-Rabbit
Cheese It, the Cat!	cartoonName	Cheese It, the Cat!
Confederate Honey	cartoonName	Confederate Honey
The Ballad of Nessie	cartoonName	The Ballad Of Nessie
The Goofy Gophers	cartoonName	The Goofy Gophers
Norman Normal	cartoonName	Norman Normal
Sky Trooper	cartoonName	Sky Trooper
The Legend of Rockabye Point	cartoonName	The Legend of Rockabye Point
Porky's Last Stand	cartoonName	Porky's Last Stand
Porky's Pooch	cartoonName	Porky's Pooch
Bugs' Bonnets	cartoonName	Bugs' Bonnets
Greetings Bait	cartoonName	Greetings Bait
Crazy Cruise	cartoonName	Crazy Cruise
Farm Frolics	cartoonName	Farm Frolics
Big House Blues	cartoonName	Big House Blues
High Note	cartoonName	High Note
Shishkabugs	cartoonName	Shishkabugs
Snafuperman	cartoonName	Snafuperman
Who's Who in the Zoo	cartoonName	Who's Who in the Zoo
Canvas Back Duck	cartoonName	Canvas Back Duck
One by One	cartoonName	One by One
Robot Rabbit	cartoonName	Robot Rabbit
Notes to You	cartoonName	Notes to You
Wild Wild World	cartoonName	Wild Wild World
Bad Ol' Putty Tat	cartoonName	Bad Ol' Putty Tat
Knight-mare Hare	cartoonName	Knight-mare Hare
Everglade Raid	cartoonName	Everglade Raid
A Fine Feathered Frenzy	cartoonName	A Fine Feathered Frenzy
Convict Concerto	cartoonName	Convict Concerto
Fiddlesticks	cartoonName	Fiddlesticks
Under the Counter Spy	cartoonName	Under the Counter Spy
Belle Boys	cartoonName	Belle Boys
Alley to Bali	cartoonName	Alley to Bali
Helter Shelter	cartoonName	Helter Shelter
Jungle Jitters	cartoonName	Jungle Jitters
Ski for Two	cartoonName	Ski for Two
The Beach Nut	cartoonName	The Beach Nut
A Fractured Leghorn	cartoonName	A Fractured Leghorn
The Hep Cat	cartoonName	The Hep Cat
Hypnotic Hick	cartoonName	Hypnotic Hick
We Did It	cartoonName	We Did It
You're Not Built That Way	cartoonName	You're Not Built That Way
Training Pigeons	cartoonName	You're Not Built That Way
Wet Blanket Policy	cartoonName	Wet Blanket Policy
Born to Peck	cartoonName	Born to Peck
Felix in Hollywood	cartoonName	Felix in Hollywood
The Astroduck	cartoonName	The Astroduck
Go Go Amigo	cartoonName	Go Go Amigo
The House of Tomorrow	cartoonName	The House of Tomorrow
Swing Ding Amigo	cartoonName	Swing Ding Amigo
Assault and Peppered	cartoonName	Assault and Peppered
Soup or Sonic	cartoonName	Soup or Sonic
Somewhere in Dreamland	cartoonName	Somewhere in Dreamland
Portrait of the Artist as a Young Bunny	cartoonName	Portrait of the Artist as a Young Bunny
Honeyland	cartoonName	Honeyland
Little Black Sambo	cartoonName	Little Black Sambo
Finding His Voice	cartoonName	Finding His Voice
Chew-Chew Baby	cartoonName	Chew-Chew Baby
Secret Agent	cartoonName	Secret Agent
The Reckless Driver	cartoonName	The Reckless Driver
This Is a Life%3F	cartoonName	This Is A Life?
Apes of Wrath	cartoonName	Apes of Wrath
Tweety's Circus	cartoonName	Tweety's Circus
Ain't She Tweet	cartoonName	Ain't She Tweet
Compressed Hare	cartoonName	COMpressed Hare
Dog Gone People	cartoonName	Dog Gone People
Stupor Duck	cartoonName	Stupor Duck
The Million Hare	cartoonName	The Million Hare
A Coy Decoy	cartoonName	A Coy Decoy
The Henpecked Duck	cartoonName	The Henpecked Duck
The Daffy Duckaroo	cartoonName	The Daffy Duckaroo
To Duck or Not to Duck	cartoonName	To Duck or Not to Duck
The Screwball	cartoonName	The Screwball
The Dizzy Acrobat	cartoonName	The Dizzy Acrobat
Ration Bored	cartoonName	Ration Bored
Woody Dines Out	cartoonName	Woody Dines Out
Kitty from Kansas City	cartoonName	Kitty from Kansas City
Road Runner a Go-Go	cartoonName	Road Runner a Go-Go
One Meat Brawl	cartoonName	One Meat Brawl
Wot a Night	cartoonName	Wot a Night
Now That Summer is Gone	cartoonName	Now That Summer is Gone
The Autograph Hound	cartoonName	The Autograph Hound
Dog Tales	cartoonName	Dog Tales
The Big Bad Wolf	cartoonName	The Big Bad Wolf\nFile:The Big Bad Wolf 1934 Title Card.jpg
Red Riding Hoodwinked	cartoonName	Red Riding Hoodwinked
Tweet and Sour	cartoonName	Tweet and Sour
Tree Cornered Tweety	cartoonName	Tree Cornered Tweety
Tugboat Granny	cartoonName	Tugboat Granny
Tweet Zoo	cartoonName	Tweet Zoo
Bad Luck Blackie	cartoonName	Bad Luck Blackie
Corn on the Cop	cartoonName	Corn on the Cop
Tease for Two	cartoonName	Tease for Two
It's Nice to Have a Mouse Around the House	cartoonName	It's Nice to Have a Mouse Around the House
Little Boy Boo	cartoonName	Little Boy Boo
Spooky Swabs	cartoonName	Spooky Swabs
Quick Brown Fox and Rapid Rabbit	cartoonName	Rabbit Stew and Rabbits Too!
The Last Hungry Cat	cartoonName	The Last Hungry Cat
Bacall to Arms	cartoonName	Bacall To Arms
Devil's Feud Cake	cartoonName	Devil's Feud Cake
Rebel Without Claws	cartoonName	Rebel Without Claws
One Droopy Knight	cartoonName	One Droopy Knight
You Were Never Duckier	cartoonName	You Were Never Duckier
West of the Pesos	cartoonName	West of the Pesos
Catch as Cats Can	cartoonName	Catch as Cats Can
Chili Weather	cartoonName	Chili Weather
Grampy's Indoor Outing	cartoonName	Grampy's Indoor Outing
Smile, Darn Ya, Smile!	cartoonName	Smile, Darn Ya, Smile!
Mexican Joyride	cartoonName	Mexican Joyride
Good Night, Elmer	cartoonName	Good Night, Elmer
Goopy Geer	cartoonName	Goopy Geer
Arts and Flowers	cartoonName	Arts and Flowers
Woody Meets Davy Crewcut	cartoonName	Woody Meets Davy Crewcut
Calling All Cuckoos	cartoonName	Calling All Cuckoos
Chief Charlie Horse	cartoonName	Chief Charlie Horse
Niagara Fools	cartoonName	Niagara Fools
After the Ball	cartoonName	After the Ball
Bunco Busters	cartoonName	Bunco Busters
Private Eye Pooch	cartoonName	Private Eye Pooch
Bedtime Bedlam	cartoonName	Bedtime Bedlam
The Tree Medic	cartoonName	The Tree Medic
Square Shootin' Square	cartoonName	Square Shootin' Square
Witch Crafty	cartoonName	Witch Crafty
Box Car Bandit	cartoonName	Box Car Bandit
Red Riding Hoodlum	cartoonName	Red Riding Hoodlum
The Unbearable Salesman	cartoonName	The Unbearable Salesman
To Catch a Woodpecker	cartoonName	To Catch a Woodpecker
International Woodpecker	cartoonName	International Woodpecker
Round Trip to Mars	cartoonName	Round Trip to Mars
Fodder and Son	cartoonName	Fodder and Son
Dopey Dick the Pink Whale	cartoonName	Dopey Dick the Pink Whale
Misguided Missile	cartoonName	Misguided Missile
Watch the Birdie	cartoonName	Watch the Birdie
Half Empty Saddles	cartoonName	Half Empty Saddles
His Better Elf	cartoonName	His Better Elf
Tree's a Crowd	cartoonName	Tree’s a Crowd
Jittery Jester	cartoonName	Jittery Jester
Wacky-Bye Baby	cartoonName	Wacky-Bye Baby
Banquet Busters	cartoonName	Banquet Busters
The Mad Hatter	cartoonName	The Mad Hatter
Woody the Giant Killer	cartoonName	Woody the Giant Killer
Solid Ivory	cartoonName	Solid Ivory
Well Oiled	cartoonName	Well Oiled
The Coo Coo Bird	cartoonName	The Coo Coo Bird
Smoked Hams	cartoonName	Smoked Hams
Fair Weather Fiends	cartoonName	Fair Weather Fiends
Bathing Buddies	cartoonName	Bathing Buddies
The Loan Stranger	cartoonName	The Loan Stranger
The Dippy Diplomat	cartoonName	The Dippy Diplomat
Woody Woodpecker	cartoonName	Woody Woodpecker
The Screwdriver	cartoonName	The Screwdriver
The Hollywood Matador	cartoonName	The Hollywood Matador
Who's Cookin' Who%3F	cartoonName	Who's Cookin' Who?
The Loose Nut	cartoonName	The Loose Nut
Ace in the Hole	cartoonName	Ace in the Hole
Wild and Woody!	cartoonName	Wild and Woody!
Drooler's Delight	cartoonName	Drooler's Delight
Puny Express	cartoonName	Puny Express
8	cartoonName	Slingshot 6 7/8
Sleep Happy	cartoonName	Sleep Happy
Wicket Wacky	cartoonName	Wicket Wacky
The Redwood Sap	cartoonName	The Redwood Sap
Destination Meatball	cartoonName	Destination Meatball
The Woody Woodpecker Polka	cartoonName	The Woody Woodpecker Polka
Stage Hoax	cartoonName	Stage Hoax
Woodpecker in the Rough	cartoonName	Woodpecker in the Rough
Scalp Treatment	cartoonName	Scalp Treatment
The Great Who-Dood-It	cartoonName	The Great Who-Dood-It
Termites from Mars	cartoonName	Termites from Mars
Buccaneer Woodpecker	cartoonName	Buccaneer Woodpecker
Operation Sawdust	cartoonName	Operation Sawdust
Wrestling Wrecks	cartoonName	Wrestling Wrecks
Socko in Morocco	cartoonName	Socko in Morocco
Hot Noon	cartoonName	Hot Noon
Log Jammed	cartoonName	Log Jammed
Tomcat Combat	cartoonName	Tomcat Combat
Panhandle Scandal	cartoonName	Panhandle Scandal
Woodpecker in the Moon	cartoonName	Woodpecker in the Moon
The Tee Bird	cartoonName	The Tee Bird
Romp in a Swamp	cartoonName	Romp in a Swamp
The Gay Anties	cartoonName	The Gay Anties
Hobo Bobo	cartoonName	Hobo Bobo
All a Bir-r-r-d	cartoonName	All A Bir-r-r-d
Billion Dollar Boner	cartoonName	Billion Dollar Boner
Kiddie League	cartoonName	Kiddie League
Pistol Packin' Woodpecker	cartoonName	Pistol Packin' Woodpecker
Heap Big Hepcat	cartoonName	Heap Big Hepcat
How to Stuff a Woodpecker	cartoonName	How to Stuff a Woodpecker
Ballyhooey	cartoonName	Ballyhooey
The Mouse That Jack Built	cartoonName	The Mouse That Jack Built
The Tortoise and the Hare	cartoonName	The Tortoise and the Hare
Gabby's Diner	cartoonName	Gabby's Diner
Barbary Coast Bunny	cartoonName	Barbary-Coast Bunny
The Art of Skiing	cartoonName	The Art of Skiing
Bugged by a Bee	cartoonName	Bugged by a Bee
Cool Cat	cartoonName	Cool Cat
The Bear That Couldn't Sleep	cartoonName	The Bear That Couldn't Sleep
What Price Porky	cartoonName	What Price Porky
Daffy Dilly	cartoonName	Daffy Dilly
Three Orphan Kittens	cartoonName	Three Orphan Kittens
The Fair-Haired Hare	cartoonName	The Fair-Haired Hare
Naughty but Mice	cartoonName	Naughty but Mice
Bugs Bunny's Overtures to Disaster	cartoonName	Bugs Bunny's Overtures to Disaster
Mother Was a Rooster	cartoonName	Mother was a Rooster
Banty Raids	cartoonName	Banty Raids
The Slick Chick	cartoonName	The Slick Chick
Strangled Eggs	cartoonName	Strangled Eggs
Nelly's Folly	cartoonName	Nelly's Folly
Pizzicato Pussycat	cartoonName	Pizzicato Pussycat
Little Beau Porky	cartoonName	Little Beau Porky
Gopher Broke	cartoonName	Gopher Broke
Yankee Doodle Bugs	cartoonName	Yankee Doodle Bugs
Robin Hood Makes Good	cartoonName	Robin Hood Makes Good
A Ham in a Role	cartoonName	A Ham in a Role
Muzzle Tough	cartoonName	Muzzle Tough
The Golden Touch	cartoonName	The Golden Touch
Gallopin' Gals	cartoonName	Gallopin' Gals
Weasel While You Work	cartoonName	Weasel While You Work
A Bird in a Bonnet	cartoonName	A Bird in a Bonnet
You're a Sap, Mr. Jap	cartoonName	You're a Sap, Mr. Jap
Hare-Less Wolf	cartoonName	Hare-Less Wolf
Two Gophers from Texas	cartoonName	Two Gophers from Texas
It's Got Me Again!	cartoonName	It's Got Me Again!
Foxy by Proxy	cartoonName	Foxy by Proxy
Hare-Abian Nights	cartoonName	Hare-Abian Nights
Page Miss Glory	cartoonName	Page Miss Glory
Eleventh Hour	cartoonName	Eleventh Hour
Prince Violent	cartoonName	Prince Violent
Magician Mickey	cartoonName	Magician Mickey
The Country Cousin	cartoonName	The Country Cousin
There's Good Boos To-Night	cartoonName	There's Good Boos To-Night
Melody	cartoonName	Melody
Monkey Love	cartoonName	Monkey Love
Mighty Mouse in Gypsy Life	cartoonName	Mighty Mouse in Gypsy Life
Donald Duck and the Gorilla	cartoonName	Donald Duck and the Gorilla
Ghost Wanted	cartoonName	Ghost Wanted
Mouse Wreckers	cartoonName	Mouse Wreckers
Trip for Tat	cartoonName	Trip For Tat
Little Rural Riding Hood	cartoonName	Little Rural Riding Hood
His Hare-Raising Tale	cartoonName	His Hare-Raising Tale
Upswept Hare	cartoonName	Upswept Hare
Hare Trimmed	cartoonName	Hare Trimmed
Half-Fare Hare	cartoonName	Half-Fare Hare
Raw! Raw! Rooster!	cartoonName	Raw! Raw! Rooster!
The Dixie Fryer	cartoonName	The Dixie Fryer
Napoleon Bunny-Part	cartoonName	Napoleon Bunny-Part
Rabbit's Feat	cartoonName	Rabbit's Feat
Sock-a-Doodle-Do	cartoonName	Sock-A-Doodle-Do
Bewitched Bunny	cartoonName	Bewitched Bunny
Design for Leaving	cartoonName	Design for Leaving
The High and the Flighty	cartoonName	The High and the Flightly
Riff Raffy Daffy	cartoonName	Riff Raffy Daffy
Bill of Hare	cartoonName	Bill of Hare
Daffy Duck in Hollywood	cartoonName	Daffy Duck in Hollywood
Of Rice and Hen	cartoonName	Of Rice and Hen
Now Hare This	cartoonName	Now Hare This
Jerky Turkey	cartoonName	Jerky Turkey
Of Thee I Sting	cartoonName	Of Thee I Sting
Greedy for Tweety	cartoonName	Greedy for Tweety
Feather Bluster	cartoonName	Feather Bluster
Kid vs. Kat vs. Christmas	cartoonName	Kid vs. Kat vs. Christmas
Honey's Money	cartoonName	Honey's Money
Hop and Go	cartoonName	Hop and Go
Toy Town Hall	cartoonName	Toy Town Hall
Boulevardier from the Bronx	cartoonName	Boulevardier From The Bronx
The Cat Came Back	cartoonName	The Cat Came Back
Officer Pooch	cartoonName	Officer Pooch
Well Worn Daffy	cartoonName	Well Worn Daffy
Feather Finger	cartoonName	Feather Finger
Mucho Locos	cartoonName	Mucho Locos
Bosko's Parlor Pranks	cartoonName	Bosko's Parlor Pranks
A Taste of Catnip	cartoonName	A Taste of Catnip
Daffy's Diner	cartoonName	Daffy's Diner
Go Away Stowaway	cartoonName	Go Away Stowaway
Snow Excuse	cartoonName	Snow Excuse
Speedy Ghost to Town	cartoonName	Speedy Ghost to Town
Canned Feud	cartoonName	Canned Feud
Putty Tat Trouble	cartoonName	Putty Tat Trouble
Room and Bird	cartoonName	Room and Bird
Tweet Tweet Tweety	cartoonName	Tweet Tweet Tweety
Little Red Rodent Hood	cartoonName	Little Red Rodent Hood
A Bird in a Guilty Cage	cartoonName	A Bird in a Guilty Cage
A Mouse Divided	cartoonName	A Mouse Divided
Fowl Weather	cartoonName	Fowl Weather
Tom Tom Tomcat	cartoonName	Tom Tom Tomcat
A Street Cat Named Sylvester	cartoonName	A Street Cat Named Sylvester
Cracked Ice	cartoonName	Cracked Ice
Goofy Gymnastics	cartoonName	Goofy Gymnastics
Once Upon a Time in the Woods	cartoonName	Once upon A Time in the Woods
The Early Bird Dood It!	cartoonName	The Early Bird Dood It!
The Hungry Wolf	cartoonName	The Hungry Wolf
Drip Dippy Donald	cartoonName	Drip Dippy Donald
The Old Army Game	cartoonName	The Old Army Game
War Dogs	cartoonName	War Dogs
Backwoods Bunny	cartoonName	Backwoods Bunny
Terrier Stricken	cartoonName	Terrier-Stricken
Thumb Fun	cartoonName	Thumb Fun
Scrambled Eggs	cartoonName	Scrambled Eggs
Unnatural History	cartoonName	Unnatural History
There Auto Be a Law	cartoonName	There Auto Be a Law
Sally Swing	cartoonName	Sally Swing
Silly Scandals	cartoonName	Silly Scandals
Pudgy the Watchman	cartoonName	Pudgy and the Watchman
Wild Elephinks	cartoonName	Wild Elephinks
Buzzy Boop	cartoonName	Buzzy Boop
The Lost Kitten	cartoonName	The Lost Kitten
Let's You and Him Fight	cartoonName	Let's You and Him Fight
Seasin's Greetinks!	cartoonName	Seasin's Greetinks!
Blow Me Down!	cartoonName	Blow Me Down!
Pudgy Picks a Fight!	cartoonName	Pudgy Picks a Fight!
Spinach Fer Britain	cartoonName	Spinach Fer Britain
The Candid Candidate	cartoonName	The Candid Candidate
Service with a Smile	cartoonName	Service with a Smile
The New Deal Show	cartoonName	The New Deal Show
The Foxy Hunter	cartoonName	The Foxy Hunter
Be Up to Date	cartoonName	Be Up to Date
On with the New	cartoonName	On with the New
So Does an Automobile	cartoonName	So Does an Automobile
Thrills and Chills	cartoonName	Thrills and Chills
The Scared Crows	cartoonName	The Scared Crows
Buzzy Boop at the Concert	cartoonName	Buzzy Boop at the Concert
Honest Love and True	cartoonName	Honest Love and True
Time on My Hands	cartoonName	Time on My Hands
Raggedy Ann and Raggedy Andy	cartoonName	Raggedy Ann and Raggedy Andy
D' Fightin' Ones	cartoonName	D' Fightin' Ones
Sugar and Spies	cartoonName	Sugar and Spies
A-Haunting We Will Go	cartoonName	A-Haunting We Will Go
Billboard Frolics	cartoonName	Billboard Frolics
Little Annie Rooney	cartoonName	Little Annie Rooney
Goofy Goat Antics	cartoonName	Goofy Goat Antics
Confidence	cartoonName	Confidence
King Klunk	cartoonName	King Klunk
The Plastics Inventor	cartoonName	The Plastics Inventor
The Daffy Doc	cartoonName	The Daffy Doc
Horse Hare	cartoonName	Horse Hare
Coyote Falls	cartoonName	Coyote Falls
Crazy House	cartoonName	Crazy House
The Ant and the Aardvark	cartoonName	The Ant and the Aardvark
Rhymes with Coop	cartoonName	Rhymes with Coop
Porky's Railroad	cartoonName	Porky's Railroad
Old Glory	cartoonName	Old Glory
The Woods Are Full of Cuckoos	cartoonName	The Woods Are Full of Cuckoos
Beauty and the Beast	cartoonName	Beauty and the Beast
Rushing Roulette	cartoonName	Rushing Roulette
Doggone Cats	cartoonName	Doggone Cats
Pappy's Puppy	cartoonName	Pappy's Puppy
Rabid Rider	cartoonName	Rabid Rider
Fur of Flying	cartoonName	Fur of Flying
His Bitter Half	cartoonName	His Bitter Half
Tall Timber	cartoonName	Tall Timber
Bright Lights	cartoonName	Bright Lights
Five and Dime	cartoonName	Five and Dime
Africa	cartoonName	Africa
The Plumber	cartoonName	The Plumber
Merlin the Magic Mouse	cartoonName	Merlin the Magic Mouse
Seein' Red, White 'N' Blue	cartoonName	Seein' Red, White 'N' Blue
Henpecked	cartoonName	Henpecked
Goo Goo Goliath	cartoonName	Goo Goo Goliath
A Fox in a Fix	cartoonName	A Fox in a Fix
Sandy Claws	cartoonName	Sandy Claws
Weary Willies	cartoonName	Weary Willies
Fiery Fireman	cartoonName	Fiery Fireman
Lovesick	cartoonName	Lovesick
The Navy	cartoonName	The Navy
The Shriek	cartoonName	The Shriek
A Wet Knight	cartoonName	A Wet Knight
Oil's Well	cartoonName	Oil's Well
Spooks	cartoonName	Spooks
Jungle Jingles	cartoonName	Jungle Jingles
Odor of the Day	cartoonName	Odor of the Day
Scentimental Romeo	cartoonName	Scentimental Romeo
Bye, Bye Bluebeard	cartoonName	Bye, Bye Bluebeard
Drive-In Me Crazy	cartoonName	Drive-In Me Crazy
Paying the Piper	cartoonName	Paying the Piper
Often an Orphan	cartoonName	Often an Orphan
Sick Cylinders	cartoonName	Sick Cylinders
Ham and Eggs	cartoonName	Ham and Eggs
The Butcher Boy	cartoonName	The Butcher Boy
The Ginger Bread Boy	cartoonName	The Ginger Bread Boy
Beach Combers	cartoonName	Beach Combers
Dime to Retire	cartoonName	Dime to Retire
Jumpin' Jupiter	cartoonName	Jumpin' Jupiter
Porky in the North Woods	cartoonName	Porky in the North Woods
The Phantom Ship	cartoonName	The Phantom Ship
Porky's Romance	cartoonName	Porky's Romance
Porky in Egypt	cartoonName	Porky in Egypt
The Candlemaker	cartoonName	The Candlemaker
Gone Batty	cartoonName	Gone Batty
The Enchanted Square	cartoonName	The Enchanted Square
The Hunter	cartoonName	The Hunter
Alpine Antics	cartoonName	Alpine Antics
The Busy Barber	cartoonName	The Busy Barber
Weenie Roast	cartoonName	Weenie Roast
Mr. and Mrs. Is the Name	cartoonName	Mr. and Mrs. Is the Name
Rodeo Dough	cartoonName	Rodeo Dough
Leghorn Swoggled	cartoonName	Leghorn Swoggled
The Egg-Cited Rooster	cartoonName	The Egg-Cited Rooster
Seeing Stars	cartoonName	Seeing Stars
Snow Time	cartoonName	Snow Time
Port Whines	cartoonName	Port Whines
Sleepy Holler	cartoonName	Sleepy Holler
The Apache Kid	cartoonName	The Apache Kid
You Don't Know What You're Doin'!	cartoonName	You Don't Know What You're Doin'!
Mexican Boarders	cartoonName	Mexican Boarders
Just Mickey	cartoonName	Fiddling Around / Just Mickey
Mickey in Arabia	cartoonName	Mickey in Arabia
Alpine Antics	cartoonName	Alpine Antics
Boom Boom	cartoonName	Boom Boom
Lil' Ainjil	cartoonName	Lil' Ainjil
Prosperity Blues	cartoonName	Prosperity Blues
Love's Labor Lost	cartoonName	Love's Labor Lost
The Hole Idea	cartoonName	The Hole Idea
The Merry Old Soul	cartoonName	The Merry Old Soul
Springtime Serenade	cartoonName	Springtime Serenade
Grandma's Pet	cartoonName	Grandma's Pet
Carnival Capers	cartoonName	Carnival Capers
The Stork Exchange	cartoonName	The Stork Exchange
Goggle Fishing Bear	cartoonName	Goggle Fishing Bear
The Rookie Bear	cartoonName	The Rookie Bear
The Sleepwalker	cartoonName	The Sleepwalker
Wax Works	cartoonName	Wax Works
The Whalers	cartoonName	The Whalers
Bars and Stripes	cartoonName	Bars and Stripes
Puppet Show	cartoonName	Puppet Show
Bye, Bye, Blackboard	cartoonName	Bye, Bye, Blackboard
Forty Winks	cartoonName	Forty Winks
Alice's Orphan	cartoonName	Alice's Orphan
The Non-Stop Fright	cartoonName	The Non-Stop Fright
Peeping Penguins	cartoonName	Peeping Penguins
Scotty Finds a Home	cartoonName	Scotty Finds A Home
Alaskan Knights	cartoonName	Alaskan Knights
The Bandmaster	cartoonName	The Bandmaster
Hamateur Night	cartoonName	Hamateur Night
Bah Wilderness	cartoonName	Bah Wilderness
Porky's Five & Ten	cartoonName	Porky's Five & Ten
Eskimotive	cartoonName	Eskimotive
Bird-Brain Bird Dog	cartoonName	Bird Brain Bird Dog
Mexico	cartoonName	Mexico
The Hypo-Chondri-Cat	cartoonName	The Hypo-Chondri-Cat
Paperman	cartoonName	Paperman
Kounty Fair	cartoonName	Kounty Fair
Searching For Santa!	cartoonName	Searching For Santa!
She Done Him Right	cartoonName	She Done Him Right
Piano Mover	cartoonName	Piano Mover
Speaking of the Weather	cartoonName	Speaking of the Weather
Felix the Cat Trifles with Time	cartoonName	Felix the Cat Trifles with Time
The Cat and the Kit	cartoonName	The Cat and the Kit
Porky's Bear Facts	cartoonName	Porky's Bear Facts
Krazy Spooks	cartoonName	Krazy Spooks
Droopy's Double Trouble	cartoonName	Droopy's \
Rail Rode	cartoonName	Rail Rode
Cinderella Meets Fella	cartoonName	Cinderella Meets Fella
Count Me Out	cartoonName	Count Me Out
Love and Curses	cartoonName	Love and Curses
The Penguin Parade	cartoonName	The Penguin Parade
Who Killed Cock Robin%3F	cartoonName	Who Killed Cock Robin
The Screwy Truant	cartoonName	The Screwy Truant
We, the Animals Squeak!	cartoonName	We, the Animals Squeak!
Wee-Willie Wildcat	cartoonName	Wee-Willie Wildcat
Horton Hatches the Egg	cartoonName	Horton Hatches the Egg
The Little Lion Hunter	cartoonName	The Little Lion Hunter
Don't Axe Me	cartoonName	Don't Axe Me
Chaser on the Rocks	cartoonName	Chaser on the Rocks
Bone Trouble	cartoonName	Bone Trouble
Head over Heels	cartoonName	Head over Heels
Wise Quackers	cartoonName	Wise Quackers
Porky's Picnic	cartoonName	Porky's Picnic
Astronut Woody	cartoonName	Astrount Woody
I Wanna Play House	cartoonName	I Wanna Play House
The Mouse Exterminator	cartoonName	The Mouse Exterminator
A Haunting We Will Go	cartoonName	A Haunting We Will Go
Felix Finds Out	cartoonName	Felix Finds Out
The Wild Goose Chase	cartoonName	The Wild Goose Chase
Aqua Duck	cartoonName	Aqua Duck
Get a Horse!	cartoonName	Get a Horse!
The Quail Hunt	cartoonName	The Quail Hunt
Birth of Jazz	cartoonName	Birth of Jazz
Commando Duck	cartoonName	Commando Duck
Slap-Happy Pappy	cartoonName	Slap-Happy Pappy
The County Fair	cartoonName	The County Fair
Russian Dressing	cartoonName	Russian Dressing
The Lumber Champ	cartoonName	The Lumber Champ
Nuts and Volts	cartoonName	Nuts and Volts
Musical Moments from Chopin	cartoonName	Musical Moments with Chopin
Radio Rhythm	cartoonName	Radio Rhythm
Halloween	cartoonName	Halloween
Parking Space	cartoonName	Parking Space
Down South	cartoonName	Down South
Farmer Al Falfa's Prize Package	cartoonName	Farmer Al Falfa's Prize Package
Puss n' Booty	cartoonName	Puss n' Booty
Skunked Again	cartoonName	Skunked Again
Toby the Showman	cartoonName	Toby the Showman
The Hay Ride	cartoonName	The Hay Ride
Krazy Kat and Ignatz Mouse: A Duet, He Made Me Love Him	cartoonName	Krazy Kat and Ignatz Mouse: A Duet, He Made Me Love Him
Red Hot Music	cartoonName	Red Hot Music
The Bill Poster	cartoonName	The Bill Poster
Chris Columbus Jr.	cartoonName	Chris Columbus Jr.
The Male Man	cartoonName	The Male Man
Cinderella Blues	cartoonName	Cinderella Blues
Krazy Kat & Ignatz Mouse Discuss the Letter 'G'	cartoonName	Krazy Kat & Ignatz Mouse Discuss the Letter 'G'
The Best Mouse Loses	cartoonName	The Best Mouse Loses
Silvery Moon	cartoonName	Silvery Moon
Cats and Bruises	cartoonName	Cats and Bruises
Home Tweet Home	cartoonName	Home Tweet Home
The Window Washers	cartoonName	The Window Washers
The Winged Horse	cartoonName	The Winged Horse
Closer than a Brother	cartoonName	Closer than a Brother
Plane Dippy	cartoonName	Plane Dippy
The Bandmaster	cartoonName	The Bandmaster
Farmer Al Falfa Sees New York	cartoonName	Farmer Al Falfa Sees New York
Dog Gone	cartoonName	Dog Gone
Small Town Sheriff	cartoonName	Small Town Sheriff
Merry Dog	cartoonName	Merry Dog
Mouse and Garden	cartoonName	Mouse and Garden
Cracked Quack	cartoonName	Cracked Quack
The Peace Conference	cartoonName	The Peace Conference
Krazy's Waterloo	cartoonName	Krazy's Waterloo
Get Rich Quick Porky	cartoonName	Get Rich Quick Porky
A Barnyard Frolic	cartoonName	A Barnyard Frolic
Dentist Love	cartoonName	Dentist Love
Mouse Warming	cartoonName	Mouse Warming
Kiko and the Honey Bears	cartoonName	Kiko and the Honey Bears
Kiko Foils the Fox	cartoonName	Kiko Foils the Fox
Holiday Land	cartoonName	Holiday Land
The Old Mill Pond	cartoonName	The Old Mill Pond
Quackodile Tears	cartoonName	Quackodile Tears
The Great Carrot Train Robbery	cartoonName	The Great Carrot Train Robbery
Bunny and Claude	cartoonName	Bunny and Claude
Cat Feud	cartoonName	Cat Feud
Hot and Cold	cartoonName	Hot and Cold
Woodpecker from Mars	cartoonName	Woodpecker from Mars
Road to Andalay	cartoonName	Road to Andalay
Cheating the Piper	cartoonName	Cheating the Piper
Missing U	cartoonName	Missing U
Educated Fish	cartoonName	Educated Fish
Jolly Little Elves	cartoonName	Jolly Little Elves
Domestic Difficulties	cartoonName	Domestic Difficulties
Beezy Bear	cartoonName	Beezy Bear
Donald's Vacation	cartoonName	Donald's Vacation
The Early Worm Gets the Bird	cartoonName	The Early Worm Gets the Bird
The Pied Piper of Guadalupe	cartoonName	The Pied Piper of Guadalupe
Payday	cartoonName	Pay Day
Feast	cartoonName	Feast
Flim Flam Films	cartoonName	Flim Flam Films
Babes at Sea	cartoonName	Babes at Sea
The Little Lost Sheep	cartoonName	The Little Lost Sheep
Bosko at the Zoo	cartoonName	Bosko at the Zoo
Dog Daze	cartoonName	Dog Daze
The Toy Shoppe	cartoonName	The Toy Shoppe
Svengarlic	cartoonName	Svengarlic
The Hare Mail	cartoonName	The Hare Mail
Farm Relief	cartoonName	Farm Relief
Mars	cartoonName	Mars
The Candy House	cartoonName	The Candy House
Teacher's Pests	cartoonName	Teacher's Pests
Kannibal Kapers	cartoonName	Kannibal Kapers
Dr. Jerkyl's Hide	cartoonName	Dr. Jerkyl's Hide
Me Musical Nephews	cartoonName	Me Musical Nephews
The Alley Cat	cartoonName	The Alley Cat
The Fireman	cartoonName	The Fireman
Minnie the Moocher	cartoonName	Minnie the Moocher
The Clown	cartoonName	The Clown
Ye Happy Pilgrims	cartoonName	Ye Happy Pilgrims
A Happy Family	cartoonName	A Happy Family
Feather Duster	cartoonName	Feather Duster
Making Good	cartoonName	Making Good
Whys and Other Whys	cartoonName	Whys and Other Whys
The Trapeze Artist	cartoonName	The Trapeze Artist
Fox Pop	cartoonName	Fox Pop
The Foxy Duckling	cartoonName	The Foxy Duckling
Empty Socks	cartoonName	Empty Socks
China Jones	cartoonName	China Jones
Soda Poppa	cartoonName	Soda Poppa
Jazz Rhythm	cartoonName	Jazz Rhythm
Antique Antics	cartoonName	Antique Antics
Play Ball	cartoonName	Play Ball
Slow Beau	cartoonName	Slow Beau
The Medicine Show	cartoonName	The Medicine Show
The Mad Locomotive	cartoonName	The Mad Locomotive
Shipwreck	cartoonName	Shipwreck
The Athlete	cartoonName	The Athlete
The Crowd Snores	cartoonName	The Crowd Snores
Going to Blazes	cartoonName	Going to Blazes
The Under Dog	cartoonName	The Under Dog
Cats and Dogs	cartoonName	Cats and Dogs
The Crystal Gazebo	cartoonName	The Crystal Gazebo
Southern Exposure	cartoonName	Southern Exposure
Bowery Daze	cartoonName	Bowery Daze
Out of the Ether	cartoonName	Out of the Ether
The Broadway Malady	cartoonName	The Broadway Malady
The Katnips of 1940	cartoonName	The Katnips of 1940
Pin Feathers	cartoonName	Pin Feathers
Wild and Woolly	cartoonName	Wild and Woolly
Billy Boy	cartoonName	Billy Boy
Wins Out	cartoonName	Wins Out
Flop Goes the Weasel	cartoonName	Flop Goes the Weasel
The Polar Bears	cartoonName	The Polar Bears
Bokays and Brickbatz	cartoonName	Bokays and Brickbatz
The Lyin' Mouse	cartoonName	The Lyin' Mouse
Swooning the Swooners	cartoonName	Swooning the Swooners
I Wanna Be a Sailor	cartoonName	I Wanna Be a Sailor
Wonderland	cartoonName	Wonderland
Carmen's Veranda	cartoonName	Carmen's Veranda
The Shell Shocked Egg	cartoonName	The Shell Shocked Egg
Mickey's Nightmare	cartoonName	Mickey's Nightmare
The Stone Age	cartoonName	The Stone Age
Disarmament Conference	cartoonName	Disarmament Conference
Reason and Emotion	cartoonName	Reason and Emotion
A-Lad-In Bagdad	cartoonName	A-Lad-In Bagdad
The Hardship of Miles Standish	cartoonName	The Hardship of Miles Standish
Barney's Hungry Cousin	cartoonName	Barney's Hungry Cousin
Sleepy-Time Squirrel	cartoonName	Sleepy-Time Squirrel
Red-Headed Baby	cartoonName	Red-Headed Baby
A Gander at Mother Goose	cartoonName	A Gander at Mother Goose
Pagan Moon	cartoonName	Pagan Moon
Crosby, Columbo, and Vallee	cartoonName	Crosby, Columbo, and Vallee
Bosko's Store	cartoonName	Bosko's Store
Krazy's Race of Time	cartoonName	Krazy's Race of Time
Moonlight for Two	cartoonName	Moonlight for Two
Bosko in Person	cartoonName	Bosko in Person
Taken for a Ride	cartoonName	Taken for a Ride
I'm Cold	cartoonName	I'm Cold
Sh-h-h-h-h-h	cartoonName	Sh-h-h-h-h-h
Hot and Cold Penguin	cartoonName	Hot and Cold Penguin
Chilly Willy	cartoonName	Chilly Willy
The T.V. of Tomorrow	cartoonName	The T.V. of Tomorrow
Swing Symphony	cartoonName	Swing Symphony
Swing You Sinners!	cartoonName	Swing You Sinners!
Pop-Pie a la Mode	cartoonName	Pop-Pie a la Mode
Circus Today	cartoonName	Circus Today
Tepee for Two	cartoonName	Tepee for Two
September in the Rain	cartoonName	September in the Rain
Malibu Beach Party	cartoonName	Malibu Beach Party
At Your Service Madame	cartoonName	At Your Service Madame
Streamlined Greta Green	cartoonName	Streamlined Greta Green
A Star is Hatched	cartoonName	A Star is Hatched
Plenty of Money and You	cartoonName	Plenty of Money and You
When I Yoo Hoo	cartoonName	When I Yoo Hoo
Cross-Country Detours	cartoonName	Cross-Country Detours
I'd Love to Take Orders From You	cartoonName	I'd Love to Take Orders From You
Detouring America	cartoonName	Detouring America
Shop, Look and Listen	cartoonName	Shop, Look and Listen
He Was Her Man	cartoonName	He Was Her Man
Sweet Sioux	cartoonName	Sweet Sioux
A Sunbonnet Blue	cartoonName	A Sunbonnet Blue
The Mice Will Play	cartoonName	The Mice Will Play
The Sneezing Weasel	cartoonName	The Sneezing Weasel
My Little Buckaroo	cartoonName	My Little Buckaroo
Little Pancho Vanilla	cartoonName	Little Pancho Vanilla
Believe It or Else	cartoonName	Believe It or Else
Dog Gone Modern	cartoonName	Dog Gone Modern
Bars and Stripes Forever	cartoonName	Bars and Stripes Forever
Snowman's Land	cartoonName	Snowman's Land
Screwball Football	cartoonName	Screwball Football
Hobo Gadget Band	cartoonName	Hobo Gadget Band
The Curious Puppy	cartoonName	The Curious Puppy
Fagin's Freshman	cartoonName	Fagin's Freshman
Fresh Fish	cartoonName	Fresh Fish
Country School	cartoonName	Country School
