Fair Isle	celticName	Fara
Iona	celticName	Ì Chaluim Chille
Orkney	celticName	Arcaibh
Shetland	celticName	Sealtainn
Gruinard Island	celticName	Eilean Gruinneart
Great Cumbrae	celticName	Cumaradh Mòr
Little Cumbrae	celticName	Cumaradh Beag
South Uist	celticName	Uibhist a Deas
St Kilda, Scotland	celticName	Hiort
Staffa	celticName	Stafa
Raasay	celticName	Ratharsair
Holy Isle, Firth of Clyde	celticName	An t-Eilean Àrd or Eilean MoLaise
Foula	celticName	Fughlaigh
Canna, Scotland	celticName	Canaigh, Eilean Chanaigh
Mainland, Orkney	celticName	Mòr-thìr
Eigg	celticName	Eige
Sanday, Inner Hebrides	celticName	Sandaigh
Scalpay, Inner Hebrides	celticName	Sgalpaigh
Coll	celticName	Cola
Fetlar	celticName	Unknown
Egilsay	celticName	?Eaglais
North Ronaldsay	celticName	N/A
Isle of Bute	celticName	Eilean Bhòid
Isle of Bute	celticName	An t-Eilean Bhòdach
Handa, Scotland	celticName	Eilean Shannda
Grimsay	celticName	Griomasaigh
Scalpay, Outer Hebrides	celticName	Sgalpaigh na Hearadh/Sgalpaigh
Baleshare	celticName	Am Baile Sear
Berneray	celticName	Beàrnaraigh
Vallay	celticName	Bhàlaigh
Sanda Island	celticName	Sandaigh/?Abhainn
Scarp, Scotland	celticName	An Sgarp
Davaar Island	celticName	Eilean Dà Bhàrr
Seil	celticName	Saoil
Easdale	celticName	Eilean Èisdeal
Luing	celticName	Luinn
Scarba	celticName	Sgarba
Belnahua	celticName	Beul na h-Uamha
Treshnish Isles	celticName	Eileanan Treisinis
Ailsa Craig	celticName	Creag Ealasaid
Sandray	celticName	Sanndraigh
Barra Head	celticName	Beàrnaraigh
Inchcolm	celticName	Innis Choluim
Gometra	celticName	Gòmastra
Eilean Donan	celticName	Eilean Donnain
Erraid	celticName	Eilean Earraid
Torsa	celticName	Torsa
Isle of May	celticName	Eilean Mhàigh
Soay, St Kilda	celticName	Soaigh
Eilean Chathastail	celticName	Eilean Chathastail
St Ninian's Isle	celticName	Unknown
Ronay	celticName	Rònaigh
Inchmarnock	celticName	Innis Mhearnaig
Boreray	celticName	Boraraigh
Inchkeith	celticName	Innse Coit
Fidra	celticName	Fiodra
Inchgarvie	celticName	Innis Garbhach
Lady Isle	celticName	Eilean Mhoire
Priest Island	celticName	Eilean a' Chlèirich
Skerryvore	celticName	An Sgeir Mhòr
Dubh Artach	celticName	Dubh Artach
Sgeotasaigh	celticName	Sgeotasaig
Tahay	celticName	Taghaigh
Inch Kenneth	celticName	Innis Choinnich
Castle Tioram	celticName	Eilean Tioram
Little Colonsay	celticName	Colbhasa Beag
Inchmurrin	celticName	Innis Mheadhran
Wiay, Skye	celticName	Bhuia/Fuidheigh
Garbh Eileach	celticName	Garbh Eileach
Pabbay, Harris	celticName	Pabaigh
Eileach an Naoimh	celticName	Eileach an Naoimh
Eilean Rìgh	celticName	Eilean Rìgh
Eilean Bàn, Lochalsh	celticName	Eilean Bàn
Sula Sgeir	celticName	Sula Sgeir
Mugdrum Island	celticName	muc-dhruim
Orsay, Inner Hebrides	celticName	Orasaigh
Eilean Dubh Mòr	celticName	Eilean Dubh Mòr
Shillay	celticName	Siolaigh
Linga, Yell	celticName	Unknown
Eilean Mhic Coinnich	celticName	Eilean Mhic Coinnich
Seaforth Island	celticName	Eilean Shìophoirt or Mulag
Isle of Ewe	celticName	Eilean Iùbh
Inchconnachan	celticName	Innis Chonachain
Lunga, Treshnish Isles	celticName	Lungaigh
Ensay	celticName	Easaigh
Muldoanich	celticName	Maol Dòmhnaich
Lunga	celticName	Lunga
Bac Mòr	celticName	Bac Mòr
Grimsay	celticName	Griomasaigh
Bac Beag	celticName	Bac Beag
Stac an Armin	celticName	Stac an Àrmainn
Cairn na Burgh Mòr	celticName	Cairn na Burgh Mòr
Tanera Mòr	celticName	Tannara Mòr
Gighay	celticName	Gioghaigh
Texa	celticName	Teacsa
Eilean nan Ròn	celticName	Eilean nan Ròn
Stac Biorach	celticName	Stac Biorach
Pabay	celticName	Pabaigh
Longay	celticName	Longaigh
Killegray	celticName	Ceileagraigh
Fuday	celticName	Fùideigh
Eilean Mhealasta	celticName	Eilean Mhealasta
Eilean Chaluim Chille	celticName	Calum Cille
Eilean Chearstaidh	celticName	Eilean Cearstaigh
Wiay, Uist	celticName	Bhuia/Fuidheigh
Eilean Mhuire	celticName	Eilean Mhuire
Tanera Beag	celticName	Tanara Beag
Inchcailloch	celticName	Innis na Cailleach
Eilean Shona	celticName	Eilean Seòna
Flodaigh	celticName	Flodaigh
Ornsay	celticName	Eilean Iarmain
Oronsay, Outer Hebrides	celticName	Orasaigh
Horse Island, Summer Isles	celticName	Eilean nan Each
Isle Martin	celticName	Eilean Mhàrtainn
Isle Ristol	celticName	Eilean Ruisteil
Oronsay, Loch Sunart	celticName	Orasaigh
Oronsay, Loch Bracadale	celticName	Orasaigh
Kirkibost	celticName	Eilean Chirceboist
Eriska	celticName	ùruisg,
Garbh Eilean	celticName	Garbh Eilean
Longa Island	celticName	Longa
Danna, Scotland	celticName	Danna
Little Bernera	celticName	Beàrnaraigh Beag
Shuna, Loch Linnhe	celticName	Siùna
Shuna	celticName	Siuna
Dùn Channuill	celticName	Dùn Channuill
Muckle Green Holm	celticName	Unknown
Hunda	celticName	Unknown
Damsay	celticName	Unknown
Inchfad	celticName	Innis Fada
Soay Mòr	celticName	Sòdhaigh Mòr
Cairn na Burgh Beag	celticName	Cairn na Burgh Beag
Arnamul	celticName	Arnamuil
Ceann Ear	celticName	Ceann Ear
Ceann Iar	celticName	Ceann Iar
Shillay, Monach Islands	celticName	Siolaigh/Seilaigh
Island Macaskin	celticName	Eilean MhicAsgain
Gunna	celticName	Gunnaigh
Calbha Beag	celticName	Calbha Beag
Hermetray	celticName	Theàrnatraigh
Inchtavannach	celticName	Innis Taigh a' Mhanaich
Moncreiffe Island	celticName	Monadh Craoibhe
Innis Chonain	celticName	Innis Chonain
Stockinish Island	celticName	Eilean Stocainis
Fuaigh Mòr	celticName	Fuaigh Mòr
Pabaigh Mòr	celticName	Pabaigh Mòr
Eilean Liubhaird	celticName	Eilean Liubhaird
Hellisay	celticName	Theiliseigh
Fladda-chùain	celticName	Fladda-chùain
East Linga	celticName	Unknown
Eilean Aigas	celticName	Eilean Àigeis
Eilean Mòr, Crowlin Islands	celticName	Eilean Mòr
Flodday	celticName	Flodaigh
Nave Island	celticName	Eilean Nèimh
Eileanan Iasgaich	celticName	Eileanan Iasgaich Mòr
Garbh Eilean, Loch Maree	celticName	Garbh Eilean
Eilean Ruairidh Mòr	celticName	Eilean Ruairidh Mòr
Fuiay	celticName	Fùidheigh
Flodaigh Mòr	celticName	Flodaigh
Haskeir	celticName	Eilean Hasgeir
Lingay, Fiaray	celticName	Lingeigh
Lady's Holm	celticName	Unknown
Little Holm, Scatness	celticName	Unknown
Forewick Holm	celticName	Unknown
Bucinch	celticName	Buc-Innis
Clairinsh	celticName	Clàr-Innis
Bernera, Lismore	celticName	Beàrnaraigh
Ceallasaigh Mòr	celticName	Ceallasaigh Mòr
Flodday near Vatersay	celticName	Flodaigh
Stac Levenish	celticName	Stac Leibhinis
Lewis and Harris	celticName	Leòdhas is na Hearadh
Colonsay	celticName	Colbhasa
Skye	celticName	An t-Eilean Sgitheanach
Boreray, St Kilda	celticName	Boraraigh
Stromay	celticName	Sròmaigh
Ceabhaigh	celticName	Ceabhaigh
Orosay	celticName	Orasaigh
Flodaigh, Lewis	celticName	Flodaigh
Fraoch-Eilean	celticName	Fraoch-eilean
Eilean Ceann na Creige	celticName	Eilean Ceann na Creige
Insh, Slate Islands	celticName	Innis
Eilean Mòr, Loch Langavat	celticName	Eilean Mòr
Eilean Horrisdale	celticName	Eilean Thòiriosdal
Eilean Ighe	celticName	Eilean Ighe
Neave Island	celticName	Eilean naomha or Eilean na Coomb
Eilean Hoan	celticName	Eilean Hoan
Eilean Choraidh	celticName	Eilean Choraidh
Innis Mhòr	celticName	Innis Mhòr,
Eilean Trodday	celticName	Eilean Trodday
Eilean Ornsay	celticName	Eilean Ornsay
Harlosh Island	celticName	Eilean Heàrrlois
Eilean Tigh	celticName	Eilean Taighe
Torran Rocks	celticName	Na Torrain
Eilean Mòr, Loch Dunvegan	celticName	Eilean Mòr
Rainish Eilean Mòr	celticName	Rainish Eilean Mòr
Dunglass Island	celticName	Innis Dhùn Ghlais
Fraoch Eilean, Loch Awe	celticName	Fraoch Eilean
The Scares	celticName	Unknown
Campaigh	celticName	Campaigh
Cealasaigh	celticName	Cealasaigh
Bearasaigh	celticName	Bearasaigh
Seanna Chnoc	celticName	Flodaigh
Flodaigh	celticName	Flodaigh
Staffin Island	celticName	Eilean Stafainn
Eileanan Chearabhaigh	celticName	Eileanan Chearabhaigh
Calbha Mor	celticName	Calbha Mor
Ceallasaigh Beag	celticName	Ceallasaigh Beag
Eilean Meadhonach	celticName	Eilean Meadhonach
Contin Island	celticName	Eilean Chunndainn
Eilean na Cille	celticName	Eilean na Cille
Eilean Loain	celticName	Eilean Loain
Eilean dà Mhèinn	celticName	Eilean dà Mhèinn
Lingeigh, North Uist	celticName	Lingeigh
Eilean Dubh, Summer Isles	celticName	Eilein Dhuibh
Flodday, Loch Maddy	celticName	Flodaigh
