AF2	ceo	Jerry Kurz
Nippon Professional Baseball	ceo	Ryozo Kato
Manchester City F.C.	ceo	Ferran Soriano
Ontario Hockey League	ceo	David Branch
Philippine Basketball Association	ceo	Chito Narvasa
EuroLeague	ceo	Jordi Bertomeu
Mitre 10 Cup	ceo	Steve Tew
Indoor Football League	ceo	Kellen Winslow
Indoor Professional Football League	ceo	Mike Storen
Surrey County Cricket Club	ceo	Richard Gould
Middlesex County Cricket Club	ceo	Richard Goatley
San Juan Jabloteh F.C.	ceo	Azaad Khan
World TeamTennis	ceo	Ilana Kloss
Waasland-Beveren	ceo	Dirk Poppe
LPGA of Japan Tour	ceo	Hiromi Kobayashi
Leicestershire County Cricket Club	ceo	Wasim Khan
ULEB	ceo	Tomas Van Den Spiegel
British Columbia Hockey League	ceo	John Grisdale
Western League	ceo	Ban Johnson
Atlantic Coast Hockey League	ceo	Ray Miron
Slovak Extraliga	ceo	Richard Lintner
Saskatchewan Junior Hockey League	ceo	Bill Chow
Heartland League	ceo	President: Jim Gonzales
South Africa national under-19 cricket team	ceo	Haroon Lorgat
Ukrainian Basketball SuperLeague	ceo	Algimantas Pavilonis
Australian Football League	ceo	Gillon McLachlan
Edmonton Brickmen	ceo	Mel Kowalchuk
International Fight League	ceo	Jay Larkin
Liga Española de Baloncesto	ceo	Jorge Garbajosa
Turkish Basketball Federation	ceo	Hedo Türkoğlu
World Indoor Football League	ceo	Gary Tufford
USA Sevens	ceo	Jon Prusmack
Basketball Bundesliga	ceo	Jan Pommer
EuroCup Basketball	ceo	Jordi Bertomeu
Israeli Basketball Premier League	ceo	Shmuel Frenkel
WHA Junior Hockey League	ceo	Bobby Hull
WHA Junior Hockey League	ceo	Ricky Smith
Montenegrin Basketball League	ceo	Milo Đukanović
York Region Shooters	ceo	Tony Bisceglia
FIBA Under-21 World Championship	ceo	Dr. Carl Men Ky Ching
FIBA Under-19 World Championship	ceo	Bob Elphinston
United Football League	ceo	Bill Hambrecht
Major League Roller Hockey	ceo	Doug Jones
Premier League	ceo	Hannes S. Jónsson
Korvpalli Meistriliiga	ceo	Jüri Ratas
Macedonian First League	ceo	Petar Naumoski
Lebanese Basketball League	ceo	Walid Nassar
FIBA Under-17 World Championship	ceo	Bob Elphinston
United National Gridiron League	ceo	Joe Cribbs
South West Football League	ceo	Paul Omodei
National Dodgeball League	ceo	Edward Prentiss
Estonian Basketball Cup	ceo	Jüri Ratas
LEB Plata	ceo	Jorge Garbajosa
PGA Tour	ceo	Tim Finchem
Liga EBA	ceo	Jorge Garbajosa
Major League Roller Hockey AA	ceo	Bill Raue
Metropolitan Swimming	ceo	Mary Fleckenstein
Provincial Women's Hockey League	ceo	Fran Rider, OWHA
European Trophy Junior	ceo	Bo Lennartsson
Second Division Men	ceo	Hannes S. Jónsson
First Division Men	ceo	Hannes S. Jónsson
First Division Women	ceo	Hannes S. Jónsson
Premier league women	ceo	Hannes S. Jónsson
Mediterranean Basketball Association	ceo	George Vassilakopoulos
Mediterranean Basketball Association	ceo	Sheikh Saud Bin Ali Al-Thani
Far West League	ceo	
National Basketball League of Canada	ceo	Dave Magley
American West Hockey League	ceo	Garry Swain
Southern Indoor Football League	ceo	Thom Hager
Lone Star Football League	ceo	Darlene Jones
Japan Women's Baseball League	ceo	Satoshi Katagiri
Ukrainian Women's Basketball SuperLeague	ceo	Wołodymyr Ryżow
Ukrainian Men's Handball Super League	ceo	Valeriy Tretyakov
Ukrainian Women's Handball Super League	ceo	Valeriy Tretyakov
Collegiate Rugby Championship	ceo	Jon Prusmack
Professional Inline Hockey Association Pro Division	ceo	Denis Jelcic
Liga de Desenvolvimento de Basquete	ceo	Cássio Roque
Euroleague Basketball Next Generation Tournament	ceo	Jordi Bertomeu
Trinbago Knight Riders	ceo	Venky Mysore
Balkan Amateur Hockey League	ceo	Martin Milanov
Tunisia Basketball Federation	ceo	Ali Benzarti
Real Mulia F.C.	ceo	Datuk Seri Abang Aditajaya Abang Alwi
Bandon A.F.C.	ceo	?
FIVB Volleyball Men's World Championship	ceo	Ary Graça
FIVB Volleyball Women's World Championship	ceo	Ary Graça
UBA Pro Basketball League	ceo	Todd Mack
AFL Women's	ceo	Gillon McLachlan
USA Volleyball Cup	ceo	Doug Beal
FIVB Volleyball Men's World Cup	ceo	Ary Graça
FIVB Volleyball Women's World Cup	ceo	Ary Graça
Algerian Basketball Federation	ceo	Rabah Bouarifi
Royal Moroccan Basketball Federation	ceo	Mohamed Dinia
Finnish Basketball Federation	ceo	Curt Lindholm
Romanian Basketball Federation	ceo	Carmen Tocala
Slovak Basketball Association	ceo	Rudolf Petrovsky
Netherlands Basketball Federation	ceo	Cees Free
