The Washington Times	chiefeditor	Christopher Dolan
Proletären	chiefeditor	Lars Rothelius
The Wall Street Journal	chiefeditor	Gerard Baker
National Post	chiefeditor	Anne Marie Owens
NRC Handelsblad	chiefeditor	Peter Vandermeersch
De Telegraaf	chiefeditor	Paul Jansen
Aftonbladet	chiefeditor	Jan Helin
Hong Kong Economic Journal	chiefeditor	Alice Kwok Yim-ming
The Australian	chiefeditor	Paul Whittaker
The Indian Express	chiefeditor	Raj Kamal Jha
El País	chiefeditor	Antonio Caño
Asr-e Azadegan	chiefeditor	Mashallah Shamsolvaezin
New York Observer	chiefeditor	Ken Kurson
New York Press	chiefeditor	Jerry Portwood
The Frontier Post	chiefeditor	Rehmat Shah Afridi
WorldNetDaily	chiefeditor	Joseph Farah
FrontPage Magazine	chiefeditor	David Horowitz
East Village Other	chiefeditor	John Wilcock
Brooklyn Eagle	chiefeditor	Thomas N. Schroth
Berliner Zeitung	chiefeditor	Brigitte Fehrle
Moskovskij Komsomolets	chiefeditor	Pavel Nikolayevich Gusev
Calgary Sun	chiefeditor	Jose Rodriquez
Hindustan Times	chiefeditor	Bobby Ghosh
Edmonton Sun	chiefeditor	Dave Breakenridge
Berner Zeitung	chiefeditor	Michael Hug
The National Sports Daily	chiefeditor	Frank Deford
Kauno diena	chiefeditor	Žilvinė Petrauskaitė-Taranda
The New Indian Express	chiefeditor	Prabhu Chawla
The eXile	chiefeditor	Mark Ames
The eXile	chiefeditor	Yasha Levine
The Tribune	chiefeditor	Harish Khare
Dala-Demokraten	chiefeditor	Göran Greider
Zaman	chiefeditor	Abdülhamit Bilici
The Namibian	chiefeditor	Tangeni Amupadhi
Nezavisne novine	chiefeditor	Sandra Gojković-Arbutina
Asharq Al-Awsat	chiefeditor	Salman bin Yousuf Al Dossary
Timpul de dimineață	chiefeditor	Sorina Ștefârță
Cotidianul	chiefeditor	Cornel Nistorescu
El Espectador	chiefeditor	Élber Gutiérrez Roa
Arab Times	chiefeditor	Ahmed Al-Jarallah
Basellandschaftliche Zeitung	chiefeditor	Franz C. Widmer
Deshabhimani	chiefeditor	M.V. Govindan
Le Journal Hebdomadaire	chiefeditor	Aboubakr Jamaï
Respublika	chiefeditor	Vitas Tomkus
Hour Community	chiefeditor	Kevin Laforest
Agos	chiefeditor	Hrant Dink
Agos	chiefeditor	Etyen Mahçupyan
Agos	chiefeditor	Rober Koptaş
Agos	chiefeditor	Yetvart Danzikyan
Jasarat	chiefeditor	Athar Hashmi
Daily Pakistan	chiefeditor	Mujeeb-ur-Rehman Shami
Nasz Dziennik	chiefeditor	Ewa Nowina-Konopka
Al-Watan	chiefeditor	Khalifa Al Ali Al Sabah
Yeni Şafak	chiefeditor	İbrahim Karagül
The Daily Mirror	chiefeditor	Champika Liyanaarachchi
Federal Times	chiefeditor	Tobias Naegele
Al Ahdath Al Maghribia	chiefeditor	Mokhtar Laghzioui
Montreal Gazette	chiefeditor	Lucinda Chodan
De Pers	chiefeditor	Ben Rogmans
Mindanao Pulse	chiefeditor	Elmer Yaun
Mindanao Post	chiefeditor	Doming Rosal
Lok Samvad	chiefeditor	S.P. Kashyap
Mindanao Examiner	chiefeditor	Al Jacinto
Le Nouvelliste	chiefeditor	Frantz Duval
Akinchi	chiefeditor	Hasan bey Zardabi
Saudi Gazette	chiefeditor	Somayya Jabarti
Tuổi Trẻ	chiefeditor	Tăng Hữu Phong
Nya Wermlands-Tidningen	chiefeditor	Staffan Ander
Lokmat	chiefeditor	Vijay J. Darda
Qué!	chiefeditor	Pedro Biurrun
The Juba Post	chiefeditor	Michael Koma
Kantipur	chiefeditor	Sudheer Sharma
Haugesunds Avis	chiefeditor	Bård Borch Michalsen
Finansavisen	chiefeditor	Trygve Hegnar
Jawa Pos Group	chiefeditor	Azrul Ananda
Calcalist	chiefeditor	Yoel Esteron
Proletarian Era	chiefeditor	Provash Ghosh
Ethiopian Reporter	chiefeditor	Name of
Ullern Avis Akersposten	chiefeditor	Ivar Brynildsen
Asia Inc.	chiefeditor	Ho Kay Tat
PR-e-Sense	chiefeditor	Krishnaswamy Srinivasan
Swadeshabhimani	chiefeditor	Swadeshabhimani Ramakrishna Pillai
Al-Wasat	chiefeditor	Mansoor Al-Jamri
GAO Journal	chiefeditor	Stephen Altman
Al-Waqt	chiefeditor	Mansoor Al Jamri
International Journal of Government Auditing	chiefeditor	Donald R. Drach
Colonial Times	chiefeditor	Andrew Bent
Wolverine Citizen	chiefeditor	Francis H. Rankin, Sr.
Wolverine Citizen	chiefeditor	Francis H. Rankin, Jr.
Poduniversal	chiefeditor	K. Srinivasan
The Suburban	chiefeditor	Beryl Wajsman
Janayugom	chiefeditor	Binoy Viswam
Kievan Past	chiefeditor	Feofan Lebedyntsev
Hastings & St. Leonards Observer	chiefeditor	Keith Ridley
The Insider	chiefeditor	Albert J. Neri
The Insider	chiefeditor	John Verbanac( )
Mondoweiss	chiefeditor	Philip Weiss
Mondoweiss	chiefeditor	Adam Horowitz
Västerbottens-Kuriren	chiefeditor	Ingvar Näslund
The Public Record	chiefeditor	James Tayoun, Sr.
The Tab	chiefeditor	Jack Rivlin
Rahbar	chiefeditor	Iraj Eskandari
Cartoon Watch	chiefeditor	Triambak Sharma
Chegemskaya Pravda	chiefeditor	Inal Khashig
Literatura și Arta	chiefeditor	Nicolae Dabija
The Hitavada	chiefeditor	Banwarilal Purohit
La Gerbe	chiefeditor	Marc Augier
The Milli Gazette	chiefeditor	Zafarul Islam Khan
Berkeley Tribe	chiefeditor	Matthew Steen
Iso-Polifonia	chiefeditor	Ramadan Sokoli
Iso-Polifonia	chiefeditor	Vasil Tole
Rilindja Demokratike	chiefeditor	Bledi Kasmi
Maaleht	chiefeditor	Andres Eilart
Jurnal de Chișinău	chiefeditor	Rodica Mahu
Ajit	chiefeditor	Barjinder Singh Hamdard
Daily FT	chiefeditor	Nisthar Cassim
Tiedonantaja	chiefeditor	Marko Korvela
Union Times Today	chiefeditor	Sanjiv Desai
Țara	chiefeditor	Ştefan Secăreanu
Deșteptarea	chiefeditor	Ştefan Secăreanu
Observatorul de Nord	chiefeditor	Victor Cobăsneanu
Gazeta Românească	chiefeditor	Valeriu Saharneanu
Sfatul Țării	chiefeditor	Nicolae Alexandri
Ardealul	chiefeditor	Onisifor Ghibu
România Nouă	chiefeditor	Onisifor Ghibu
Glasul Basarabiei	chiefeditor	Grigore D. Constantinescu
Art press	chiefeditor	Catherine Millet
Cuvântul Liber	chiefeditor	Ion Mititelu
Moldavskie Vedomosti	chiefeditor	Dumitru Ciubaşenco
Unghiul	chiefeditor	Tatiana Cuibaru, Valentina Slotina
Sud-Est	chiefeditor	Valentina Tăzlauanu
Cuvânt Moldovenesc	chiefeditor	Nicolae Alexandri
Cuvânt Moldovenesc	chiefeditor	Pan Halippa
Contrafort	chiefeditor	Vitalie Ciobanu
The Agatya	chiefeditor	Mahbub Jamal Zahedi
Kashmir Observer	chiefeditor	Sajjad Haider
Azerbaijan	chiefeditor	Bakhtiyar Sadigov
The Daily	chiefeditor	Jesse Angelo
Cahiers Octave Mirbeau	chiefeditor	Pierre Michel
Bdnews24.com	chiefeditor	Toufique Imrose Khalidi
Daily Desher Katha	chiefeditor	Gautam Das
Al-Seyassah	chiefeditor	Ahmed Al-Jarallah
Theekkathir	chiefeditor	Ramalingam C
The Voice Weekly	chiefeditor	Kyaw Min Swe
Groznensky Rabochy	chiefeditor	Musa Muradov
Al-Bilad	chiefeditor	Moanes Al Mardi
Democrația	chiefeditor	Ala Mândâcanu
Democrația	chiefeditor	Cornel Ciurea
The Washington Free Beacon	chiefeditor	Matthew Continetti
Al Eqtisadiah	chiefeditor	Salman bin Yousuf Al Dossary
Al-Jarida	chiefeditor	Khalid Alhelal
Wall Street Italia	chiefeditor	Daniele Chicca
Aththa	chiefeditor	Jinadasa Kankanamge
Kombetare	chiefeditor	Ardit Rada
El Tahrir	chiefeditor	Ibrahim Eissa
Azadliq	chiefeditor	Ganimat Zahid
The Sunday Guardian	chiefeditor	M.J. Akbar Beginning-May 2014 \n                         Madhav Das Nalapat June 2014-present
SoL	chiefeditor	Kemal Okuyan
Altüst	chiefeditor	Burak Demir
Guardian Australia	chiefeditor	Emily Wilson
El Medio	chiefeditor	Pablo Kleinman
Diário de Noite	chiefeditor	Luís de Menezes Bragança
The North Queensland Guardian	chiefeditor	Fred Paterson
Nawan Zamana	chiefeditor	Jagjit Singh Anand
Chung Sai Yat Po	chiefeditor	Ng Poon Chew
Janomot	chiefeditor	Syed Nahas Pasha
Arbeter Zeitung	chiefeditor	Moshe Erem
Deenbandhu	chiefeditor	V. R. Krishnan Ezhuthachan
Der Funke	chiefeditor	Willi Eichler
Daily Sabah	chiefeditor	Serdar Karagoz
Rudý večerník	chiefeditor	Ivan Olbracht
La Vie Ouvrière	chiefeditor	Pierre Monatte
Financial Tribune	chiefeditor	Khosro Ghadiri
Le Petit Quotidien	chiefeditor	François Dufour
Madras Musings	chiefeditor	S. Muthiah
La Nation Arabe	chiefeditor	Shakib Arslan
La Nation Arabe	chiefeditor	Ihsan al-Djabri
Complete Sports	chiefeditor	Dr. Sunny Obazu-Ojeagbase
Mayihlome News	chiefeditor	Mmbara Hulisani Kevin
Molod Ukrayiny	chiefeditor	Serhiy Bondarenko
Daily Basharat	chiefeditor	Hamid Hussain
New Medical Gazette	chiefeditor	Andrei Gusev
Weekly Ajdad Islamabad	chiefeditor	Shah Dil Awan
