Food and Drug Administration	child7Agency	National Center for Toxicological Research
United States Department of Homeland Security	child7Agency	National Protection and Programs Directorate
Department of Internal Affairs	child7Agency	New Zealand Office of Ethnic Affairs
Ministry of Health	child7Agency	Traditional Chinese Medicine Practitioners Board
Security Bureau	child7Agency	Hong Kong Police Force
Office of Environment and Heritage	child7Agency	Lord Howe Island Board
Department of Justice	child7Agency	Corrective Services NSW
Minnesota Department of Natural Resources	child7Agency	List of Minnesota state parks
NHS Scotland	child7Agency	Scottish Ambulance Service
Attorney-General's Department	child7Agency	Australian Human Rights Commission
Department of Industry, Innovation, Climate Change, Science, Research and Tertiary Education	child7Agency	Office of the Chief Scientist
Department of the Treasury	child7Agency	Inspector-General of Taxation
California Natural Resources Agency	child7Agency	California Department of Water Resources
Wisconsin Department of Administration	child7Agency	Division of Gaming
Ministry of Commerce, Industry and Tourism	child7Agency	Superintendency of Corporations
Ministry of Health	child7Agency	* Vancouver Island Health Authority
New Jersey Department of Law and Public Safety	child7Agency	New Jersey Division of Law
Ministry of Home Affairs	child7Agency	Singapore Corporation of Rehabilitative Enterprises
Ministry of National Education	child7Agency	Institute for Technical Vocational Training of San Juan del Cesar
Ministry of Trade and Industry	child7Agency	JTC Corporation
Department for Business, Innovation and Skills	child7Agency	Skills Funding Agency
Ministry of Environment, Housing and Territorial Development	child7Agency	Sinchi Amazonic Institute of Scientific Research
Department of Regional Australia, Local Government, Arts and Sport	child7Agency	Australian Institute of Sport
Department of Human Settlements	child7Agency	Social Housing Foundation
Department of Labour	child7Agency	Productivity South Africa
Foreign Ministry of the Independent State of Croatia	child7Agency	Embassy in Rome
The Treasury	child7Agency	Internal Audit Bureau of New South Wales
Puerto Rico fiscal agent and financing	child7Agency	Puerto Rico Municipal Financing Agency
Department of Industry	child7Agency	Office of the Chief Scientist
Department of Agriculture, Fisheries and Forestry	child7Agency	Australian Pesticides and Veterinary Medicines Authority
Ministry of Transport and Civil Aviation	child7Agency	Sri Lanka Transport Board
Alberta Environment and Sustainable Resource Development	child7Agency	default.aspx
Coordinating Ministry for Human Development and Cultural Affairs	child7Agency	Ministry of Education and Culture
