Zhang Ziyi	chinesename	章子怡
Ringo Lam	chinesename	林岭东
Tsui Hark	chinesename	徐克
Twins	chinesename	雙生兒
Joseph Koo	chinesename	顧嘉煇
Cui Jian	chinesename	崔健
Ruan Lingyu	chinesename	阮玲玉
Teresa Teng	chinesename	鄧麗君
Nicholas Tse	chinesename	謝霆鋒
Jerry Yan	chinesename	言承旭
Ken Chu	chinesename	朱孝天
Johnnie To	chinesename	杜琪峯
Takeshi Kaneshiro	chinesename	金城武
Machi	chinesename	麻吉
Russell Wong	chinesename	王盛德
Jiang Wen	chinesename	姜文
Dao Lang	chinesename	刀郎
Liza Wang	chinesename	汪明荃
Joey Wong	chinesename	王祖賢
Yuen Woo-ping	chinesename	袁和平
David Tao	chinesename	陶喆
Zhou Xuan	chinesename	周璇
Nancy Sit	chinesename	薛家燕
Donnie Yen	chinesename	甄子丹
Yuan Muzhi	chinesename	袁牧之
Susanne Hou	chinesename	侯以嘉
Ekin Cheng	chinesename	鄭伊健
Wing	chinesename	曾咏韓
Kenix Kwok	chinesename	郭可盈
Karen Mok	chinesename	莫文蔚
Yuen Qiu	chinesename	元秋
Tian Zhuangzhuang	chinesename	田壯壯
Liu Kai-chi	chinesename	廖啟智
Wong Jing	chinesename	王晶
Chang Fei	chinesename	張菲
Valerie Chow	chinesename	周嘉玲
Kenneth Tsang	chinesename	曾江
Lam Bun	chinesename	林彬
Jessica Hsuan	chinesename	宣萱
Ada Choi	chinesename	蔡少芬
Na Ying	chinesename	那英
At17	chinesename	雁石分天.
Karl Maka	chinesename	麥嘉
Maggie Shiu	chinesename	邵美琪
Jerry Lamb	chinesename	林曉峰
Chin Ka-lok	chinesename	錢嘉樂
Lam Ching-ying	chinesename	林正英
Yu So-chow	chinesename	于素秋
Endy Chow	chinesename	周國賢
George Lam	chinesename	林子祥
Alex Fong	chinesename	方力申
Peter Pau	chinesename	鮑德熹
Barbara Yung	chinesename	翁美玲
Melissa Ng	chinesename	吳美珩
Athena Chu	chinesename	朱茵
Joyce Cheng	chinesename	鄭欣宜
Annie Yi	chinesename	伊能靜
He Ping	chinesename	何平
Gigi Lai	chinesename	黎姿
Mandy Cho	chinesename	曹敏莉
Marco Ngai	chinesename	魏駿傑
Li Nanxing	chinesename	李南星
Jimmy Wang Yu	chinesename	王羽
Tsai Chin	chinesename	周采芹
Ella Koon	chinesename	官恩娜
Dick Lee	chinesename	李迪文
Kate Tsui	chinesename	徐子珊
Karena Lam	chinesename	林嘉欣
Eman Lam	chinesename	林二汶
Jenny Tseng	chinesename	甄妮
Yvonne Yung	chinesename	翁虹
Michael Wong	chinesename	王光良
Mayday	chinesename	五月天
Chew Chor Meng	chinesename	周初明
Qi Yuwu	chinesename	戚玉武
Jan Lamb	chinesename	林海峰
Tanya Chua	chinesename	蔡健雅
Danny Lee	chinesename	李修賢
Dadawa	chinesename	朱哲琴
Grasshopper	chinesename	草蜢
Li Xuejian	chinesename	李雪健
Diana Pang	chinesename	彭丹
Wu Bai	chinesename	伍佰
Ivana Wong	chinesename	王菀之
Li Xiaolu	chinesename	李小璐
Pang brothers	chinesename	彭發
Pang brothers	chinesename	彭順
Kelly Lin	chinesename	林熙蕾
Xia Yu	chinesename	夏雨
Sammy Leung	chinesename	森美
Cai Chusheng	chinesename	蔡楚生
Dion Lam	chinesename	林迪安
Myolie Wu	chinesename	胡杏兒
Annie Man	chinesename	文頌嫻
Angela Mao	chinesename	茅瑛
Yuen Siu-tien	chinesename	袁小田
Sandra Ng	chinesename	吳君如
Sam Lee	chinesename	李璨琛
Louise Lee	chinesename	李司棋
Joanne Peh	chinesename	白薇秀
Li Bingbing	chinesename	李冰冰
Sonija Kwok	chinesename	郭羨妮
Don Li	chinesename	李逸朗
Benny Yau	chinesename	邱穟恆
Eric Wan	chinesename	尹天照
Lawrence Chou	chinesename	周俊偉
Tiffany Lam	chinesename	林敏俐
Gloria Yip	chinesename	葉蘊儀
Li Qian	chinesename	李倩
Ang Ching Hui	chinesename	翁沁慧
Maria Cordero	chinesename	瑪俐亞
Kang Kang	chinesename	康晉榮
Ah Niu	chinesename	阿牛
Alex Fong	chinesename	方中信
Natalie Wong	chinesename	黃𨥈瑩
Queenie Chu	chinesename	朱慧敏
Tsai Chin	chinesename	蔡琴
Janet Chow	chinesename	周家蔚
Ariel Lin	chinesename	林依晨
Soo Kui Jien	chinesename	苏桂健
2moro	chinesename	郭彥均、郭彥甫
Ren Yexiang	chinesename	任冶湘
Michael Tao	chinesename	陶大宇
Philip Kwok	chinesename	郭追
Nina Li	chinesename	利智
Frankie Lam	chinesename	林文龍
Yoyo Mung	chinesename	蒙嘉慧
Phyllis Quek	chinesename	郭妃麗
Yu Jim-yuen	chinesename	于占元
Lam Suet	chinesename	林雪
Raymond Cho	chinesename	曹永廉
Runme Shaw	chinesename	邵仁枚
Lin Xi	chinesename	林夕
Hu Ge	chinesename	胡歌
Teresa Mo	chinesename	毛舜筠
Kang Cheng Xi	chinesename	江承熹
Eugenia Yuan	chinesename	原麗淇
Blackie Ko	chinesename	柯受良
Louisa So	chinesename	蘇玉華
Terence Yin	chinesename	尹子維
Khalil Fong	chinesename	方大同
Sarah Song	chinesename	宋熙年
Shawn Tng	chinesename	唐志瑋
Yao Lee	chinesename	姚莉
Bak Sheut-sin	chinesename	白雪仙
Wei Zi	chinesename	巍子
Gary Chaw	chinesename	曹格
Evan Yo	chinesename	蔡旻佑
Becky Lee	chinesename	李璧琦
Bill Tung	chinesename	董驃
Canti Lau	chinesename	劉錫明
Teresa Cheung	chinesename	章小蕙
Ngo Ka-nin	chinesename	敖嘉年
Timi Zhuo	chinesename	卓依婷
Lotus	chinesename	蓮花樂隊
You Yong	chinesename	尤勇
Bai Guang	chinesename	白光
Bai Hong	chinesename	白虹
Shek Sau	chinesename	石修
Wang Quan'an	chinesename	王全安
Vincent Fang	chinesename	方文山
Jasmine	chinesename	庭竹
Ha Yu	chinesename	夏雨
Wang Leehom	chinesename	王力宏
Hou Yaowen	chinesename	侯耀文
Tiffany Tang	chinesename	唐嫣
Yu Haoming	chinesename	俞灏明
Hoyan Mok	chinesename	莫可欣
Michelle Yim	chinesename	米雪
Four Golden Flowers	chinesename	四朵金花
Sandra Lang	chinesename	仙杜拉
The Chopsticks	chinesename	筷子姊妹花
Yau Nai-hoi	chinesename	游乃海
Namewee	chinesename	黃明志
Cecilia Yip	chinesename	葉童
Eddy Ko	chinesename	高雄
Wong He	chinesename	王喜
Angela Pan	chinesename	潘迎紫
Chan Kwong-wing	chinesename	陳光榮
Li Yu	chinesename	李玉
Wang Bing	chinesename	王兵
Joseph Chang	chinesename	張孝全
An Youqi	chinesename	安又琪
Amguulan	chinesename	阿穆隆
Genie Chuo	chinesename	卓文萱
Pu Cunxin	chinesename	濮存昕
Jiang Wu	chinesename	姜武
Lee Siu-kei	chinesename	李兆基
William Chang	chinesename	張叔平
Kirk Wong	chinesename	黃志強
Chor Yuen	chinesename	楚原
Gordon Chan	chinesename	陳嘉上
Alfred Cheung	chinesename	張堅庭
Jonathan Lee	chinesename	李宗盛
Yvonne Lim	chinesename	林湘萍
Da Mouth	chinesename	大嘴巴
Huang Wenyong	chinesename	黃文永
Toby Leung	chinesename	梁靖琪
Diao Yinan	chinesename	刁亦男
Cai Shangjun	chinesename	蔡尚君
Angus Tung	chinesename	童安格
Dee Hsu	chinesename	徐熙娣
Waise Lee	chinesename	李子雄
Paul Chun	chinesename	秦沛
Wong Tin-lam	chinesename	王天林
Claire Yiu	chinesename	姚嘉妮
Martin Chappell	chinesename	卓保怡
Jim Tang	chinesename	鄧永健
Wang Guangli	chinesename	王光利
Pakho Chau	chinesename	周柏豪
Jade Leung	chinesename	梁琤
Maria Yi	chinesename	衣依
Lu Yi-ching	chinesename	陸弈靜
Wang Chao	chinesename	王超
Cathy Leung	chinesename	梁雨恩
Jolene Chin	chinesename	陈影雯
Siqin Gaowa	chinesename	斯琴高娃
Pang Ho-cheung	chinesename	彭浩翔
Jacky Heung	chinesename	向佐
Tsui Siu-Ming	chinesename	徐小明
Wang Yu	chinesename	王昱
Wang Yuqing	chinesename	王昱青
Wayne Lai	chinesename	黎耀祥
Bianca Bai	chinesename	白歆惠
Yoga Lin	chinesename	林宥嘉
Chu Yen-ping	chinesename	朱延平
Ivy Ho	chinesename	岸西
Huo Jianqi	chinesename	霍建起
Lung Fong	chinesename	Wikt:
Hong Huifang	chinesename	洪慧芳
Li Wenhai	chinesename	李文海
Huang Yiliang	chinesename	黄奕良
Li Shing-cheong	chinesename	李成昌
Lina Ng	chinesename	黄嫊方
Stefan Wong	chinesename	黃長興
Vincent Kok	chinesename	谷德昭
Deng Jie	chinesename	鄧婕
John Cheng	chinesename	鍾耀南
Tsai Yi-chen	chinesename	蔡頤臻
Michael Chow	chinesename	周文健
Jutoupi	chinesename	朱約信
Arthur Wong	chinesename	黃岳泰
Wang Fuli	chinesename	王馥荔
Shang Wenjie	chinesename	尚雯婕
Ming Dao	chinesename	明道
Edelweiss Cheung	chinesename	張舒雅
Candy Chu	chinesename	朱婉儀
George Hu	chinesename	胡宇威
Soh Hang-suen	chinesename	蘇杏璇
Patricia Mok	chinesename	小玲
Nancy Wu	chinesename	胡定欣
Cheng Gwan-min	chinesename	君綿
Tin Kai-man	chinesename	田啟文
Jing Boran	chinesename	井柏然
Nicole Lai	chinesename	黎珈仪
Zhu Houren	chinesename	朱厚任
Kiki Sheung	chinesename	商天娥
Kym	chinesename	金莎
Kym	chinesename	Jin Sha
Rosanne Wong	chinesename	黃婉君
Jo Kuk	chinesename	谷祖琳
A-One	chinesename	A-One 组合
Siu Yam-yam	chinesename	邵音音
Sheng Zhimin	chinesename	盛志民
Cao Baoping	chinesename	曹保平
Lau Kong	chinesename	劉江
Roy Chiao	chinesename	喬宏
Huang Bo	chinesename	黄渤
François Wong	chinesename	黃長發
Edward Ou	chinesename	歐定興
Guo Tao	chinesename	郭涛
Yu Quan	chinesename	羽泉
Guan Hu	chinesename	管虎
Suki Chui	chinesename	徐淑敏
Hsie Zhen-wu	chinesename	謝震武
He Qun	chinesename	何群
Bak Man-biu	chinesename	白文彪
Baron Chen	chinesename	陳楚河
Leung Sing-Bor	chinesename	梁醒波
Loong Kin Sang	chinesename	龍劍笙
Vin Choi	chinesename	蔡淇俊
Law Lan	chinesename	羅蘭
Yan Ni	chinesename	闫妮
Chan Hung-lit	chinesename	陳鴻烈
Lawrence Cheng	chinesename	鄭丹瑞
Louis Fan	chinesename	樊少皇
Joan Lin	chinesename	林鳳嬌
Wang Zi	chinesename	王子
Adele Wong	chinesename	王惠珊
MeiMei Kuo	chinesename	郭婕祈
Mark Kwok	chinesename	郭耀明
Eddie Chow	chinesename	周俊威
Timmy Hung	chinesename	洪天明
Choc7	chinesename	超克7
Lo Hoi-pang	chinesename	盧海鵬
Xiao Xun	chinesename	Xiao Xun
Hung Yan-yan	chinesename	熊欣欣
Dylan Kuo	chinesename	郭品超
Huo Siyan	chinesename	霍思燕
Hu Mei	chinesename	胡玫
Crowd Lu	chinesename	卢广仲
Johnson Lee	chinesename	李思捷
Cheng Bugao	chinesename	程步高
Kong Lin	chinesename	孔琳
Paul Wei Ping-ao	chinesename	魏平澳
Lee Kwan	chinesename	李昆
Chrissie Chau	chinesename	周秀娜
Xiao Man	chinesename	Wang Cheng Yen
Jack Kao	chinesename	高捷
Li Lingyu	chinesename	李玲玉
Lene Lai	chinesename	賴琳恩
Li Xiaoran	chinesename	李小冉
Li Jing	chinesename	利菁
Pan Lingling	chinesename	潘玲玲
Van Fan	chinesename	范逸臣
Su Xing	chinesename	苏醒
Liljay	chinesename	小傑
Yang Lei	chinesename	阳蕾
Owodog	chinesename	敖犬
Lydia Shum	chinesename	沈殿霞
Jaime Chik	chinesename	戚美珍
Kristal Tin	chinesename	田蕊妮
Elanne Kong	chinesename	江若琳
Vic Chou	chinesename	周渝民
Vincent Wong	chinesename	王浩信
He Zhuoyan	chinesename	何琢言
Shin	chinesename	蘇見信
Wayne Chua	chinesename	蔡佩璇
Jing Chang	chinesename	張芸京
Li Lili	chinesename	黎莉莉
Ron Heung	chinesename	香子俊
Qin Hao	chinesename	秦昊
Mark Chao	chinesename	趙又廷
Cool Silly	chinesename	傻酷
Zhu Yuchen	chinesename	朱雨辰
Hou Yong	chinesename	侯勇
Feng Xiaoning	chinesename	馮小寧
Lyndel Soon	chinesename	孙玉心
Yu Chenghui	chinesename	于承惠
Du Chun	chinesename	杜淳
Jess Sum	chinesename	沈卓盈
Lu Chen	chinesename	路晨
Wei Wei	chinesename	韦伟
David Siu	chinesename	邵仲衡
Aarif Rahman	chinesename	李治廷
Meilin Gray	chinesename	梅琳
Hu Die	chinesename	胡蝶
Fiona Fung	chinesename	馮曦妤
Wen Zhang	chinesename	文章
Lori Chow	chinesename	周美欣
Chui Tien-you	chinesename	徐天佑
Qin Yi	chinesename	秦怡
Billy Chung	chinesename	鍾少雄
Li Xiaoyun	chinesename	李霄云
Wang Feng	chinesename	汪峰
1976	chinesename	1976
Zeng Huifen	chinesename	曾慧芬
Bii	chinesename	毕书尽
Jess Lee	chinesename	李佳薇
Lydia Li	chinesename	李狄維
Tao Ching-Ying	chinesename	陶晶莹
Comic Boyz	chinesename	可米小子
Samingad	chinesename	紀曉君
William Chak	chinesename	翟威廉
Grace Wong	chinesename	王君馨
Song Chunli	chinesename	宋春丽
Zheng Zhenyao	chinesename	郑振瑶
Jun Kung	chinesename	恭碩良
24Herbs	chinesename	廿四味
Cheuk Wan-chi	chinesename	卓韻芝
Batdorj-in Baasanjab	chinesename	巴森扎布
Sandee Chan	chinesename	陳珊妮
Yuan Hong	chinesename	袁弘
He Jiong	chinesename	何炅
Lin Gengxin	chinesename	林更新
Yu Mo-lin	chinesename	余慕蓮
Xie Na	chinesename	谢娜
JPM	chinesename	JPM
Hu Xia	chinesename	胡夏
Jia Nailiang	chinesename	贾乃亮
Cui Peng	chinesename	崔鹏
Ni Ni	chinesename	倪妮
Miao Pu	chinesename	苗圃
Meng Jia	chinesename	孟佳
Qi Wei	chinesename	戚薇
Kitty Yuen	chinesename	阮小儀
Griselda Yeung	chinesename	楊卓娜
Wang Yumei	chinesename	王玉梅
Huang Zitao	chinesename	黄子韬
Jin Chao-chun	chinesename	金超群
Lam Tsz-sin	chinesename	林子善
Sibelle Hu	chinesename	胡慧中
Catherine Chau	chinesename	周家怡
Mat Yeung	chinesename	楊明
Li Yugang	chinesename	李玉刚 （李玉剛）
Chu Ke-liang	chinesename	豬哥亮
Oscar Leung	chinesename	梁烈唯
Xu Fan	chinesename	徐帆
Shao Bing	chinesename	邵兵
Guo Liang	chinesename	郭亮
Samuel Tai	chinesename	邰正宵
Thomas Ong	chinesename	王沺裁
Wanting Qu	chinesename	曲婉婷
Betty Zhou	chinesename	周玲安
Angel Chiang	chinesename	蔣家旻
Vincent Wan	chinesename	Wen Jia Heng
Dennis To	chinesename	杜宇航
Annie Liu	chinesename	刘止人
Kong Ngai	chinesename	江毅
Song Wenfei	chinesename	宋汶霏
Bonnie Loo	chinesename	罗美仪
Bai Baihe	chinesename	白百何
Yang Kun	chinesename	杨坤
Guan Zhe	chinesename	关喆
Kenneth Chung	chinesename	钟坤华
Ed Yen	chinesename	嚴子貿
Mao Di	chinesename	毛弟
Nick Chou	chinesename	周湯豪
Lau Wai Ming	chinesename	劉惠鳴
Jiang Xin	chinesename	蔣欣
Priscilla Wong	chinesename	黃翠如
Kaki Leung	chinesename	梁嘉琪
Billy Lau	chinesename	樓南光
Hung Sin-nui	chinesename	紅線女
Angel Lai Wei Li	chinesename	Angel 贝贝
Lin Xiawei	chinesename	林夏薇
Athena Lee Yen	chinesename	李燕
Yako Chan	chinesename	丫頭
Yao Yao	chinesename	瑶瑶
Lyan Cheng	chinesename	程予希
Liao Fan	chinesename	廖凡
Chris Wang	chinesename	宥勝
Julie Tan	chinesename	陈欣淇
Mini Chang	chinesename	筱婕/小婕/甯兒
Dada Chan	chinesename	陳靜
Iris Chung	chinesename	鍾采羲
Megan Lai	chinesename	賴雅妍
Jeannie Chan	chinesename	陳瀅
Figaro Tseng	chinesename	曾少宗
Joyce Chu	chinesename	四葉草
Tracy Chu	chinesename	朱千雪
Xu Bin	chinesename	徐彬
Kimberly Chia	chinesename	谢静仪
Ian Fang	chinesename	方伟杰
Jia Jia	chinesename	家家
Hu Qiaohua	chinesename	胡乔华
Lee Shih Shiong	chinesename	李偲菘
Luhan	chinesename	鹿晗
Kris Wu	chinesename	吴亦凡
Chung Fat	chinesename	鍾發
TFBoys	chinesename	加油少年
Funky Brothers	chinesename	放客兄弟
Ferlyn Wong	chinesename	黃晶玲
Natasha Low	chinesename	劉怡伶
Aloysius Pang	chinesename	冯伟衷
Carrie Wong	chinesename	黄思恬
Somaline Ang	chinesename	洪凌
Melody Tan	chinesename	陈永馨
Jeffrey Xu	chinesename	徐鸣杰
Kate Yeung	chinesename	楊淇
Hannah Quinlivan	chinesename	昆凌
Li Jian	chinesename	李健
Tang Kee-chan	chinesename	鄧寄塵
Wang Likun	chinesename	王丽坤
Yao Yuanhao	chinesename	姚元浩
Naren Hua	chinesename	娜仁花
Yan Bingyan	chinesename	颜丙燕
Ai Liya	chinesename	艾丽娅
Xi Meijuan	chinesename	奚美娟
Song Xiaoying	chinesename	宋晓英
Jonathan Cheung	chinesename	張頴康
Angel Lam	chinesename	林安淇
Rachel Lam	chinesename	林熹瞳
Jayley Woo	chinesename	胡佳琪
Shen Teng	chinesename	沈腾
Seraph Sun	chinesename	孙欣佩
Guntzepaula	chinesename	槍擊潑辣
Sara Chang	chinesename	张蔷
Youyi	chinesename	有懿
Ai Xia	chinesename	艾霞
Pu Shunqing	chinesename	濮舜卿
Xie Fang	chinesename	谢芳
Su Miaoling	chinesename	苏妙玲
AGA	chinesename	江海迦
Hayley Woo	chinesename	胡佳嬑
Han Ying-chieh	chinesename	韩英杰
Huang Tsung Hsing	chinesename	黃宗迅
Nick Teo	chinesename	张鈞淯
Li Li-Hua	chinesename	李麗華
Ali Lee	chinesename	李佳芯
Daniela Anahi Bessia	chinesename	安达
Qi Qi	chinesename	琪琪
Yuen Shun-yi	chinesename	袁信义
Omnipotent Youth Society	chinesename	万能青年旅店
Chan Wui-ngai	chinesename	陈会毅
Vicky Wong Wai-Kit	chinesename	黃偉傑
Dino Lee	chinesename	李玉璽
Darren Wang	chinesename	王大陸
Dewi Chien	chinesename	簡廷芮
Wang Qing	chinesename	王青
Jin Yinji	chinesename	金银姬
Desmond Ng	chinesename	黄振隆
Guan Xiaotong	chinesename	关晓彤
Ma Li	chinesename	马丽
Li Youbin	chinesename	李幼斌
Feng Jianyu	chinesename	冯建宇
Perhat Khaliq	chinesename	帕尔哈提
Kelly Fu	chinesename	傅嘉莉
Li Ruijun	chinesename	李睿珺
Zhang Tianai	chinesename	张天爱
Leo Wu	chinesename	吴磊
Liu Haoran	chinesename	劉昊然
