Annals of Mathematics	coden	ANMAAH
Constellations	coden	CNSTES
Cell Cycle	coden	CCEYAS
United Nations Economic Commission for Europe	coden	SJUED4
Nature	coden	NATUAS
Bulletin of the Atomic Scientists	coden	BASIAP
Foreign Affairs	coden	FRNAA3
Science	coden	SCIEAS
The Astronomical Journal	coden	ANJOAA
Proceedings of the National Academy of Sciences of the United States of America	coden	PNASA6
Health Economics	coden	HEECEZ
Physical Review Focus	coden	PRFHAQ
The Lancet	coden	LANCAO
Econometrica	coden	ECMTA7
The New England Journal of Medicine	coden	NEJMAG
Cancer Cell	coden	CCAECI
JAMA	coden	JAMAAP
The BMJ	coden	DXRA5
Chemical Abstracts Service	coden	CHABA8
Journal of Theoretical Biology	coden	JTBIAP
Harvard Law Review	coden	HALRAF
Annals of Human Genetics	coden	ANHGAA
Physical Review Letters	coden	PRLTAO
Zeitschrift für Physikalische Chemie	coden	ZPCFAX
Journal of Near-Death Studies	coden	JNDAE7
Monthly Notices of the Royal Astronomical Society	coden	MNRAA4
Nature Neuroscience	coden	NANEFN
Columbia Law Review	coden	COLRAO
SIAM Journal on Computing	coden	SMJCAT
Zoological Science	coden	ZOSCEX
Zoological Journal of the Linnean Society	coden	ZJLSA7
Zeitschrift für Angewandte Mathematik und Physik	coden	ZAMPDB
International Organization	coden	IOCMFZ
International Journal of Medical Sciences	coden	IJMSGZ
International Journal of Biological Sciences	coden	IJBSB9
Journal of the British Interplanetary Society	coden	JBISAW
Journal of Financial Economics	coden	JFECDT
Tropical Grasslands	coden	TRGRB4
Biometrika	coden	BIOKAX
Journal of the American Chemical Society	coden	JACSAT
Oikos	coden	OIKSAA
Journal of Fluid Mechanics	coden	JFLSA7
Arkivoc	coden	AKVCFI
Nucleic Acids Research	coden	NARHAD
Organic Syntheses	coden	ORSYAT
Mankind Quarterly	coden	MKQUA4
Mankind Quarterly	coden	MAQUE6
Intelligence	coden	NTLLDT
Nature Reviews Urology	coden	NRNADQ
Nature Reviews Molecular Cell Biology	coden	NRMCBP
IEEE Transactions on Information Theory	coden	IETTAW
Journal of Economic Theory	coden	JECTAQ
Genome Research	coden	GEREFS
Neuron	coden	NERNET
Nature Reviews Gastroenterology & Hepatology	coden	NRGHA9
Isis	coden	ISISA4
British Journal of Social Psychology	coden	BJSPDA
Molecules	coden	MOLEFW
Beilstein Journal of Organic Chemistry	coden	BJOCBH
Journal of Artificial Intelligence Research	coden	JAIRFR
Philosophical Magazine	coden	PMHABF
Angewandte Chemie	coden	ACIEF5 , ANCEAD
Journal of the Association for Information Science and Technology	coden	JASIEF
BioEssays	coden	BIOEEJ
IEEE Annals of the History of Computing	coden	IAHCEX
Economics Letters	coden	ECLEDS
IEEE Transactions on Software Engineering	coden	IESEDJ
Journal of Homosexuality	coden	JOHOD7
Chemical Communications	coden	CHCOFS
Journal of Organic Chemistry	coden	joceah
Journal of Molecular Biology	coden	JMOBAK
Journal of Clinical Investigation	coden	JCINAO
Journal of Biogeography	coden	JBIODN
Computational Intelligence	coden	COMIE6
Developmental Biology	coden	DEBIAO
Blood	coden	BLOOAW
Chemische Berichte	coden	BDCGAS
Chemische Berichte	coden	CHBEAM
Chemische Berichte	coden	CHBRFW
Tetrahedron	coden	TETRAB
Advances in Physics	coden	ADPHAH
The Auk	coden	AUKJAF
Journal of Physical Chemistry A	coden	jpcafh
Public Opinion Quarterly	coden	POPQAE
Southern Economic Association	coden	SECJAR
Annals of Emergency Medicine	coden	AEMED3
American Journal of Psychiatry	coden	AJPSAO
Chemical Reviews	coden	CHREAY
Journal of Medicinal Chemistry	coden	JMCMAR
Organic Letters	coden	ORLEF7
ACS Combinatorial Science	coden	jcchff
Accounts of Chemical Research	coden	ACHRE4
Materials Today	coden	MTOUAN
JAMA Neurology	coden	ANNED3
JAMA Pediatrics	coden	APAMEB
Endocrinology	coden	ENDOAO
Behavioral and Brain Sciences	coden	BBSCDH
Iranian Studies	coden	IRSTEK
The Economic Journal	coden	ECJOAB
Applied Physics Letters	coden	APPLAB
Science & Justice	coden	SJUSFE
American Journal of Physics	coden	AJPIAS
American Journal of Botany	coden	AJBOAA
Cell	coden	CELLB5
Biochemical Journal	coden	BIJOAK
The EMBO Journal	coden	EMJ0DG
Faraday Discussions	coden	FDISE6
Journal of the Chemical Society, Faraday Transactions	coden	JCFTEV
Physical Chemistry Chemical Physics	coden	PPCPFQ
Chemical Society Reviews	coden	CSRVBR
Dalton Transactions	coden	DTARAF
Organic and Biomolecular Chemistry	coden	OBCRAK
Green Chemistry	coden	GRCHFJ
Nature Materials	coden	NMAACR
Reviews of Modern Physics	coden	RMPHAT
Geophysical Research Letters	coden	GPRLAJ
The American Historical Review	coden	AMHRA2
American Journal of Sociology	coden	AJSOAR
Mathematics of Computation	coden	MCMPAF
Journal of Geophysical Research	coden	JGREA2
Journal of Library Administration	coden	JLADEL
Earth Interactions	coden	EINTFP
Monthly Weather Review	coden	MWREAB
Journal of Physical Oceanography	coden	JPYOBT
Chemistry Education Research and Practice	coden	CERPCE
The Journal of Finance	coden	JLFIAN
Inventiones Mathematicae	coden	INVMBH
Journal of Health Psychology	coden	JHPSFC
Pediatric Research	coden	PEREBL
Journal of Economic Literature	coden	JECLB3
Analytical Chemistry	coden	ANCHAM
Feminist Studies	coden	FMSDA2
Heart	coden	HEARFR
Talanta	coden	TLNTA2
Middle East Quarterly	coden	MEQUFZ
Nature Chemical Biology	coden	NCBABT
Journal of Virology	coden	JOVIAM
Small Business Economics	coden	SBECEX
Nature Nanotechnology	coden	NNAABX
Administrative Science Quarterly	coden	ASCQAG
Topology	coden	TPLGAF
Emerging Infectious Diseases	coden	EIDIFA
Chemistry: A European Journal	coden	CEUJED
Bulletin of the Chemical Society of Japan	coden	BCSJA8
Chemistry Letters	coden	CMLTAG
Canadian Journal of Chemistry	coden	CJCHAG
Journal of Chemical Physics	coden	JCPSA6
Journal of Biological Chemistry	coden	JBCHA3
Langmuir	coden	LANGD5
Inorganic Chemistry	coden	INOCAJ
Proceedings of the American Mathematical Society	coden	PAMYAR
Critical Review	coden	CTRVE3
Cancer Research	coden	CNREA8
BioScience	coden	BISNAS
Rapid Communications in Mass Spectrometry	coden	RCMSEF
Contemporary Sociology	coden	C0S0AG
Evolution and Human Behavior	coden	EHIBEF
The Information Society	coden	INSCD8
Copeia	coden	COPAAR
Antiviral Therapy	coden	ANTHFA
AIDS	coden	AIDSET
International Journal of Middle East Studies	coden	IJMECN
Journal of Chemical Information and Modeling	coden	JCISD8
Molecular Informatics	coden	MIONBS
Methods in Enzymology	coden	MENZAU
Journal of Bacteriology	coden	JOBAAY
Critical Care Medicine	coden	CCMDC7
Biophysical Journal	coden	BIOJAU
Chemical & Engineering News	coden	CENEAR
Information Systems Research	coden	ISYREH
Management Information Systems Quarterly	coden	MISQDP
Personality and Individual Differences	coden	PEIDD9
European Journal of Human Genetics	coden	EJHGEU
Liebigs Annalen	coden	LACHDL
modernity	coden	MMODFU
Molecular Biology of the Cell	coden	MBCEEV
Measurement Science and Technology	coden	MSTCEP
Metrologia	coden	MTRGAU
NeuroImage	coden	NEIMEF
Qualitative Inquiry	coden	QUINFS
Quality Assurance Journal	coden	QAJOFW
Quality Engineering	coden	QEUNA5
Quarterly Journal of Engineering Geology & Hydrogeology	coden	QJEGB8
Chest	coden	CHETBF
The Library Quarterly	coden	LIBQAS
Clinical Medicine	coden	CMLUBK
Antimicrobial Agents and Chemotherapy	coden	AMACCQ
Spine	coden	SPINDD
Primates	coden	PRMTBU
Archives of Sexual Behavior	coden	ASXBA
Journal of Experimental Medicine	coden	JEMEAV
Nature Medicine	coden	NAMEFI
Annals of Internal Medicine	coden	AIMEAS
American Journal of Human Genetics	coden	AJHGAG
The Journal of Allergy and Clinical Immunology	coden	JACIBY
Advanced Functional Materials	coden	AFMDC6
European Journal of Organic Chemistry	coden	EJOCFK
Soft Matter	coden	SMOABF
Journal of Materials Chemistry	coden	JMACEP
Acta Mathematica	coden	ACMAA8
New Journal of Chemistry	coden	NJCHE5
Photochemical and Photobiological Sciences	coden	PPSHCB
Analyst	coden	ANALAO
Optics Letters	coden	OPLEDP
Applied Optics	coden	APOPAI
Energy & Environment	coden	EENVE2
Journal of High Energy Physics	coden	JHEPAB
CrystEngComm	coden	CRECF4
The Canadian Entomologist	coden	CAENAF
Journal of Avian Biology	coden	JAVBE9
Journal of Chemical Education	coden	JCEDA8
Aristotelian Society	coden	PRASE4
Journal of Analytical Atomic Spectrometry	coden	JASPE2
Natural Product Reports	coden	NPRRDF
Lab on a Chip	coden	LCAHAM
American Journal of Archaeology	coden	AJARAE
Crustaceana	coden	CRUSAP
Automation and Remote Control	coden	AURCAT
American Journal of Psychology	coden	AJPCAA
Australian Journal of Chemistry	coden	AJCHAS
Mobilization	coden	MOBLF3
Industrial & Engineering Chemistry Research	coden	IECRED
Journal of the Royal Society Interface	coden	JRSICU
Journal of Accounting and Economics	coden	JAECDS
Proceedings of the Chemical Society	coden	PCSLAW
European Physical Journal C	coden	EPCFFB
Human Relations	coden	HUREAA
International Journal of Mathematics and Mathematical Sciences	coden	INTJM4
Journal of Personality and Social Psychology	coden	JPSPB2
Journal of Number Theory	coden	JNUTA9
IEEE Transactions on Evolutionary Computation	coden	ITEVF5
The Physics Teacher	coden	PHTEAH
Journal of Mathematical Physics	coden	JMAPAQ
Psychological Bulletin	coden	PSBUAI
Journal of Food Science	coden	JFDSAZ
Xenobiotica	coden	XENOBH
Journal of Ornithology	coden	JORNAH
Physical Review B	coden	PRBMDO
Journal of the West	coden	JNLWA7
Optical Review	coden	OPREFN
Journal of Applied Physics	coden	JAPIAU
Journal of Physics B	coden	JPAPEH
Journal of Physics A	coden	JPAMB5
Optics Communications	coden	OPCOB8
Lebensmittel-Wissenschaft & Technologie	coden	LBWTAP
American Journal of Public Health	coden	AJHEAA
Nations and Nationalism	coden	NANAFB
Israel Journal of Psychiatry and Related Sciences	coden	IPRDAH
Journal of Clinical Psychology	coden	JCPYAO
Organometallics	coden	orgnd7
International Feminist Journal of Politics	coden	IJOIED
The Medical Letter on Drugs and Therapeutics	coden	MELEAP
Ecology Letters	coden	ECLEFU
Innovative Food Science and Emerging Technologies	coden	IFSEBO
Applied Physics B	coden	APBOEM
Applied Physics A	coden	APAMFC
International Journal of Hydrogen Energy	coden	IJHEDX
Social Problems	coden	SOPRAG
Medical Hypotheses	coden	MEHYDY
Infection and Immunity	coden	INFIBR
Clinical Microbiology Reviews	coden	CMIREX
Clinical and Vaccine Immunology	coden	CVILA6
Journal of Clinical Microbiology	coden	JCMIDW
Microbiology and Molecular Biology Reviews	coden	MMBRF7
Neuropsychopharmacology	coden	NEROEW
Radical Philosophy	coden	RAPHEH
Drug and Alcohol Dependence	coden	DADEDV
Reports on Progress in Physics	coden	RPPHAG
Public Understanding of Science	coden	PUNSEM
Journal of the Royal Society of Medicine	coden	JRSMD9
Journal of Modern Optics	coden	JMOPEW
Medical Law International	coden	MLINFN
The Journal of the Learning Sciences	coden	JLSBE3
Journal of Political Economy	coden	JLPEAR
Journal of the Physical Society of Japan	coden	JUPSAU
Climate Dynamics	coden	CLDYEM
Current Science	coden	CUSCAM
Laser Physics	coden	LAPHEJ
Chelonian Conservation and Biology	coden	CCOBED
Acta Zoologica: Morphology and Evolution	coden	AZOSAT
The Professional Geographer	coden	PFGGAC
Area	coden	AREAB6
Japanese Journal of Applied Physics	coden	JJAPB6
FEBS Journal	coden	FJEOAC
Solid State Communications	coden	SSCOA4
Philosophical Transactions of the Royal Society A	coden	PTMSFB
Philosophical Transactions of the Royal Society B	coden	PTRBAE
Australasian Plant Pathology	coden	AAPPDN
Conservation Biology	coden	CBIOEF
Journal of Mass Spectrometry	coden	JMSPFJ
Molecular Plant Pathology	coden	MPPAFD
Historia Mathematica	coden	HIMADS
Climatic Change	coden	CLCHDX
The New Zealand Medical Journal	coden	NZMJAX
Journal of Invertebrate Pathology	coden	JIVPAZ
Journal of Approximation Theory	coden	JAXTAZ
Journal of Biology	coden	JBOIAW
Journal of Computational Chemistry	coden	JCCHDD
Annual Review of Astronomy and Astrophysics	coden	ARAAAJ
International Journal of Wireless Information Networks	coden	IJWNEY
Journal of Symbolic Logic	coden	JSYLA6
Journal of Philosophical Logic	coden	JPLGA7
Ophthalmology	coden	OPHTDG
Journal of Immunology	coden	JOIMA3
ChemPlusChem	coden	CCCCAK
Journal of Experimental Social Psychology	coden	JESPAQ
Law and Human Behavior	coden	LHBEDM
Population and Environment	coden	PENVDK
Magnetic Resonance in Chemistry	coden	MRCHEG
GeoJournal	coden	GEOJDQ
Applied Organometallic Chemistry	coden	AOCHEX
Brain	coden	BRAIAK
Luminescence	coden	LUMIFC
Biomedical Chromatography	coden	BICHE2
Journal of Chemometrics	coden	JOCHEU
Flavour and Fragrance Journal	coden	FFJOED
Journal of Applied Toxicology	coden	JJATDK
Journal of Labelled Compounds and Radiopharmaceuticals	coden	JLCRD4
Journal of Molecular Recognition	coden	JMORE4
Phytochemical Analysis	coden	PHANEL
Polymers for Advanced Technologies	coden	PADTE5
Journal of Peptide Science	coden	JPSIEL
X-Ray Spectrometry	coden	XRSPAX
Journal of Raman Spectroscopy	coden	JRSPAF
Journal of Experimental and Theoretical Physics	coden	JTPHES
Naturwissenschaften	coden	NATWAY
Journal of Physics: Condensed Matter	coden	JCOMEL
Revista de Biologia	coden	RVBIAP
Lethaia	coden	LETHAT
Biometrics	coden	BIOMB6
Journal of Consulting and Clinical Psychology	coden	JCLPBC
The Journal of Law and Economics	coden	JLLEA7
Environmental Health Perspectives	coden	EVHPAZ
Clinical Infectious Diseases	coden	CIDIEL
The Journal of Infectious Diseases	coden	JIDIAQ
Physiological and Biochemical Zoology	coden	PBZOF6
Philosophy of Science	coden	PHSCA6
Europe-Asia Studies	coden	EASTER
Bioelectromagnetics	coden	BLCTDO
Studies in American Political Development	coden	SAPDFH
Electrophoresis	coden	ELCTDN
Journal of Alzheimer's Disease	coden	JADIF9
The Journal of Neuroscience	coden	JNRSDS
British Journal of Pharmacology	coden	BJPCBM
Gazzetta Chimica Italiana	coden	GCITA9
Anales de Química	coden	ANQUEX
Comparative Biochemistry and Physiology B	coden	CBPBB8
Journal of Endocrinology	coden	JOENAK
Environmental Science & Technology	coden	ESTHAG
Journal of General Virology	coden	JGVIAY
Bulletin des Sociétés Chimiques Belges	coden	BSCBAG
Recueil des Travaux Chimiques des Pays-Bas	coden	RTCPA3
Bulletin de la Société Chimique de France	coden	BSCFAS
Natural Language Semantics	coden	NLSEEM
Molecular Biology and Evolution	coden	MBEVEO
European Journal of Inorganic Chemistry	coden	EJICFO
European Journal of Medicinal Chemistry	coden	EJMCA5
Anales de Física	coden	AFISEX
Revista Boliviana de Quimica	coden	RBQUDX
Anais da Associação Brasileira de Química	coden	AABQAL
Journal of the Brazilian Chemical Society	coden	JOCSET
Revista Brasileira de Química	coden	RBQSAO
Revista Brasileira de Chímica	coden	RBCRAJ
Revista de la Sociedad Química de Mexico	coden	RSQMAN
Revista de la Sociedad Venezolana Química	coden	RSVQAQ
Revista Latinoamericana de Química	coden	RLAQA8
Polish Journal of Chemistry	coden	PJCHDQ
The Journal of the American Osteopathic Association	coden	JAOAAZ
Química Nova	coden	QUNODK
Brazilian Journal of Chemical Engineering	coden	BJCEFZ
Economic Development and Cultural Change	coden	EDCCAF
Journal of Rehabilitation Research and Development	coden	JRRDEC
Astronomische Nachrichten	coden	ASNAAN
International Journal of Astrobiology	coden	IJANFR
Astrobiology	coden	ASTRC4
IEEE Wireless Communications	coden	IWCEAS
IEEE Transactions on Computers	coden	ITCOB4
IEEE Journal of Quantum Electronics	coden	IEJQA7
IEEE Transactions on Pattern Analysis and Machine Intelligence	coden	ITPIDJ
IEEE Software	coden	IESOEG
Computer	coden	CPTRB4
IEEE Transactions on Control Systems and Technology	coden	IETTE2
IEEE Transactions on Computer-Aided Design of Integrated Circuits and Systems	coden	ITCSDI
IEEE Transactions on Wireless Communications	coden	ITWCAX
IEEE Transactions on Applied Superconductivity	coden	ITASE9
IEEE Transactions on Communications	coden	IECMBT
IEEE Communications Letters	coden	ICLEF6
Virology	coden	VIRLAX
Ecography	coden	ECOGEG
Journal of Molecular Evolution	coden	JMEVAU
Military Medicine	coden	MMEDA9
Nonlinearity	coden	NONLE5
University of Chicago Law Review	coden	UCLRA2
Geographical Review	coden	GEORAD
Bioinspiration & Biomimetics	coden	BBIICI
Classical and Quantum Gravity	coden	CQGRDG
Astrophysics and Space Science	coden	APSSBE
Computational Science & Discovery	coden	CSD0A3
Journal of Healthcare Management	coden	JHMAFB
IEEE Internet Computing	coden	IICOFX
Journal of Lightwave Technology	coden	JLTEDG
IEEE Transactions on Mobile Computing	coden	ITMCCJ
IEEE Transactions on Multimedia	coden	ITMUF8
IEEE Sensors Journal	coden	ISJEAZ
Antiviral Chemistry & Chemotherapy	coden	ACCHEH
Physics of Fluids	coden	PHFLE6
Environmental Research Letters	coden	ERLNAL
Microbiology	coden	MIBLAO
Journal of Clinical Oncology	coden	JCONDN
International Journal of Systematic and Evolutionary Microbiology	coden	ISEMF5
Representations	coden	RPREEL
Biochemical Society Transactions	coden	BCSTB5
Aldrichimica Acta	coden	ALACBI
Journal of Geophysics and Engineering	coden	JGE0C3
The Journal of Slavic Military Studies	coden	JSMTE8
Clinical Science	coden	CSCIAE
Postgraduate Medical Journal	coden	PGMJAO
Journal of Computational Physics	coden	JCTPAH
Biotechnology and Applied Biochemistry	coden	BABIEC
ACGC Chemical Research Communications	coden	ACRCFA
Journal of Acquired Immune Deficiency Syndromes	coden	JJASFJ
Sensors	coden	SENSC9
Journal of Radiological Protection	coden	JRPREA
Entropy	coden	ENTRFG
Philosophy and Phenomenological Research	coden	PPHRAI
Journal of Plantation Crops	coden	JPCRDW
Journal of Physics D	coden	JPDBAK
Physical Biology	coden	PBHIAT
Physics in Medicine and Biology	coden	PHMBA7
Journal of Sex Research	coden	JSXRAJ
Physics Education	coden	PHEDA7
Journal of Physics G	coden	JPGPED
Journal of World History	coden	JWHIEC
Genes, Brain and Behavior	coden	GBBEAO
Cell Biochemistry & Function	coden	CBFUDH
Medical Mycology	coden	MEMYFR
Journal of Chromatography A	coden	JCRAEY
Current Issues in Molecular Biology	coden	CMBIF6
Journal of Econometrics	coden	JECMB6
International Journal of Acarology	coden	IJOADM
Advances in Ecological Research	coden	AELRAY
Bijdragen tot de Taal-, Land- en Volkenkunde	coden	BTTVE2
Mathematics of Operations Research	coden	MOREDQ
American Journal of Occupational Therapy	coden	AJOTAM
European Journal of Social Psychology	coden	EJSPA6
BMC Bioinformatics	coden	BBMIC4
Journal of Computational Biology	coden	JCOBEM
Journal of Money, Credit and Banking	coden	JMCBBT
Journal of Economic Dynamics and Control	coden	JEDCDH
Journal of Monetary Economics	coden	JMOEDW
British Journal of Anaesthesia	coden	BJANAD
Communications on Pure and Applied Mathematics	coden	CPMAMV
Nature Geoscience	coden	NGAEBU
Psyche	coden	PSYCHAQ
Acta Crystallographica	coden	CACEQ
Acta Crystallographica	coden	SBSDK
Acta Crystallographica	coden	ACSCEE
Acta Crystallographica	coden	ABCRE6
Acta Crystallographica	coden	ACSEBH
Acta Crystallographica	coden	ACSFCL
Energy Economics	coden	EECODR
Physics-Uspekhi	coden	PHUSEY
Journal of Graph Theory	coden	JGTHDO
BioDrugs	coden	BIDRF4
Eastern Mediterranean Health Journal	coden	EMHJAM
Inverse Problems	coden	INPEEY
Journal of Physical Chemistry C	coden	JPCCCK
Mayo Clinic Proceedings	coden	MACPAJ
Mammalian Species	coden	MLNSBP
Boreas	coden	BRESB3
Open Life Sciences	coden	OLSPBT
ChemMedChem	coden	CHEMGX
Journal of Environmental Economics and Management	coden	JEEMDI
Annual Review of Sociology	coden	ARVSDB
British Journal of Psychiatry	coden	BJPYAJ
Acta Psychiatrica Scandinavica	coden	APYSA9
Schizophrenia Research	coden	SCRSEH
Schizophrenia Bulletin	coden	SCZBB3
Addiction	coden	ADICE5
Annual Review of Genetics	coden	ARVGB
Annual Review of Anthropology	coden	ARAPCW
Annual Review of Biochemistry	coden	ARBOAW
Annual Review of Earth and Planetary Sciences	coden	AREPCI
Annual Review of Analytical Chemistry	coden	ARACFU
Annual Review of Cell and Developmental Biology	coden	ARDBF8
Annual Review of Plant Biology	coden	ARPBDW
Scientia Pharmaceutica	coden	SCPHA4
Biological Psychiatry	coden	BIPCBF
Environmental Values	coden	ENVLE7
Scientometrics	coden	SCNTDX
European Journal of Political Research	coden	EJPRDY
Journal of Cell Science	coden	JNCSAI
Journal of Heredity	coden	JOHEA8
Journal of Evolutionary Biology	coden	JEBIEQ
Acta Oncologica	coden	ACTOEL
Journal of Cerebral Blood Flow & Metabolism	coden	JCBMDN
Political Communication	coden	PLCMEM
Journal of Semitic Studies	coden	JSSTF5
Acta Biochimica et Biophysica Sinica	coden	ABBSC2
Acta Biochimica et Biophysica Sinica	coden	SHWPAU
The Journal of Physiology	coden	JPHYA7
Acta Astronautica	coden	AASTCF
Philosophical Studies	coden	PLSDA3
Yearbook of the Association of Pacific Coast Geographers	coden	YAPGAJ
Artificial Life	coden	ARLIEY
The Review of Economics and Statistics	coden	RECSA9
PALAIOS	coden	PALAEM
Journal of Public Health Policy	coden	JPPODK
Irish Medical Journal	coden	IMDJBD
Clinical Cardiology	coden	CLCADC
Women & Health	coden	WOHEDI
Zeitschrift für anorganische und allgemeine Chemie	coden	ZAACAB
Public Culture	coden	PUCUE7
Management Science	coden	MSCIAM
Manufacturing & Service Operations Management	coden	MSOMFV
British Journal of Medical Practitioners	coden	BJMPBC
Organization Science	coden	ORSCEZ
American Journal of Cardiology	coden	AJCDAG
Ion Exchange Letters	coden	IELOAB
Milbank Quarterly	coden	MIQUES
Journal of Alternative and Complementary Medicine	coden	JACPFP
Clinical Orthopaedics and Related Research	coden	CORTBR
BMC Health Services Research	coden	BHSRAX
Current Pharmaceutical Design	coden	CPDEFP
Culture, Medicine and Psychiatry	coden	CMPSD2
Headache	coden	HEADAE
Social Science & Medicine	coden	SSMDEP
Psychological Medicine	coden	PSMDCO
Mount Sinai Journal of Medicine	coden	MSJMAZ
Diabetes	coden	DIAEAZ
International Journal of Epidemiology	coden	IJEPBF
Epidemiology and Infection	coden	EPINEU
International Journal of Biometeorology	coden	IJBMAO
Pacific Philosophical Quarterly	coden	PPHQEJ
Theoretical and Applied Genetics	coden	THAGA6
African Invertebrates	coden	ANMUA9
Erkenntnis	coden	ERKEDQ
Clinical Proteomics	coden	CPLRCX
Astronomy and Astrophysics	coden	AAEJAF
Human Brain Mapping	coden	HBMAEE
Magnetic Resonance in Medicine	coden	MRMEEN
Aviation, Space, and Environmental Medicine	coden	ASEMCG
Water Resources Research	coden	P1159
The Accounting Review	coden	ACRVAS
Acta Biomaterialia	coden	ABCICB
Acta Biotheoretica	coden	ABIOAN
Science and Technology of Advanced Materials	coden	STAMCV
Notes and Records	coden	NOREAY
Zeitschrift für Geologische Wissenschaften	coden	ZGWSA7
Cataloging & Classification Quarterly	coden	CCQUDB
International Journal of Cancer	coden	IJCNAW
Clinical Leukemia	coden	CLLEAW
Discrete and Computational Geometry	coden	DCGEER
Journal of Oral and Maxillofacial Surgery	coden	JOMSDA
Statistical Applications in Genetics and Molecular Biology	coden	SAGMCU
Developmental Psychology	coden	DEVPA9
Journal of Catalysis	coden	JCTLA5
Tellus A	coden	TSAOD8
ACM Transactions on Computer-Human Interaction	coden	ATCIF4
The Journal of Pediatrics	coden	JOPDAB
Energy and Environmental Science	coden	EESNBY
Phytopathologia Mediterranea	coden	PYMDA
Gut	coden	GUTTAK
Phytochemistry	coden	PYTCAS
Mycologia	coden	MYCOAE
Common Market Law Review	coden	CMLRDD
Polyhedron	coden	PLYHDE
Nature Structural & Molecular Biology	coden	NSMBCU
IEEE Micro	coden	IEMIDZ
Biochemical and Biophysical Research Communications	coden	BBRCA9
Genes & Development	coden	GEDEEP
Econometric Reviews	coden	ECREEP
Histochemistry and Cell Biology	coden	HCBIFP
Journal of Nutrition	coden	JONUAI
Nutrition and Cancer	coden	NUCADQ
Journal of Ethnopharmacology	coden	JOETD7
Acta Paediatrica	coden	APAEEL
Economic Botany	coden	ECBOA5
Journal of Neurology	coden	JNRYA9
Annals of the New York Academy of Sciences	coden	ANYAA9
Developmental Psychobiology	coden	DEPBA5
Reproduction	coden	RCUKBS
Journal of Inherited Metabolic Disease	coden	JIMDDP
The Journal of Clinical Endocrinology and Metabolism	coden	JCEMAZ
Oil Shale	coden	OSIHA3
Current Medical Research and Opinion	coden	CMROCX
Endocrine Journal	coden	ENJOEO
Fundamenta Informaticae	coden	FUMAAJ
Synthetic Metals	coden	SYMEDZ
Journal of Pharmacology and Experimental Therapeutics	coden	JPETAB
Journal of the American Academy of Dermatology	coden	JAADDB
American Journal of Pharmaceutical Education	coden	AJPDAD
Journal of Organizational Behavior	coden	JORBEJ
International Journal of Oral and Maxillofacial Surgery	coden	IJOSE9
BMC Cancer	coden	BCMACL
ChemPhysChem	coden	CPCHFT
Nature Reviews Drug Discovery	coden	NRDDAG
Commentarii Mathematici Helvetici	coden	COMHAX
Pediatric Nursing	coden	PENUEI
Journal of Health and Social Behavior	coden	JHSBA5
Canadian Journal of Earth Sciences	coden	CJESAP
Scandinavian Journal of Work, Environment & Health	coden	SWEHDO
Journal of Pediatric Gastroenterology and Nutrition	coden	JPGND6
Journal of AOAC International	coden	JAINEE
Alcoholism: Clinical and Experimental Research	coden	ACRSDM
Journal of Molecular Neuroscience	coden	JMNEES
Bone Marrow Transplantation	coden	BMTRE9
The Journal of Steroid Biochemistry and Molecular Biology	coden	JSBBEZ
Surface Science Reports	coden	SSREDI
Journal of Medical Entomology	coden	JMENA6
Hormone Research in Paediatrics	coden	HRPOA9
Clinical Chemistry	coden	CLCHAU
American Journal of Kidney Diseases	coden	AJKDD
Journal of Occupational and Environmental Medicine	coden	JOEMFM
Neural Networks	coden	NNETEB
Journal of Management	coden	JOMADO
Health Affairs	coden	HEAFDN
Expert Opinion on Pharmacotherapy	coden	EOPHF7
Expert Opinion on Therapeutic Patents	coden	EOTPEG
ACS Applied Materials & Interfaces	coden	AAMICK
BMC Evolutionary Biology	coden	BEBMCG
Psychosomatic Medicine	coden	PSMEAP
Trials	coden	TRIACW
Chemistry of Materials	coden	cmatex
International Journal for Numerical Methods in Fluids	coden	IJNFDW
Progress of Theoretical and Experimental Physics	coden	PTPKAV
Virginia Law Review	coden	VLIBAD
ACS Nano	coden	ANCAC3
Bioconjugate Chemistry	coden	bcces
Biomacromolecules	coden	bomaf6
Contributions to Mineralogy and Petrology	coden	CMPEAP
Chemical Research in Toxicology	coden	CRTOEC
Crystal Growth & Design	coden	CGDEFU
Energy & Fuels	coden	ENFUEM
Journal of Agricultural and Food Chemistry	coden	JAFCAU
Journal of Chemical & Engineering Data	coden	jceaax
Journal of Chemical Theory and Computation	coden	jctcce
The Journal of Membrane Biology	coden	MBBBO
British Journal of Clinical Pharmacology	coden	BCPHBM
Expert Opinion on Investigational Drugs	coden	EOIDER
Journal of Natural Products	coden	JNPRDF
Journal of Proteome Research	coden	JPROBS
Molecular Pharmaceutics	coden	MPOHBP
Nano Letters	coden	NALEFD
Organic Process Research & Development	coden	oprdfk
Macromolecules	coden	MAMOBX
Journal of Neurochemistry	coden	JONRA9
Expert Opinion on Drug Delivery	coden	EODDAW
Propellants, Explosives, Pyrotechnics	coden	PEPYD5
Archives of Disease in Childhood	coden	ADCHAK
Cutaneous and Ocular Toxicology	coden	JTOTDO
Drug and Chemical Toxicology	coden	DCTODJ
RNA	coden	RNARFU
Annals of Clinical & Laboratory Science	coden	ACLSCP
Experimental Cell Research	coden	ECREAL
Menopause	coden	MENOF2
Journal of Receptors and Signal Transduction	coden	JRETET
Anesthesia & Analgesia	coden	AACRAT
Toxicology Mechanisms and Methods	coden	TMMOCP
Medical & Biological Engineering & Computing	coden	MBECDY
Discrete Mathematics	coden	DSMHA4
Journal of Occupational and Organizational Psychology	coden	JOCCEF
The International Journal of Psychoanalysis	coden	IJPSAA
British Journal of Ophthalmology	coden	BJOPAL
Annals of the Rheumatic Diseases	coden	ARDIAO
Occupational and Environmental Medicine	coden	OEMEEM
Acupuncture in Medicine	coden	ACMEFP
Journal of Epidemiology and Community Health	coden	JECHDR
Data Mining and Knowledge Discovery	coden	DMKDFD
Cancer Science	coden	CSACCM
Annales médico-psychologiques	coden	AMPYAT
Annual Review of Sex Research	coden	ARXREJ
Annales d'histochimie	coden	ANHIAG
American Mineralogist	coden	AMMIAY
Heterocycles	coden	HTCYAM
Journal of Clinical Pathology	coden	JCPAAK
Physiology & Behavior	coden	PHBHA4
Solar Physics	coden	SLPHAX
Annual Review of Biophysics	coden	ARBNCV
Paleoceanography	coden	POCGEP
Journal of the American Medical Informatics Association	coden	JAMAFU
European Biophysics Journal	coden	EBJOE8
American Journal of Physiology	coden	AJPHAP
Clinical and Experimental Pharmacology and Physiology	coden	CEXPB9
American Journal of Obstetrics and Gynecology	coden	AJOGAH
Journal of Biological Inorganic Chemistry	coden	JJBCFA
Molecular Ecology	coden	MOECEO
Laser & Photonics Reviews	coden	LPRAB8
Expert Opinion on Drug Safety	coden	EODSA9
Nanotoxicology	coden	NANOGK
Celestial Mechanics and Dynamical Astronomy	coden	CLMCAV
Behavioural Brain Research	coden	BBREDI
The Journal of Higher Education	coden	JHIEAW
Expert Opinion on Drug Discovery	coden	EODDBX
Expert Opinion on Drug Metabolism & Toxicology	coden	EODMBQ
Clinical Gastroenterology and Hepatology	coden	CGHLAW
Journal of Applied Biomedicine	coden	JABOBD
Transplantation Proceedings	coden	TRPPA8
Electronic Journal of Theoretical Physics	coden	EJTPBC
Arthroscopy	coden	ARTHE3
Algorithmica	coden	ALGOEJ
Journal of Coatings Technology and Research	coden	JRCEB5
Review of African Political Economy	coden	RAPEF9
Journal of Microscopy	coden	JMICAR
World Journal of Gastroenterology	coden	WJGAF2
Journal of Neurosurgery	coden	JONSAC
Critical Reviews in Clinical Laboratory Sciences	coden	CRCLBH
World Archaeology	coden	WOAREN
Pharmaceutical Biology	coden	PHBIFC
Journal of Microencapsulation	coden	JOMIEF
Pharmaceutical Development and Technology	coden	PDTEFS
CA	coden	CAMCAM
Journal of Drug Targeting	coden	JDTAEH
Annals of Oncology	coden	ANONE2
Pediatric Radiology	coden	PDRYA5
The American Journal of Clinical Nutrition	coden	AJCNAC
European Journal of Nuclear Medicine and Molecular Imaging	coden	EJNMA6
Human Biology	coden	HUBIAA
Allergy	coden	LLRGDY
Nature Methods	coden	NMAEA3
ChemBioChem	coden	CBCHFX
Acta Chimica Slovenica	coden	ACSLE7
ACS Chemical Neuroscience	coden	ACNCDM
Journal of Physical Chemistry Letters	coden	JPCLCD
International Journal of Geriatric Psychiatry	coden	IJGPES
Journal of the Neurological Sciences	coden	JNSCAG
FEBS Letters	coden	FEBLAL
Bulletins of American Paleontology	coden	BAPLAJ
DNA Research	coden	DARSE8
Journal of Cardiovascular Electrophysiology	coden	JCELE2
Molecular Physics	coden	MOPHAM
Acta Zoologica Mexicana	coden	AZMEEF
Journal of Development Economics	coden	JDECDF
Archives of Biochemistry and Biophysics	coden	ABBIA4
Mutation Research	coden	MUREAV
Vision Research	coden	VISRAM
Computers in Biology and Medicine	coden	CBMDAW
Journal of Chemical Technology & Biotechnology	coden	JCTBED
Nature Cell Biology	coden	NCBIFN
Journal of Lipid Research	coden	JLPRA
American Journal of Respiratory and Critical Care Medicine	coden	AJCMED
Irish Journal of Medical Science	coden	IJMSA
Molecular Endocrinology	coden	MOENEN
Journal of Biochemistry	coden	JOBIAO
African Journal of Aquatic Science	coden	AJASBI
American Indian Quarterly	coden	AIQUEW
HLA	coden	TSANA2
Analytical Biochemistry	coden	ANBCA2
China Pharmacy	coden	ZYHAA4
Journal of Medical Genetics	coden	JMDGAE
Sexual Abuse	coden	SAJTEY
British Journal of Neurosurgery	coden	BJNEEL
Zeitschrift für Physik	coden	ZPAHEX
Journal of Nanoparticle Research	coden	JNARFA
European Journal of Pharmacology	coden	EJPHAZ
The American Journal of Pathology	coden	AJPAA4
The American Journal of Medicine	coden	AJMEAZ
American Journal of Emergency Medicine	coden	AJEMEN
Journal of Molecular Medicine	coden	JMLME8
Australian Journal of Physics	coden	AUJPAS
Boundary-Layer Meteorology	coden	BLMEBR
European Physical Journal E	coden	EPJSFH
European Journal of Clinical Pharmacology	coden	EJCPAS
Macromolecular Chemistry and Physics	coden	MCHPES
Annals of Saudi Medicine	coden	ANSMEJ
ACM Transactions on Networking	coden	IEANEP
Cytogenetic and Genome Research	coden	CGRYAJ
Alzheimer Disease and Associated Disorders	coden	ADADE2
Oncogene	coden	ONCNES
Cancer	coden	CANCAR
SIAM Journal on Scientific Computing	coden	SJOCE3
Journal of Applied Biomechanics	coden	JABOEG
Arteriosclerosis, Thrombosis, and Vascular Biology	coden	ATVBFA
European Heart Journal	coden	EHJODF
Clinical Cancer Research	coden	CCREF
Cancer Immunology, Immunotherapy	coden	CIIMDN
Cancer Chemotherapy and Pharmacology	coden	CCPHDZ
ReCALL	coden	RCALE2
Journal of Low Temperature Physics	coden	JLTPAC
Journal of Gay and Lesbian Social Services	coden	JGLSEI
The Scientific World Journal	coden	THESAS
Journal of the Gay and Lesbian Medical Association	coden	JGLAFX
Journal of Sex Education and Therapy	coden	JSETE2
Journal of Psychosomatic Research	coden	JPCRAT
Journal of Nuclear Cardiology	coden	JNCAE2
Biotechnology and Bioengineering	coden	BIBIAU
Malacologia	coden	MALAAJ
Guy's Hospital Reports	coden	GHREAA
American Journal of Primatology	coden	AJPTDU
Cellular and Molecular Life Sciences	coden	CMLSFI
Journal of Neurogenetics	coden	JLNEDK
Journal of Fish Biology	coden	JFIBA9
Macromolecular Theory and Simulations	coden	MTHSEK
Biotechnic & Histochemistry	coden	BIHIEU
Veterinary Parasitology	coden	VPARDI
Journal of Intelligent and Robotic Systems	coden	JIRSES
Microsystem Technologies	coden	MCTCEF
Journal of Polymer Science Part A	coden	JPACEC
New Phytologist	coden	NEPHAV
Journal of Cellular Biochemistry	coden	JCEBD5
International Journal of Food Sciences and Nutrition	coden	IJFNEH
Protein Science	coden	PRCIEI
Annals of Medicine	coden	ANMDEU
Experimental Mechanics	coden	EXMCAZ
Nonlinear Dynamics	coden	NODYES
Archive of Applied Mechanics	coden	INARAS
Structural and Multidisciplinary Optimization	coden	SOPTEQ
Journal of Materials Science: Materials in Electronics	coden	JSMEEV
Space Science Reviews	coden	SPSRA4
Genetica	coden	GENEA3
Proceedings of the IEEE	coden	IEEPAD
Journal of Thermal Spray Technology	coden	JTTEE5
Journal of Gender Studies	coden	JGESEH
International Journal of Thermophysics	coden	IJTHDY
Journal of Sol-Gel Science and Technology	coden	JSGTEC
Journal of Neurophysiology	coden	JONEA4
Journal of Materials Science: Materials in Medicine	coden	JSMMEL
Phytomedicine	coden	PYTOEY
Journal of Neurotherapy	coden	JNOEA2
Journal of Documentation	coden	JDOCAS
European Journal of Neuroscience	coden	EJONEI
Acta Neuropathologica	coden	ANLSBX
Bioinformatics	coden	BOINFP
AMBIO	coden	AMBOCX
Scandinavian Journal of Gastroenterology	coden	SJGRA4
The John Marshall Journal of Information Technology and Privacy Law	coden	JCJIEI
Pharmacological Reviews	coden	PAREAQ
Cooperation and Conflict	coden	COCFEF
Behavior Genetics	coden	BHGNAT
Bulletin of the American Museum of Natural History	coden	BUMNAE
The Journal of General Physiology	coden	JGPLAD
Journal of Psychopharmacology	coden	JOPSEQ
Journal of Human Genetics	coden	JHGEFR
Journal of Leukocyte Biology	coden	JLBIE7
Functional Ecology	coden	FECOE5
The Journal of Sexual Medicine	coden	JSMOAN
Sex Roles	coden	SROLDH
American Annals of the Deaf	coden	ANDFAL
Review of International Political Economy	coden	RIPEFV
Earth and Planetary Science Letters	coden	EPSLA2
ACS Medicinal Chemistry Letters	coden	amclct
American Journal of Human Biology	coden	AJHUES
Thyroid	coden	THYRER
Scripta Geologica	coden	SCGLA5
Canadian Journal of Physiology and Pharmacology	coden	CJPPA3
The International Journal of Biochemistry & Cell Biology	coden	IJBBFU
Cancer Epidemiology, Biomarkers & Prevention	coden	CEBPE4
European Journal of Cancer	coden	EJCAEL
American Journal of Translational Research	coden	AJTRA7
Neuropharmacology	coden	NEPHBW
Arthritis & Rheumatology	coden	ARHEAW
Clinica Chimica Acta	coden	CCATAR
EPL	coden	EULEE8
Biophysical Reviews and Letters	coden	BRLIA7
Cellular Signalling	coden	CESIEY
Fractals	coden	FRACEG
Cancer Letters	coden	CALEDQ
Journal of Hydraulic Engineering	coden	JHEND8
The Journal of Clinical Psychiatry	coden	JCLPDE
Biological Chemistry	coden	BICHF3
Life Sciences	coden	LIFSAK
Journal of Histochemistry and Cytochemistry	coden	JHCYAS
Biochemical Pharmacology	coden	BCPCA6
Human Immunology	coden	HUIMDQ
International Journal of Historical Archaeology	coden	IJHAFN
Izvestiya Vysshikh Uchebnykh Zavedenii. Radioelektronika	coden	IVUZB5
Izvestiya Vysshikh Uchebnykh Zavedenii. Radioelektronika	coden	RCSYDS
Preventive Medicine	coden	PVTMA3
South African Journal of Science	coden	SAJSAR
American Journal of Physical Anthropology	coden	AJPNA9
Bulletin of the World Health Organization	coden	BWHOA6
International Journal of Nanoscience	coden	IJNNAJ
Rheumatic Diseases Clinics of North America	coden	RDCAEK
Journal of Instrumentation	coden	JIONAS
Journal of Nonlinear Optical Physics & Materials	coden	JNOMFV
Hippocampus	coden	HIPPEL
Journal of the American Board of Family Medicine	coden	JABPEJ
Brain Injury	coden	BRAIEO
Human Mutation	coden	HUMUE3
Journal of Interprofessional Care	coden	JINCFT
Leukemia & Lymphoma	coden	LELYEA
International Journal of Radiation Biology	coden	IJRBE7
Journal of Differential Geometry	coden	JDGEAS
Experimental Lung Research	coden	EXLRDA
Platelets	coden	PLTEEF
Chronobiology International	coden	CHBIE4
Ultrastructural Pathology	coden	ULPAD3
Movement Disorders	coden	MOVDEA
Immunogenetics	coden	IMNGBK
American Journal of Respiratory Cell and Molecular Biology	coden	AJRBEL
Retrovirology	coden	RETRBO
Neuroscience	coden	NRSCDN
Journal of Hypertension	coden	JOHYD3
International Journal of Cardiology	coden	IJCDD5
European Journal of Cancer Prevention	coden	EJUPEK
Journal of the American College of Cardiology	coden	JACCDI
Journal of Heterocyclic Chemistry	coden	JHTCA
Fitoterapia	coden	FTRPAE
Neuroscience & Biobehavioral Reviews	coden	NBREDE
International Journal of Primatology	coden	IJPRDA
Nature Chemistry	coden	NCAHBB
Veterinary Record	coden	VETRAX
In Practice	coden	IPRCDH
Journal of Polymer Science Part B	coden	JPBPEM
IEEE Transactions on Antennas and Propagation	coden	IETPAK
Environmental Ethics	coden	ENETDD
Organization & Environment	coden	ORENFX
Free Radical Biology and Medicine	coden	FRBMEH
Yale Journal of Criticism	coden	YJCRFL
History and Anthropology	coden	HIAND7
Histopathology	coden	HISTDD
Acta Obstetricia et Gynecologica Scandinavica	coden	AOGSAE
Journal of Intellectual & Developmental Disability	coden	JIDDFG
Clinical Anatomy	coden	CLANE8
Zoo Biology	coden	ZOBIDX
Psychiatric Quarterly	coden	PSQUAP
International Journal of Sport Nutrition and Exercise Metabolism	coden	IJSNAA
Psychological Reports	coden	PYRTAZ
Analytica Chimica Acta	coden	ACACAM
Journal of Behavioral Medicine	coden	JBMEDD
Medical Anthropology Quarterly	coden	MAQUD5
Synapse	coden	SYNAET
Pulmonary Pharmacology & Therapeutics	coden	PPTHFJ
British Journal of Clinical Psychology	coden	BJCPDW
The American Journal of Gastroenterology	coden	AJGAAR
NeuroReport	coden	NERPEZ
The Canadian Journal of Psychiatry	coden	CPAJAK
Drugs	coden	DRUGAY
Journal of Clinical Psychopharmacology	coden	JCPYD
Contemporary Clinical Trials	coden	CCLTDH
Cephalalgia	coden	CEPHDF
The Journal of Pathology	coden	JPTLAS
Cardiology	coden	CAGYAO
Epileptic Disorders	coden	EPDIFP
IEEE Antennas and Wireless Propagation Letters	coden	IAWPA7
Journal of the History of Medicine and Allied Sciences	coden	JHMAA6
Obstetrics & Gynecology	coden	OBGNAS
Journal of International Economics	coden	JIECBE
Rheumatology	coden	RUMAFK
World Development	coden	WODEDW
Journal of Automated Reasoning	coden	JAREEW
SIAM Journal on Matrix Analysis and Applications	coden	SJMAEL
Dialectical Anthropology	coden	DIAAER
Indian Journal of Anaesthesia	coden	IJANBN
Indian Journal of Cancer	coden	IJCAAR
International Journal for the Psychology of Religion	coden	IPRLEB
Neurobiology of Aging	coden	NEAGDO
Journal of Religion & Health	coden	JRHEAT
Health Education & Behavior	coden	HEDBFS
Indian Journal of Dermatology, Venereology and Leprology	coden	IJDLDY
Indian Journal of Dermatology	coden	IJDEAA
Computational Materials Science	coden	CMMSEM
Indian Journal of Medical Microbiology	coden	IJMMEF
Indian Journal of Medical Sciences	coden	INJMAO
Journal of Electroceramics	coden	JOELFJ
Indian Journal of Ophthalmology	coden	IJOMBM
Indian Journal of Pathology & Microbiology	coden	IJPMDT
Indian Journal of Pharmaceutical Sciences	coden	IJSID
Indian Journal of Pharmacology	coden	INJPD2
Materials	coden	MATEG9
International Journal of Forecasting	coden	IJFOEK
Glycobiology	coden	GLYCE3
Aging and Mental Health	coden	AMHTFD
Planetary and Space Science	coden	PLSSAE
Journal of Aging and Health	coden	JAHEEG
British Journal of Dermatology	coden	BJDEAZ
Journal of Controlled Release	coden	JCREEC
International Journal of Pharmaceutics	coden	IJPHDE
CardioVascular and Interventional Radiology	coden	CARADG
Toxicology	coden	TXCYAC
Gynecologic Oncology	coden	GYNOA3
Toxicology Letters	coden	TOLED5
Advances in Space Research	coden	ASRSDW
Journal of Cancer	coden	JCWAAL
Database	coden	DATAFX
Review of Educational Research	coden	REDRAB
Human Reproduction	coden	HUREEE
Human Reproduction	coden	HRUPF8
Human Reproduction	coden	MHREFD
International Journal of Language & Communication Disorders	coden	IJLDFI
Disability and Rehabilitation	coden	DREHET
Gynecological Endocrinology	coden	GYENER
Hypertension in Pregnancy	coden	HYPPEV
Journal of Musculoskeletal Pain	coden	JMPAEQ
Journal of Dermatological Treatment	coden	JDTREY
Geochimica et Cosmochimica Acta	coden	GCACAK
Acta Odontologica Scandinavica	coden	AOSCAQ
Cytotherapy	coden	CYTRF3
Network: Computation In Neural Systems	coden	NEWKEB
Acta Radiologica	coden	ACRAE3
Occupational Therapy in Health Care	coden	OTHCES
Physical & Occupational Therapy in Geriatrics	coden	POTGD7
Physiotherapy: Theory and Practice	coden	PTHPEA
Somatosensory & Motor Research	coden	SMOREZ
Stress	coden	STREFR
The Aging Male	coden	AGMAF7
Platinum Metals Review	coden	PTMRA3
Acta Materialia	coden	AMATEB
Nutrients	coden	NUTRHU
Computational Statistics	coden	CSTAEB
Ultramicroscopy	coden	ULTRD6
BioControl	coden	BOCOFW
Skeletal Radiology	coden	SKRADI
Microscopy and Microanalysis	coden	MIMIF7
Experimental Aging Research	coden	EAGRDS
Astronomy Reports	coden	ATROES
Physical Review E	coden	PRESCM
Environmental Earth Sciences	coden	EESNCZ
Neurology India	coden	NURYAY
Diabetologia	coden	DBTGAJ
Journal of Biomedical Informatics	coden	JBIOBL
British Columbia Medical Journal	coden	BCMJAC
Dutch Crossing	coden	DUCRE2
Applied Mechanics Reviews	coden	AMREAD
American Journal of Transplantation	coden	AJTMBR
International Journal of Hematology	coden	IJHEEY
Thin Solid Films	coden	THSFAP
Toxicon	coden	TOXIA6
Optical Materials	coden	OMATET
Forest Pathology	coden	FOPAFV
Journal of the National Cancer Institute	coden	JNCIEQ
Clinical Genetics	coden	CLGNAY
British Journal of Haematology	coden	BJHEAL
Earth, Moon, and Planets	coden	EMPLD3
Mechanisms of Development	coden	MEDVE6
Placenta	coden	PLACDF
Journal of the American Ceramic Society	coden	JACTAW
Cell Research	coden	CREEB6
Molecular Microbiology	coden	MOMIEE
Immunity	coden	IUNIEH
Stroke	coden	SJCCA7
Epilepsia	coden	EPILAK
Animal Behaviour	coden	ANBEA8
Journal of Infection	coden	JINFD2
Peptides	coden	PPTDD5
Carcinogenesis	coden	CRNGDP
Drug Metabolism and Disposition	coden	DMDSAI
Geophysical Journal International	coden	GJINEA
Bioscience, Biotechnology, and Biochemistry	coden	BBBIEJ
AIAA Journal	coden	AIAJAH
Jordan Medical Journal	coden	JOMJAE
Journal of Zoological Systematics and Evolutionary Research	coden	JZSEF9
Journal of the Royal Astronomical Society of Canada	coden	JRASA2
Urology	coden	URGYAZ
Scripta Materialia	coden	SCMAF7
Atherosclerosis	coden	ATHSBL
Traffic	coden	TRAFFA
Environmental Biology of Fishes	coden	EBFID3
Information Services & Use	coden	ISUSDX
Hypertension	coden	HPRTDN
Nederlands Tijdschrift voor Geneeskunde	coden	NETJAN
Constitutional Political Economy	coden	CPECFO
European Journal of Cell Biology	coden	EJCBDN
Radiology	coden	RADLAX
Nature Physics	coden	NPAHAX
Oncology Reports	coden	OCRPEW
Reviews of Geophysics	coden	REGEEP
Pharmacotherapy	coden	PHPYDQ
Journal of Magnetism and Magnetic Materials	coden	JMMMDC
IEEE Transactions on Magnetics	coden	IEMGAQ
Physics of the Earth and Planetary Interiors	coden	PEPIAM
Elements	coden	EOOCAG
Nature Communications	coden	NCAOBW
The Journal of Rheumatology	coden	JRHUA9
Journal of Contemporary Health Law and Policy	coden	JCLPEF
Journal of Medicine	coden	JNMDBO
The Journal of Antibiotics	coden	JANTAJ
International Journal for Parasitology	coden	IJPYBT
International Immunology	coden	INIMEN
Pharmacology & Therapeutics	coden	PHTHDT
Minds and Machines	coden	MMACEO
Brain Pathology	coden	BRPAE7
The Breast	coden	BREAEK
Human Affairs	coden	HUAFFZ
Journal of Holistic Nursing	coden	JHNUF8
Millennium: Journal of International Studies	coden	MILLFB
Journal of the National Comprehensive Cancer Network	coden	JNCCN
Journal of Neuroscience Research	coden	JNREDK
European Psychiatry	coden	EUPSED
International Angiology	coden	INANEK
Journal of Obstetric, Gynecologic, & Neonatal Nursing	coden	JOGNEY
AORN Journal	coden	AOJOEL
Journal of Perinatal & Neonatal Nursing	coden	JPNNE8
Bell System Technical Journal	coden	BSTJAN
ACS Catalysis	coden	ACCACS
Neonatal Network	coden	NEONEE
Journal of the Science of Food and Agriculture	coden	JSFAAE
Transgenic Research	coden	TRSEES
Reproductive Health Matters	coden	RHMAFV
Journal of Internal Medicine	coden	JINMEO
Canadian Journal of Neurological Sciences	coden	CJNSA2
Neuropsychology Review	coden	NERVEJ
Pediatric Clinics of North America	coden	PCNAA8
International Journal of Developmental Neuroscience	coden	IJDND6
Journal of Nanoscience and Nanotechnology	coden	JNNOAR
Aquatic Toxicology	coden	AQTODG
Archives of Pathology & Laboratory Medicine	coden	APLMAS
Security Dialogue	coden	SDIAER
Flow, Turbulence and Combustion	coden	FTCOF9
British Dental Journal	coden	BDJOAJ
Cancer Causes & Control	coden	CCCNEN
Wave Motion	coden	WAMOD9
The Journal of Comparative Neurology	coden	JCNEAM
Cardiology in Review	coden	CRVIE4
Circulation Research	coden	CIRUAL
Journal of Clinical Gastroenterology	coden	JCGADC
Photochemistry and Photobiology	coden	PHCBAP
Cosmic Research	coden	CSCRA7
Addiction Biology	coden	ADBIFN
American Journal of Clinical Oncology	coden	AJCODI
American Journal of Clinical Oncology	coden	CCTRDH
Neuromuscular Disorders	coden	NEDIEC
Neuropsychologia	coden	NUPSA6
Neuropsychobiology	coden	NPBYAL
Psychosomatics	coden	PSYCBC
Experimental Neurology	coden	EXNEAC
The American Journal of Economics and Sociology	coden	AJESA3
Phlebology	coden	PHLEEF
Neurogenetics	coden	NEROFX
Brain Research Bulletin	coden	BRBUDU
Neural Regeneration Research	coden	NRREBM
Environmental Monitoring and Assessment	coden	EMASDH
Respiratory Research	coden	RREEBZ
Journal of the Canadian Society of Forensic Science	coden	JCFSBP
Physical Review A	coden	PLRAAN
Canadian Journal of Physics	coden	CJPHAD
Mathematics and Computer Education	coden	MCEDDA
Acta Numerica	coden	ANUMFU
Topology and its Applications	coden	TIAPD9
Journal of Photochemistry and Photobiology	coden	JPCMAE
Acta Palaeontologica Polonica	coden	APGPAC
Flora Neotropica	coden	FLNMAV
Annual Review of Chemical and Biomolecular Engineering	coden	ARCBCY
Cretaceous Research	coden	CRRSDD
Drug Research	coden	ARZNAD
Journal of the Operational Research Society	coden	JORSDZ
Journal of Applied Physiology	coden	JAPHEV
Information Systems Journal	coden	ISYJER
Applied Psychology	coden	ADPYE4
Abhandlungen aus dem Mathematischen Seminar der Universität Hamburg	coden	AMHAAJ
Acta Applicandae Mathematicae	coden	AAMADV
Acta Mathematica Hungarica	coden	AMAHE9
Catalysis Science & Technology	coden	CSTAGD
Archive for Mathematical Logic	coden	AMLOEH
Rocky Mountain Journal of Mathematics	coden	RMJMAE
Feminist Economics	coden	FEECFE
Israel Journal of Mathematics	coden	ISJMAP
Numerische Mathematik	coden	NUMMA7
Advances in Geometry	coden	AGDEA3
SIAM Journal on Discrete Mathematics	coden	SJDMEC
Operations Research	coden	OPREAI
Differential Equations	coden	DIEQAN
Bulletin de la Société Mathématique de France	coden	BSMFAA
Journal of Mathematical Biology	coden	JMBLAJ
Journal of Animal Ecology	coden	JAECAP
The Journal of Chemical Thermodynamics	coden	JCTDAF
Mental Health, Religion & Culture	coden	MHRCA2
South African Medical Journal	coden	SAMJEJ
Analog Integrated Circuits and Signal Processing	coden	AICPEF
Fishery Bulletin	coden	FSYBAY
Reference and User Services Quarterly	coden	RUSQFU
Theory of Probability and Its Applications	coden	TPRBAU
The Cerebellum	coden	CERECF
Arkiv för Matematik	coden	AKMTAJ
Archiv der Mathematik	coden	ACVMAL
Monatshefte für Mathematik	coden	MNMTA2
Probability Theory and Related Fields	coden	PTRFEU
Chemical Science	coden	CSHCCN
British Journal of Medical Hypnotism	coden	BJMHAL
Applied Radiation and Isotopes	coden	ARISEF
Journal of the Kansas Entomological Society	coden	JKESA7
Transactions of the Kansas Academy of Science	coden	TSASAH
Critical Reviews in Immunology	coden	CCRIDE
PhysChemComm	coden	PHCCFX
Physics of the Solid State	coden	PSOSED
Physics and Chemistry of Liquids	coden	PCLQAC
Quaternary International	coden	QUINER
Metallomics	coden	METAJS
Journal of Rheology	coden	JORHD2
Koedoe	coden	KOEDB2
Journal of Environmental Biology	coden	JEBIDP
Journal of Cosmology and Astroparticle Physics	coden	JCAPBP
The Review of Austrian Economics	coden	RAECFG
Journal of Experimental Nanoscience	coden	JENOBX
Journal of Chemical Crystallography	coden	JCCYEV
Journal of Cluster Science	coden	JCSCEB
Crystallography Reviews	coden	CRRVEN
Postgraduate Medicine	coden	POMDAS
The Physician and Sportsmedicine	coden	PHSPDE
Archives of Virology	coden	ARVIDF
European Journal of Anaesthesiology	coden	EJANEG
Southern Medical Journal	coden	SMJOAV
Nachrichtentechnische Fachberichte	coden	NTGFDK
Journal of Child Psychology and Psychiatry	coden	JPPDAI
Matrix Biology	coden	MTBOEC
Analytical Methods	coden	AMNEGX
Journal of Nursing Education	coden	JNUEAW
The Nautilus	coden	NUTLA5
Amerasia Journal	coden	AMEJEZ
Calcified Tissue International	coden	CTINDZ
Osteoporosis International	coden	OSINEP
Somatic Cell and Molecular Genetics	coden	SCMGDN
Complexity	coden	COMPFS
Food Chemistry	coden	FOCHD
Emotion	coden	EMOTCL
Journal of Criminal Law & Criminology	coden	JCLCFB
The Biological Bulletin	coden	BIBUBX
Advanced Energy Materials	coden	ADEMBC
Journal of French Language Studies	coden	JFSLEP
Ultrasonics	coden	ULTRA3
Building Services Engineering Research and Technology	coden	BSETDF
Culture and Psychology	coden	CUPSFQ
Journal of Cellular Plastics	coden	JCUPAM
European History Quarterly	coden	EHIQEH
European Journal of Communication	coden	EJCOET
European Journal of Industrial Relations	coden	EJIRFZ
Food Science and Technology International	coden	FSTIFZ
Journal of Bioactive and Compatible Polymers	coden	JBCPEV
International Journal of Behavioral Development	coden	IJBDDY
Journal of Composite Materials	coden	JCOMBI
Health and Human Rights	coden	HHRIF4
Journal of Building Physics	coden	JBPOAL
Journal of Elastomers and Plastics	coden	JEPLAX
Journal of Fire Protection Engineering	coden	JFPEEN
Journal of Fire Sciences	coden	JFSCDV
Journal of Intelligent Material Systems and Structures	coden	JMSSER
Journal of Plastic Film and Sheeting	coden	JPFSEH
Journal of the Renin-Angiotensin-Aldosterone System	coden	JRAAAG
Journal of Reinforced Plastics and Composites	coden	JRPCDW
Journal of Sandwich Structures and Materials	coden	JSSMFI
Journal of Thermoplastic Composite Materials	coden	JTMAEQ
Journal of Vibration and Control	coden	JVCOFX
Journal of Librarianship and Information Science	coden	JLSCE6
Lighting Research & Technology	coden	LRTEA9
Language Teaching Research	coden	LTREFI
Mathematics & Mechanics of Solids	coden	MMESFP
Multiple Sclerosis Journal	coden	MUSCFZ
Progress in Physical Geography	coden	PPGEEC
Party Politics	coden	PAPOFH
Rationality and Society	coden	RTSOEG
Scandinavian Journal of Public Health	coden	SJPHAJ
Social & Legal Studies	coden	SLSTEK
Statistical Methods in Medical Research	coden	SMMRFQ
Journal of Social and Personal Relationships	coden	JSRLE9
Social Science Information	coden	SSCIBL
Theory & Psychology	coden	THPSEJ
Theoretical Criminology	coden	TRCNFA
Toxicology and Industrial Health	coden	TIHEEC
Time & Society	coden	TIMSEB
Transactions of the Institute of Measurement and Control	coden	TICODG
Textile Research Journal	coden	TRJOA9
Waste Management & Research	coden	WMARD8
Proceedings of the Institution of Mechanical Engineers, Part A: Journal of Power and Energy	coden	PMAEET
Proceedings of the Institution of Mechanical Engineers, Part B: Journal of Engineering Manufacture	coden	PIBMEU
Proceedings of the Institution of Mechanical Engineers, Part C: Journal of Mechanical Engineering Science	coden	PMCSED
Proceedings of the Institution of Mechanical Engineers, Part E: Journal of Process Mechanical Engineering	coden	PMEEEF
Compositio Mathematica	coden	CMPMAF
Proceedings of the Institution of Mechanical Engineers	coden	PIMLAA
Palaeogeography, Palaeoclimatology, Palaeoecology	coden	PPPYAB
American Journal of Enology and Viticulture	coden	AJEVAC
SIAM Journal on Numerical Analysis	coden	SJNAAM
Pramana	coden	PRAMCI
American Journal of Ophthalmology	coden	AJOPAA
The American Journal of Psychoanalysis	coden	AJPYA8
Proceedings of the Institution of Mechanical Engineers, Part G: Journal of Aerospace Engineering	coden	PMGEEP
Proceedings of the Institution of Mechanical Engineers, Part H: Journal of Engineering in Medicine	coden	PIHMEQ
Proceedings of the Institution of Mechanical Engineers, Part L: Journal of Materials: Design and Applications	coden	PIMAFG
Proceedings of the Institution of Mechanical Engineers, Part J: Journal of Engineering Tribology	coden	PEJTET
Concurrent Engineering	coden	CRAPEM
Advances in Colloid and Interface Science	coden	ACISB9
Journal of Industrial Textiles	coden	JINTFC
Quarterly Journal of Mathematics	coden	QJMAAT
Angiology	coden	ANGIAB
Biological Research for Nursing	coden	BRNIAH
Clinical Pediatrics	coden	CPEDAM
Clinical and Applied Thrombosis-Hemostasis	coden	CATHF9
Criminal Justice and Behavior	coden	CJBHAB
Educational and Psychological Measurement	coden	EPMEAJ
Environment and Behavior	coden	EVBHAF
International Journal of Toxicology	coden	IJTOFN
International Journal of Surgical Pathology	coden	IJSPFL
Journal of Biomolecular Screening	coden	JBISF3
Journal of Biological Rhythms	coden	JBRHEE
Journal of Dental Research	coden	JDREAF
Journal of Family Issues	coden	JFISDT
Journal of Human Lactation	coden	JHLAE5
Experimental Hematology	coden	EXHMA6
Physics of Plasmas	coden	PHPAEN
Briefings in Bioinformatics	coden	BBIMFX
Nanotechnology	coden	NNOTER
Journal of Business and Technical Communication	coden	JBTCE9
Journal of Mathematical Psychology	coden	JMTPAJ
Journal of Pakistan Medical Association	coden	JJPAD4
Technical Communication Quarterly	coden	TCQEAB
Journal of Information Science	coden	JISCDI
Journal of the Electrochemical Society	coden	JESOAN
Neurosurgery	coden	NRSRDY
Biological Psychology	coden	BLPYAX
Kew Bulletin	coden	KEWBAF
European Review for Medical and Pharmacological Sciences	coden	RESFD
Infection	coden	IFTNAL
Pacing and Clinical Electrophysiology	coden	PPCEDP
Internal Medicine	coden	IEDIEP
Pan American Journal of Public Health	coden	RPSPFQ
Biomedical Materials	coden	BMBUCS
Biofabrication	coden	BIOFCK
Journal of the British Astronomical Association	coden	JBAAA6
Applied Spectroscopy	coden	APSPA4
Annals of Physics	coden	APNYA6
IEEE Transactions on Electron Devices	coden	IETDAJ
Cell Biology International	coden	CBIIEV
Tectonophysics	coden	TCTOAM
Journal of Economic Behavior and Organization	coden	JEBOD9
AIP Conference Proceedings	coden	APCPCS
Journal of Banking and Finance	coden	JBFIDO
Muelleria	coden	MAJBAC
Journal of Cross-Cultural Gerontology	coden	JCCGEB
Annals of Otology, Rhinology, and Laryngology	coden	AORHA2
Biokhimiya	coden	BIORAK
Current Alzheimer Research	coden	CARUBY
Current Molecular Medicine	coden	CMMUBP
Current Gene Therapy	coden	CGTUAH
Current Cancer Drug Targets	coden	CCDTB9
Current Medicinal Chemistry	coden	CMCHE7
Current Topics in Medicinal Chemistry	coden	CTMCCL
The Open Ecology Journal	coden	OEJPF7
Cytoskeleton	coden	CMCYEO
Evolutionary Anthropology	coden	EVANEW
Genesis	coden	GNESFY
Journal of Orthopaedic Research	coden	JOREDR
Open Biology	coden	OBPICQ
Journal of Continuing Education in Nursing	coden	JCENB5
ACM Transactions on Computational Biology and Bioinformatics	coden	ITCBCY
Veterinary Immunology and Immunopathology	coden	VIIMDS
Dermatology	coden	DERAEG
IEEE Transactions on Education	coden	IEEDAB
European Journal of Women's Studies	coden	EJWSE5
Human & Experimental Toxicology	coden	HETOEA
Finance & Development	coden	FNDVAM
Clinical Rehabilitation	coden	CEHAEN
Journal of Grid Computing	coden	JGCOAP
Journal of Theoretical Politics	coden	JTPOEF
Discourse & Society	coden	DISOEN
Journal of the American Academy of Child and Adolescent Psychiatry	coden	JAAPEE
Feminism & Psychology	coden	FEPSFF
High Performance Polymers	coden	HPPOEX
The Holocene	coden	HOLOE6
Psychotherapy Research	coden	PRSECG
Methods of Information in Medicine	coden	MIMCAI
International Journal of High Performance Computing Applications	coden	IHPCFL
Indoor and Built Environment	coden	IBENFP
International Journal of Bilingualism	coden	IJBIFH
International Journal of Damage Mechanics	coden	IDMEEH
Innate Immunity	coden	IINMCB
British Journal of Educational Technology	coden	BJEDTK
Southwestern Entomologist	coden	SENTDD
Journal of Biomaterials Applications	coden	JBAPEL
Inorganica Chimica Acta	coden	ICHAA3
Journal of Biosciences	coden	JOBSDN
Respiratory Care	coden	RECACP
Plastic and Reconstructive Surgery	coden	PRSUAS
AAPG Bulletin	coden	AABUD2
Behavioral Ecology and Sociobiology	coden	BESOD6
Marine Ecology Progress Series	coden	MESEDT
Journal of the Geological Society	coden	JGSLAS
Applied Developmental Science	coden	ADSCFM
Knowledge Organization	coden	KNOREM
Meteorologische Zeitschrift	coden	MEZEEV
Psychology of Women Quarterly	coden	PWOQDY
Otolaryngology-Head and Neck Surgery	coden	OHNSDL
Journalism & Mass Communication Quarterly	coden	JMCQFA
Science Communication	coden	SCICEQ
Urban Affairs Review	coden	UAREFI
Violence Against Women	coden	VAWOFG
Qualitative Health Research	coden	QHREEM
Nonprofit and Voluntary Sector Quarterly	coden	NVSQEQ
Medical Decision Making	coden	MDMADE
Nutrition in Clinical Practice	coden	NCPREH
Business Information Review	coden	BIREEY
Clinical Child Psychology and Psychiatry	coden	CCPPFR
Contemporary Family Therapy	coden	CFTHE9
Nephrology Dialysis Transplantation	coden	NDTREA
Asian Cardiovascular and Thoracic Annals	coden	ACTAFE
ACS Synthetic Biology	coden	ASBCD6
Stochastic Models	coden	SMTOBE
Annals of Science	coden	ANNSA8
Geostandards and Geoanalytical Research	coden	GGREA3
Journal of Management Education	coden	JMEUFW
Revue de Médecine Interne	coden	RMEIDE
Current Approaches in Psychiatry	coden	PGYSA9
Revista Colombiana de Química	coden	RCLQAY
Journal of Archaeological Science	coden	JASCDU
Canadian Journal of Zoology	coden	CJZOAG
Business and Society Review	coden	BUSRAM
Economic Inquiry	coden	ECIND6
IEEE Transactions on Terahertz Science and Technology	coden	ITTSBX
Journal of Applied Crystallography	coden	JACGAR
Diversity and Distributions	coden	DIDIFX
Accountability in Research	coden	ARQAEZ
British Journal of Nutrition	coden	BJNUAV
Chemistry of Natural Compounds	coden	CHNCA8
The International Journal of Neuropsychopharmacology	coden	IJNUFB
Behavior Modification	coden	BEMOD
Journal of Hymenoptera Research	coden	JHYREJ
International Review of Victimology	coden	IRVIE2
Serbian Astronomical Journal	coden	SAJOFK
Archive for History of Exact Sciences	coden	AHESAN
Neues Jahrbuch für Geologie und Paläontologie	coden	NJGMA2
Annals of Probability	coden	APBYAE
Communications of the Lunar and Planetary Laboratory	coden	AULCBY
Central Asiatic Journal	coden	CAJOFE
European Journal of Medical Research	coden	EJMRFL
Computational Statistics & Data Analysis	coden	CSDADW
Voluntas	coden	VOLUE8
Journal of Basic Microbiology	coden	JBMIEQ
Journal of Analytical Toxicology	coden	JATOD3
Biotropica	coden	BTROAZ
Publications of the Astronomical Society of Japan	coden	PASJAC
Systematic Botany	coden	SYBODA
Monographs in Systematic Botany	coden	MSBOE5
Developmental Dynamics	coden	DEDYEI
Cultural Studies	coden	CUSTE9
ELife	coden	ELIFA8
Advanced Drug Delivery Reviews	coden	ADDREP
Vascular Pharmacology	coden	VPAHAJ
Gender & History	coden	GEHIEN
Diabetes, Obesity and Metabolism	coden	DOMEF6
Autonomous Agents and Multi-Agent Systems	coden	AAMSFJ
Entomologisk tidskrift	coden	ETTIAC
Applied Thermal Engineering	coden	ATENFT
European Journal of Pharmaceutical Sciences	coden	EPSCED
Journal of the Korean Astronomical Society	coden	CHACDE
Maal og Minne	coden	MAMIFJ
Journal of Sensory Studies	coden	JSSDEO
Journal of Food Safety	coden	JFSADP
Journal of Food Quality	coden	JFQUD7
Journal of Food Processing and Preservation	coden	JFPPDL
Journal of Food Process Engineering	coden	JFPEDM
Journal of Food Biochemistry	coden	JFBIDW
Journal of Texture Studies	coden	JTXSBU
The International Journal of Developmental Biology	coden	IJDBE5
Child Development	coden	CHDEAW
Journal of Biotechnology	coden	JBITD4
Biotechnology Advances	coden	BIADDD
Abacus	coden	ABACAF
Journal of Multivariate Analysis	coden	JMVAAI
Enzyme and Microbial Technology	coden	EMTED2
Metabolic Engineering	coden	MEENFM
Social Politics	coden	SOPOFC
Journal of the Academy of Nutrition and Dietetics	coden	JADAAE
Arctic Anthropology	coden	ARANBP
Journal of the Korean Physical Society	coden	JKPSDV
Advanced Science Letters	coden	ASLDAM
Mathematical Social Sciences	coden	MSOSDD
Microelectronics International	coden	MIINF2
Revue neurologique	coden	RENEAM
Quantum Electronics	coden	SJQEAF
Pacific Insects	coden	PFISAO
International Journal of Biological Macromolecules	coden	IJBMDR
Chinese Physics Letters	coden	CPLEEU
Fuel Cells	coden	FUCEFK
Pattern Recognition Letters	coden	PRLEDG
Journal of the American Medical Directors Association	coden	JAMDC2
Journal of Comparative and Physiological Psychology	coden	JCPPAV
Journal of Comparative Psychology	coden	JCOPDT
Electromagnetics	coden	ETRMDV
Current Genomics	coden	CMMUBP
International Journal of Medical Microbiology	coden	IMEMFV
Genes	coden	GENEG9
Journal of Traumatic Stress	coden	JTSTEB
Materials & Design	coden	MADSD2
Journal of Marriage and Family	coden	JMFAA6
Virginia Environmental Law Journal	coden	VELJF8
Journal of Materials Engineering and Performance	coden	JMEPEG
Health Services Research	coden	HESRA
Criminology	coden	CRINYA
Nematology	coden	NMATFJ
Human Ecology	coden	HMECAJ
Journal of Adolescent & Adult Literacy	coden	JADLFI
The Reading Teacher	coden	REDTAH
Reading Research Quarterly	coden	RRQUA6
Monographs of the Society for Research in Child Development	coden	MSCDA7
Political Psychology	coden	POPSEO
Journal of Small Business Management	coden	JSBMAU
Risk Analysis	coden	RIANDF
Journal of Product Innovation Management	coden	JPI?DD
Decision Sciences Journal of Innovative Education	coden	DSJIE
Materials Chemistry and Physics	coden	MCHPDR
American Journal of Preventive Medicine	coden	AJPMEA
Methods	coden	MTHDE9
Nitric Oxide	coden	NIOXF5
Geobiology	coden	GEOBCZ
Biomedical Optics Express	coden	BOEICL
Biology and Philosophy	coden	BIOPEI
Micron	coden	MCONEN
Journal of New Music Research	coden	JNEMEE
Proceedings of the Royal Society of Queensland	coden	PRSQAG
Canadian Journal of Behavioural Science	coden	CJBSAA
Canadian Psychology	coden	CPSGD2
Chinese Medical Journal	coden	CMDJAS
Ecological Economics	coden	ECECEM
Annals of Behavioral Medicine	coden	ABMEEH
Marine Biology	coden	MBIOAJ
European Journal of Cancer Care	coden	EUCAEU
Behavioral Neuroscience	coden	BENEDJ
The Indian Forester	coden	IORA8
Dreaming	coden	DRMGEW
Journal of Population Economics	coden	JPECEW
Journal of Parasitology	coden	JOPAA2
Clinical Interventions in Aging	coden	CIALBC
Child: Care, Health and Development	coden	CCHDDH
International Journal of Stress Management	coden	ISMAE8
Drugs & Aging	coden	DRAGE6
Gender, Work and Organization	coden	GWORF8
International Labour Review	coden	ILREDT
Journal of Agricultural Economics	coden	JAGEA7
Zeitschrift für Naturforschung B	coden	ZNBSEN
Zeitschrift für Naturforschung A	coden	ZNASEI
Natural Resources Forum	coden	NRFODS
Zeitschrift für Naturforschung C	coden	ZNCBDA
Clinical Chemistry and Laboratory Medicine	coden	CCLMFW
Reviews in Clinical Gerontology	coden	RCGEEB
PharmacoEconomics	coden	PARMEK
Molecular Brain	coden	MBORAO
Wjm	coden	WJMDA2
Polish Sociological Review	coden	PSREFL
Yeast	coden	YESTE3
Parasite	coden	PASIED
Computational Biology and Chemistry	coden	CBCOCH
Journal of Experimental Botany	coden	JEBOA6
Journal of Colloid and Interface Science	coden	JCISA5
Indian Journal of Medical Research	coden	IMIREV
Journal of Mining Science	coden	JMCIEJ
Organic Geochemistry	coden	ORGEDE
Journal of Mining and Metallurgy, Section B	coden	JMBMFR
Engineering Geology	coden	EGGOAO
Marine Resource Economics	coden	JMREDD
Discrete Mathematics & Theoretical Computer Science	coden	DTCSFX
Review of Policy Research	coden	RPRECJ
Early Human Development	coden	EHDEDN
Psychiatry Research: Neuroimaging	coden	PSREEK
Psychoneuroendocrinology	coden	PSYCDE
Superconductor Science and Technology	coden	SUSTEF
TESOL Journal	coden	TEJOEO
Journal of the History of Biology	coden	JHBIA9
Academic Questions	coden	ACQUEO
Nanoscale	coden	NANOHL
The Journal of Nuclear Medicine	coden	JNMEAQ
Journal of Antimicrobial Chemotherapy	coden	JACHDX
Journal of Psychiatric Research	coden	JPYRA3
Journal of Nuclear Medicine Technology	coden	JNMTB4
IEEE Journal on Selected Areas in Communications	coden	ISACEM
Studia Leibnitiana	coden	STLBBI
Spectrochimica Acta Part A: Molecular and Biomolecular Spectroscopy	coden	SAMCAS
Journal of Pineal Research	coden	JPRSE9
Toxicological Sciences	coden	TOSCF2
Biosensors and Bioelectronics	coden	BBIOE4
Journal of Adolescent Health	coden	JADHE5
Open Access Journal of Medicinal and Aromatic Plants	coden	OAJMAX
RSC Advances	coden	RSCACL
Family and Consumer Sciences Research Journal	coden	FCSJEM
Food and Chemical Toxicology	coden	FCTOD7
Curator: The Museum Journal	coden	CRTRAH
Differences	coden	DIFFEX
Regulatory Toxicology and Pharmacology	coden	RTOPDW
Psychophysiology	coden	PSPHAF
Business Ethics: A European Review	coden	BUETFV
Journal of South American Earth Sciences	coden	JAESE9
Experimental Brain Research	coden	EXBRAP
Geographical Analysis	coden	GPHAA4
International Journal of Geographical Information Science	coden	IGISFR
Rubber Chemistry and Technology	coden	RCTEA4
Journal of Geriatric Cardiology	coden	JGCOBQ
Leukemia Research	coden	LEREDD
The Eugenics Review	coden	EUREAB
Combinatorial Chemistry & High Throughput Screening	coden	CCHSFU
Journal of Pharmacy and Pharmacology	coden	JPPMAB
Canadian Journal of Law and Society	coden	CJLSEU
Optical Engineering	coden	OPEGAR
Journal of Electronic Imaging	coden	JEIME5
Biotechnology Journal	coden	BJIOAM
Journal of Affective Disorders	coden	JADID7
Publications of the Astronomical Society of Australia	coden	PASAFO
Acta Ophthalmologica	coden	AOOUAQ
Psychologica Belgica	coden	PBELAN
Nuclear Science and Techniques	coden	NSETEC
Physics Essays	coden	PHESEM
Turkish Journal of Biology	coden	TJBIEZ
Bulletin of the Seismological Society of America	coden	BSSAAP
Earth-Science Reviews	coden	ESREAV
Journal of Solid State Chemistry	coden	JSSCBI
Herald of the Russian Academy of Sciences	coden	HRUSEG
Pain	coden	PAINDB
Combustion and Flame	coden	CBFMAO
Journal of Toxicology and Environmental Health	coden	JTEHD6
Theoretical Population Biology	coden	TLPBAQ
Russian Journal of Physical Chemistry B	coden	RJPCCT
Cell Calcium	coden	CECADV
Purinergic Signalling	coden	PSUIA9
Oxford Journal of Archaeology	coden	OJARE2
Annual Review of Physical Chemistry	coden	ARPLAP
Russian Journal of Physical Chemistry A	coden	RJPCBS
Bulletin of Materials Science	coden	BUMSDW
Pharmacology, Biochemistry and Behavior	coden	PBBHAU
Journal of Chemical Sciences	coden	JCSBB5
Proceedings - Mathematical Sciences	coden	PIAMDO
Journal of Chemical Ecology	coden	JCECD8
European Neuropsychopharmacology	coden	EURNE8
Biologia	coden	BILGA6
ACM Transactions on Information Systems	coden	ATISET
Hormones and Cancer	coden	HCOABS
The Independent Review	coden	IREVFP
Archives of Toxicology	coden	ATSUDG
Brain, Behavior, and Immunity	coden	BBIMEW
NeuroToxicology	coden	NRTXDN
Clinical Therapeutics	coden	CLTHDG
Neural Plasticity	coden	NEPLFE
Neurobiology of Disease	coden	NUDIEM
Neurotoxicology and Teratology	coden	NETEEC
Doklady Physics	coden	DOPHFU
Progress in Neurobiology	coden	PNNEA
Sleep Medicine Reviews	coden	SMREFC
Frontiers in Neuroendocrinology	coden	FNEDA7
Machine Vision and Applications	coden	MVAPEO
Theory & Society	coden	301568766
Brain Structure and Function	coden	BSFRCD
Journal of Psychiatry & Neuroscience	coden	JPNEEF
Translational Psychiatry	coden	TPRSCF
Spectrochimica Acta Part B: Atomic Spectroscopy	coden	SAASBH
Molecular Neurobiology	coden	MONBEW
Current Opinion in Neurology	coden	CONEEX
Optometry and Vision Science	coden	OVSCET
Medicine	coden	MEDIAV
Sleep	coden	SLEED6
Applied Artificial Intelligence	coden	AAINEH
Glia	coden	GLIAEJ
Food Structure	coden	FSTUE2
Journal of Translational Medicine	coden	JTMOBV
Aging Cell	coden	ACGECQ
American Midland Naturalist	coden	AMNAAF
Steroids	coden	STEDAM
Toxicology in Vitro	coden	TIVIEQ
Journal of Neuroinflammation	coden	JNOEB3
Bipolar Disorders	coden	BDIIAU
Journal of Medical Virology	coden	JMVIDB
Pathophysiology	coden	PTHOE7
Health Services Management Research	coden	HSRMEO
International Journal of STD & AIDS	coden	INSAE3
Theoretical and Applied Climatology	coden	TACLEK
Journal of Exposure Science and Environmental Epidemiology	coden	JESEBS
Arctic, Antarctic, and Alpine Research	coden	AAARFO
General and Comparative Endocrinology	coden	GCENA5
Journal of Nutritional Biochemistry	coden	JNBIEL
Obesity Reviews	coden	ORBEBL
Clinical and Experimental Immunology	coden	CEXIAL
Journal of Molecular Endocrinology	coden	JMLEEI
Molecular Autism	coden	MAOUBR
Archives of Oral Biology	coden	AOBIAR
Revue Médicale de Bruxelles	coden	RMBRDQ
Physical Review X	coden	PRXHAE
Neurochemical Research	coden	NEREDZ
Neuromolecular Medicine	coden	NMEEAN
Appetite	coden	APPTD4
Developmental Neurobiology	coden	DNEEAM
Molecular Biotechnology	coden	MLBOEO
Epidemiologic Reviews	coden	EPIRD7
Journal of Marketing Research	coden	JMKRAE
Animal Welfare	coden	ANWEEF
American Journal of Nursing	coden	AJNUAK
The Nurse Practitioner: The American Journal of Primary Healthcare	coden	NRPRDJ
Critical Reviews in Analytical Chemistry	coden	CCACBB
Journal of Developmental and Behavioral Pediatrics	coden	JDBPD5
Journal of Phycology	coden	JPYLAJ
Alzheimer's Research & Therapy	coden	ARTLCD
Physiological Reports	coden	PRHEJ2
Contraception	coden	CCPTAY
Anatolian Journal of Cardiology	coden	AKDNAO
Journal of Neuropathology & Experimental Neurology	coden	JNENAD
Depression and Anxiety	coden	DEANF5
Nature Climate Change	coden	NCCACZ
Chemical Engineering Science	coden	CESCAC
Journal of Autoimmunity	coden	JOAUEP
Clinical Pharmacology & Therapeutics	coden	CLPTAT
Investigative Radiology	coden	INVRAV
Atlantic Geology	coden	ATGEEB
Journal of Atmospheric and Solar-Terrestrial Physics	coden	JASPF3
Stochastic Processes and their Applications	coden	STOPB7
Fennia	coden	FENNAJ
Expert Review of Anti-infective Therapy	coden	ERATCK
Regional Studies	coden	REGSAT
Environmental Health	coden	EHAGAB
American Journal of Reproductive Immunology	coden	AAJID8
The Journal of Pain	coden	JPOAB5
Expert Review of Clinical Pharmacology	coden	ERCPAG
Resource and Energy Economics	coden	REEEEF
Polar Record	coden	POLRAV
Res Publica	coden	REPUFH
European Journal of Neurology	coden	EJNEFL
Linear Algebra and its Applications	coden	LAAPAW
Journal of the Chemical Society of Pakistan	coden	JCSPDF
American Heart Journal	coden	AHJOA2
Journal of Biomedical Science	coden	JBCIEA
Expert Review of Anticancer Therapy	coden	ERATBJ
Expert Review of Medical Devices	coden	ERMDDX
Avian Diseases	coden	AVDIAI
AIP Advances	coden	AAIDBI
Journal of Integrative Medicine	coden	JIMOBM
Planta	coden	PLANAB
Annales Zoologici	coden	AZOGAR
APL Materials	coden	AMPADS
Applied Physics Reviews	coden	APRPG5
Biomicrofluidics	coden	BIOMGB
Chaos	coden	CHAOEH
Journal of Physical and Chemical Reference Data	coden	JPCRBU
Low Temperature Physics	coden	LTPHEG
BioMetals	coden	BOMEEH
Journal of Inorganic Biochemistry	coden	JIBIDJ
American Journal of Orthopsychiatry	coden	AJORAG
IEEE Transactions on Signal Processing	coden	ITPRED
FEMS Microbiology Ecology	coden	FMECEZ
Academic Emergency Medicine	coden	AEMEF5
History of Science	coden	HISCAR
Biological & Pharmaceutical Bulletin	coden	BPBLEO
NeuroRehabilitation	coden	NRORFG
Journal of Structural Geology	coden	JSGEDY
Learning & Memory	coden	LEMEFO
Molecular Neurodegeneration	coden	MNOEAZ
Journal of Pure and Applied Algebra	coden	JPAAA2
Australian Feminist Studies	coden	AFSTFJ
Journal of Synchrotron Radiation	coden	JSYRES
Carbohydrate Research	coden	CRBRAT
Environmental Sciences Europe	coden	USZOE9
Quarterly Journal of the Royal Meteorological Society	coden	QJRMAM
Life	coden	LBSIB7
Radiophysics and Quantum Electronics	coden	RPQEAC
Cognitive, Affective, & Behavioral Neuroscience	coden	CABNC2
Journal of Biomedical Optics	coden	JBOPFO
Autonomic Neuroscience: Basic and Clinical	coden	ANUEB2
Clinical Neurophysiology	coden	CNEUFU
Annali di Matematica Pura ed Applicata	coden	ANLMAE
Acta Agriculturae Scandinavica. Section B. Soil and Plant Science	coden	AASBEV
Agriculture, Ecosystems & Environment	coden	AEENDO
Hormones and Behavior	coden	HOBEAO
ACS Photonics	coden	APCHD5
Biology	coden	BBSIBX
Current Neurology and Neuroscience Reports	coden	CNNRBS
Medical Care	coden	MDLCBD
Mini-Reviews in Medicinal Chemistry	coden	MMCIAE
Immunology	coden	IMMUAM
Journal of Group Theory	coden	JGTHFQ
Journal of Industrial Ecology	coden	JINEFZ
Acta Physiologica	coden	APCHC4
Environmental Toxicology and Pharmacology	coden	ETOPFR
Acarologia	coden	ACRLAW
Experimental and Applied Acarology	coden	EAACEM
Journal of Non-Equilibrium Thermodynamics	coden	JNETDY
Molecular Pain	coden	MPOAC5
Journal of Child and Family Studies	coden	JCFSES
Earth, Planets and Space	coden	EPSPFJ
Journal of Experimental and Theoretical Artificial Intelligence	coden	JEAIL
Energy Policy	coden	ENPYAC
Chemotherapy	coden	CHTHBK
Current Opinion in Colloid and Interface Science	coden	COCSFL
BioMed Research International	coden	BRIIDT
Annals of the Institute of Statistical Mathematics	coden	AISXAD
Current Opinion in Anaesthesiology	coden	COAUCE
Cytometry Part A	coden	CYTODQ
Mathematical Biosciences	coden	MABIAR
Educational Psychologist	coden	EDPSDT
Antarctic Science	coden	ANTSE8
Atmosphere	coden	ATMOCZ
Applied Acoustics	coden	AACOBL
Solid State Ionics	coden	SSIOD3
ECS Electrochemistry Letters	coden	EELCBY
ECS Solid State Letters	coden	ESSLCP
Electrochemical and Solid State Letters	coden	ESLEF6
Atmospheric Environment	coden	AENVEQ
Medicine & Science in Sports & Exercise	coden	MSPEDA
Acta Neurobiologiae Experimentalis	coden	ANEXAC
Photonic Sensors	coden	PSHEC2
Malaria Journal	coden	MJAOAZ
Revista Cubana de Física	coden	RECFD7
Reviews on Environmental Health	coden	REVHA3
Competition & Change	coden	COCHFM
Interface	coden	ELSIE3
Acta Neurologica Belgica	coden	ANUBBR
Journal of Neuro-Oncology	coden	JNODD2
Geophysics	coden	GPYSA7
The Journal of Mental Health Policy and Economics	coden	JMHPAR
Journal of Quantitative Criminology	coden	JQCRE6
Social Science Research	coden	SSREBG
Acupuncture & Electro-Therapeutics Research	coden	AEREDS
Epigenetics	coden	EPIGB6
International Journal of Mosquito Research	coden	IJMRK2
Radio Science	coden	RASCAD
Cognition	coden	CGTNAU
American Journal of Hypertension	coden	AJHYE6
Inflammation Research	coden	INREFB
Intensive Care Medicine	coden	ICMED9
South African Journal of Botany	coden	SAJBDD
Quaternary Science Reviews	coden	QSREDU
Human Pathology	coden	46
Systematic Parasitology	coden	SYPAD4
Journal of Critical Care	coden	JCCAER
Immunotherapy	coden	IMMUCO
Psychiatry Research	coden	PSRSDR
European Journal of Clinical Nutrition	coden	EJCNEQ
The Pediatric Infectious Disease Journal	coden	PIDJEV
Genetics in Medicine	coden	GEMEF3
The Turkish Journal of Pediatrics	coden	TJPDAI
Research in Developmental Disabilities	coden	RDDIEF
Critical Care Clinics	coden	CCCLEH
Asian Journal of Andrology	coden	ASJAF8
Experimental & Molecular Medicine	coden	EMMEF3
Maturitas	coden	MATUDK
Journal of Neuroscience Methods	coden	JNMEDT
Minerva Medica	coden	MIMEAO
Annals of Intensive Care	coden	AICNC7
European Journal of Clinical Microbiology & Infectious Diseases	coden	EJCDEU
Annals of Nuclear Energy	coden	ANENDJ
Radiation Protection Dosimetry	coden	RPDODE
Journal of Non-Crystalline Solids	coden	JNCSBJ
Health Physics	coden	HLTPAO
International Journal of Energy Research	coden	IJERDN
Journal of Environmental Radioactivity	coden	JERAEE
Journal of Nuclear Materials	coden	JNUMAM
The Pharmacogenomics Journal	coden	PJHOAZ
Journal of Materials Chemistry A	coden	JMCAET
Journal of Materials Chemistry B	coden	JMCBDV
Annali dell'Istituto Superiore di Sanità	coden	AISSAW
Translational Research	coden	JLCMAK
Journal of Radiation Research	coden	JRARAX
Progress in Nuclear Energy	coden	PNENDE
Radiation and Environmental Biophysics	coden	REBPAT
Radiation Measurements	coden	RMEAEP
Neurogastroenterology & Motility	coden	NMOTEK
Medical Microbiology and Immunology	coden	MMIYAO
Journal of Ethnobiology	coden	JOUEE9
Blood Cells, Molecules and Diseases	coden	BCMDFX
Journal of Materials Chemistry C	coden	JMCCCX
Differentiation	coden	DFFNAW
Nicotine & Tobacco Research	coden	NTREF6
Computational and Structural Biotechnology Journal	coden	CSBJAC
Journal of Dentistry	coden	JDENAB
Journal of Electrocardiology	coden	JECAB4
The Angle Orthodontist	coden	ANORAA
Behaviour	coden	BEHAA8
European Journal of Endocrinology	coden	EJOEEP
Journal of Circadian Rhythms	coden	JCROB5
Virchows Archiv	coden	VARCEM
Women & Therapy	coden	WOTHDJ
Breast Cancer Research	coden	BCRRCT
Annals of Allergy, Asthma & Immunology	coden	ALAIF6
Environment International	coden	ENVIDV
Behavioural Pharmacology	coden	BPHAEL
The Johns Hopkins Medical Journal	coden	JHMJAX
Women's Health Issues	coden	WHISEH
Nutrition	coden	NUTRER
Energy Technology	coden	ETNEFN
Epigenomics	coden	EPIGC7
Future Microbiology	coden	FMUIAR
Materials Horizons	coden	MHAOBM
Plant Systematics and Evolution	coden	ESPFBP
Annual Review of Fluid Mechanics	coden	ARVFA3
Indian Journal of Gender Studies	coden	IJGSF4
Public Health Reports	coden	PHRPA6
Health & Place	coden	HEPLFG
ChemSusChem	coden	CHEMIZ
Chimica Oggi - Chemistry Today	coden	CHOGDS
AoB Plants	coden	APOLD9
Journal of Mathematical Economics	coden	JMECDA
AIDS and Behavior	coden	AIBEFC
Agro FOOD Industry Hi Tech	coden	AIHTEI
Experimental Parasitology	coden	EXPAAA
Endocrine-Related Cancer	coden	ERCAE9
Parasitology	coden	PARAAE
Archives Italiennes de Biologie	coden	AIBLAS
Women's Studies International Forum	coden	WSINDA
European Urology	coden	EUURAV
Sydowia	coden	SYAMAU
Journal of Applied Microbiology	coden	JAMIFK
Journal of Zhejiang University Science A	coden	JZUSBN
Journal of Zhejiang University Science B	coden	JZUSAM
European Journal of Public Health	coden	EJPHF6
Epilepsy & Behavior	coden	EBPEA4
IEEE Transactions on Fuzzy Systems	coden	IEFSEV
ASN Neuro	coden	ANSEFU
Endoscopy	coden	ENDCAM
European Journal of Pain	coden	EJPAFJ
Cell Biochemistry and Biophysics	coden	CBBIFV
Radiation Research	coden	RAREAE
Protein & Cell	coden	PCREFB
Physics in Perspective	coden	PHPEF2
Journal of Addiction Medicine	coden	JAMOCZ
Transplantation	coden	TRPLAU
Bioanalysis	coden	BIOAB4
Pharmacogenomics	coden	PARMFL
Biomarkers in Medicine	coden	BMIEDG
Nutrition Reviews	coden	NUREA8
Gastrointestinal Endoscopy	coden	GAENBQ
HIV Medicine	coden	HMIEAB
Journal of Human Hypertension	coden	JHHYE
Future Oncology	coden	FOUNBN
Nanomedicine	coden	NLUKAC
Future Virology	coden	FVUIAM
Personalized Medicine	coden	PMEECD
Regenerative Medicine	coden	RMEECZ
Future Medicinal Chemistry	coden	FMCUA7
Personal Relationships	coden	PRRLEY
Respirology	coden	69
Norwegian Journal of Geography	coden	NGGTA2
Annual Reports on the Progress of Chemistry	coden	ARPCAW
Journal of Business Research	coden	JBRED4
Water Science and Technology	coden	WSTED4
Health Care for Women International	coden	HCWIDQ
Food and Nutrition Bulletin	coden	FNBPDV
European Journal of Pediatrics	coden	EJPEDT
Source Code for Biology and Medicine	coden	SCBMCJ
Eye	coden	EYEEEC
Journal of Women's Health	coden	JWHOAQ
Advances in Microbial Physiology	coden	AMIPB2
Arquivos de Neuro-Psiquiatria	coden	ANPIAM
The British Journal of Criminology	coden	BJCDAR
Pharmacological Research	coden	PHMREP
Transactions of the Royal Society of Tropical Medicine and Hygiene	coden	TRSTAZ
Journal of Women & Aging	coden	JWAGE5
IEEE Transactions on Advanced Packaging	coden	ITAPFZ
IEEE Transactions on Aerospace and Electronic Systems	coden	IEARAX
European Neurology	coden	EUNEAP
Pain Medicine	coden	PMAEAP
Feminist Legal Studies	coden	FLSTED
Information Systems	coden	INSYD6
Epigenetics & Chromatin	coden	ECPHAK
Revista Brasileira de Engenharia, Caderno de Engenharia Química	coden	RRBEEN
Aquatic Conservation: Marine and Freshwater Ecosystems	coden	AQCOEY
NPG Asia Materials	coden	NAMPCE
Journal of Materials Research and Technology	coden	JMRTAL
Aggression and Violent Behavior	coden	AVBEFZ
Ymer	coden	YMERAD
International Journal of Clinical Practice	coden	IJCPF9
Myanmar Medical Journal	coden	BMDJA3
Current Drug Metabolism	coden	CDMUBU
Psychotherapy and Psychosomatics	coden	PSPSBF
Addictive Behaviors	coden	ADBEDS
Medical Science Monitor	coden	MSMOFR
International Journal of Multiphase Flow	coden	IJMFBP
Chinese Chemical Letters	coden	CCLEE7
Advances in Parasitology	coden	ADPRAD
Science of the Total Environment	coden	STENDL
Memórias do Instituto Oswaldo Cruz	coden	MIOCAS
Clinical Research in Cardiology	coden	CRCLCI
International Journal of Impotence Research	coden	IJIRFB
Journal of Accounting and Public Policy	coden	JACPDN
Journal of Cancer Research and Clinical Oncology	coden	JCROD7
International Archives of Occupational and Environmental Health	coden	IAEHDW
Psycho-Oncology	coden	POJCEE
Journal of Physics and Chemistry of Solids	coden	JPCSAW
Biological Conservation	coden	BICOBK
Medical History	coden	MDHIAA
Developmental Cell	coden	DCEEBE
Gender, Place & Culture: A Journal of Feminist Geography	coden	GPCUE9
Mycopathologia	coden	MYCPAH
Hepatology	coden	HPTLD9
Archives of Microbiology	coden	AMICCW
British Medical Bulletin	coden	BMBUAQ
Oryx	coden	ORYXAM
Canadian Journal of Research	coden	CJREAE
Combinatorics, Probability and Computing	coden	CPCOFG
American Journal of Industrial Medicine	coden	AJIMD8
Child Abuse Review	coden	CABEEB
Progress in Neuro-Psychopharmacology & Biological Psychiatry	coden	PNPPD7
International Journal of Modelling and Simulation	coden	IMSIEK
Historical Biology	coden	HIBIEW
Progress in Cardiovascular Diseases	coden	PCVDAN
Review of Palaeobotany and Palynology	coden	RPPYAX
Journal of Technical Writing and Communication	coden	JTWCAA
Frontiers in Biology	coden	FBRIA3
Neuroepidemiology	coden	NEEPD3
Estuarine, Coastal and Shelf Science	coden	ECSSD3
Journal of Strategic Information Systems	coden	JSIYE3
Italian Journal of Anatomy and Embryology	coden	IEMBEF
Environmental Fluid Mechanics	coden	EFMNAA
Scientia Marina	coden	SCIMEM
Aquaculture Research	coden	AQREFC
Israel Journal of Entomology	coden	IJENB9
Brazilian Journal of Physics	coden	BJPHE6
Neuro-Oncology	coden	NEURJR
Neurotoxicity Research	coden	NURRFI
Journal of Aggression, Maltreatment & Trauma	coden	JAMTFJ
Pharmacy and Therapeutics	coden	PPTTEK
Australasian Physical & Engineering Sciences in Medicine	coden	AUPMDI
Medical Anthropology	coden	MDANES
Medical Physics	coden	MPHYA6
Social Psychiatry and Psychiatric Epidemiology	coden	SPPEEM
Journal of Criminal Justice	coden	JCJUDJ
Post-Communist Economies	coden	PCECF8
Substance Use & Misuse	coden	SUMIFL
Journal of Drug Issues	coden	JDGIA
Journal of Safety Research	coden	JSFRAV
Archives of Suicide Research	coden	ASREFQ
Acta Psychologica	coden	APSOAZ
Journal of Pediatric Psychology	coden	JPPSDW
Marine Mammal Science	coden	MMSCEC
International Journal of Psychology	coden	IJPSBB
Infant Mental Health Journal	coden	IMHJDZ
Injury	coden	INJUBF
Studies in Mycology	coden	SMYCA2
The AAPS Journal	coden	AJAOB6
AAPS PharmSciTech	coden	AAPHFZ
Caldasia	coden	CALDAK
Plant Disease	coden	PLDIDE
Journal of Molecular and Cellular Cardiology	coden	JMCDAY
The American Journal of Geriatric Psychiatry	coden	AJGPE8
Journal of Guidance, Control, and Dynamics	coden	JGCODS
Journal of Prosthetic Dentistry	coden	JPDEAT
Journal of Clinical Orthodontics	coden	JCLOB9
Journal of School Health	coden	JSHEA2
Acta Biológica Colombiana	coden	ABICEP
Brazilian Archives of Biology and Technology	coden	BABTFC
Strength of Materials	coden	SMTLB5
Labour Economics	coden	LECOE3
Journal of European Public Policy	coden	JEPPFG
Environmental Pollution	coden	ENPOEK
Maternal and Child Health Journal	coden	MCHJFB
Journal of Molecular Spectroscopy	coden	PLDIDE
Animal Science Journal	coden	ASCJFY
Obstetrical & Gynecological Survey	coden	OGSUA8
South European Society and Politics	coden	SESPFS
Exercise and Sport Sciences Reviews	coden	ESSRB8
Journal of Surgical Research	coden	JSGRA2
Issues in Science and Technology Librarianship	coden	ISTLF9
Canadian Journal of Information and Library Science	coden	CJISEF
Public Health	coden	PUHEAE
European Addiction Research	coden	EADREE
Quality of Life Research	coden	QLREEG
Journal of Health Politics, Policy and Law	coden	JHPLDN
Alcohol	coden	ALCOEX
Western North American Naturalist	coden	WNANF5
Science & Education	coden	SCEDE9
Journal of Substance Abuse Treatment	coden	JSATEG
World Journal of Surgery	coden	WJSUDI
Journal of Perinatology	coden	JOPEEI
Journal of Biological Education	coden	JBIEAO
Photosynthetica	coden	PHSYB5
Plant, Cell & Environment	coden	PLCEDV
APMIS	coden	APMSEL
International Journal of Health Services	coden	IJUSC3
Metabolic Brain Disease	coden	MBDIEE
General Hospital Psychiatry	coden	GHPSDB
Law & Policy	coden	LAPOE6
Journal of Urban Economics	coden	JUECDW
Journal of Huntington's Disease	coden	JHDOA3
American Journal of Health-System Pharmacy	coden	AHSPEK
International Journal of Research in Marketing	coden	IJRME6
International Journal of Clinical Pharmacy	coden	IJCPKE
Journal of Pharmacy and Pharmaceutical Sciences	coden	JPPSFY
Journal of Clinical Pharmacy and Therapeutics	coden	JCPTED
Seminars in Perinatology	coden	SEMPDU
Statistical Modelling	coden	SMTOCF
International Clinical Psychopharmacology	coden	ICLPE4
Trends in Cardiovascular Medicine	coden	TCMDEQ
Journal of Youth and Adolescence	coden	JYADA6
Regional Science and Urban Economics	coden	RSUEDM
International Journal of Politics, Culture, and Society	coden	ICSOE2
Juvenile and Family Court Journal	coden	JFCJD6
American Journal of Community Psychology	coden	AJCPCK
Journal of Surgical Oncology	coden	JSONAU
Japanese Journal of Clinical Oncology	coden	JJCOAC
Journal of Vocational Behavior	coden	JVBHA2
Physical Therapy	coden	PTHEA7
Physiotherapy	coden	PHSIAO
Journal of Public Economics	coden	JPBEBK
Algal Research	coden	ARLEBJ
International Journal of Gynecology & Obstetrics	coden	IJGOAL
Journal of Agricultural and Environmental Ethics	coden	JAEVEI
Behavior Therapy	coden	BHVTAK
Herpetologica	coden	HPTGAP
Memory & Cognition	coden	MYCGAO
Atomic Data and Nuclear Data Tables	coden	ADNDAT
Fluid Dynamics Research	coden	FDRSEH
Diamond and Related Materials	coden	DRMTE3
Journal of Pediatric Health Care	coden	JPHCED
AIDS Care	coden	AIDCEF
Conservation Genetics	coden	CGOEAC
Canadian Journal of Microbiology	coden	CJMIAZ
Surface Science	coden	SUSCAS
Advanced Science	coden	ASDCCF
Current Bioinformatics	coden	CB
Physics and Chemistry of Glasses: European Journal of Glass Science and Technology Part B	coden	PCGECL
Journal of Proteomics	coden	JPORFQ
Endeavour	coden	ENDEAS
Journal of Housing Economics	coden	JHECFB
Wiener klinische Wochenschrift	coden	WKWOAO
Clinical Obstetrics and Gynecology	coden	COGYAK
Population Research and Policy Review	coden	PRPRE8
Studies in History and Philosophy of Science	coden	SHPSB5
Progress in Energy and Combustion Science	coden	PECSDO
Biomedical Research	coden	BIRSE8
Surgery	coden	SURGAZ
Clinical Laboratory	coden	CLLAFP
Medizinische Monatsschrift für Pharmazeuten	coden	MMPHDB
Aggressive Behavior	coden	AGBEDU
Clinical Microbiology and Infection	coden	CMINFM
Health Education Research	coden	HERPE2
The Ramanujan Journal	coden	RAJOF9
Ethnicity & Health	coden	ETHEFR
Journal of Medical Biochemistry	coden	JMBBAN
Genome Biology and Evolution	coden	GBEEA5
Canadian Journal of Public Health	coden	CJPEA4
International Journal of Clinical Rheumatology	coden	IJCRHH
Imaging in Medicine	coden	IMMECA
Biuletyn Peryglacjalny	coden	BIPEAK
Permafrost and Periglacial Processes	coden	PEPPED
International Journal of Pharma and Bio Sciences	coden	IJPBJ2
European Spine Journal	coden	ESJOEP
