Bodmin	cornishName	Bosvenegh
Bolventor	cornishName	Bedhasbold
Land's End	cornishName	Penn an Wlas / Pedn an Wlas
Lamorna	cornishName	Nansmornow
Padstow	cornishName	Lannwedhenek
Truro	cornishName	Truru
Newquay	cornishName	Tewynblustri
Tintagel	cornishName	Tre war Venydh
Polruan	cornishName	Porthruwan
Falmouth, Cornwall	cornishName	Aberfal or Peny-cwm-cuic
Looe	cornishName	Logh
St Ives, Cornwall	cornishName	Porth Ia
Marazion	cornishName	Marhasyow
Bude	cornishName	Porthbud
St Michael's Mount	cornishName	Karrek Loos yn Koos
St Neot, Cornwall	cornishName	Loveni
Tresco, Isles of Scilly	cornishName	Enys Skaw
St Mary's, Isles of Scilly	cornishName	Ennor
Penzance	cornishName	Pennsans
Redruth	cornishName	Resrudh
Liskeard	cornishName	Lyskerrys
Camborne	cornishName	Kammbronn
Helston	cornishName	Hellys
Camelford	cornishName	Reskammel
Fowey	cornishName	Fowydh
St Austell	cornishName	S. Austel
Lostwithiel	cornishName	Lostwydhyel
Hugh Town	cornishName	Tre Huw
Torpoint	cornishName	Penntorr
Newlyn	cornishName	Lulyn
Perranporth	cornishName	Porthperan
Sennen	cornishName	Sen Senan
Charlestown, Cornwall	cornishName	Porthmeur
Saltash	cornishName	Essa
Cawsand	cornishName	Porthbugh
Boscastle	cornishName	Kastel Boterel
Antony, Cornwall	cornishName	Trevanta
Polzeath	cornishName	Polsegh
St Keverne	cornishName	Lannaghevran
St Germans, Cornwall	cornishName	Lannaled
St Erth	cornishName	Lannudhno
Lanhydrock	cornishName	Lannhedrek
Mevagissey	cornishName	Lannvorek
Veryan	cornishName	Elerghi
Trevone	cornishName	Treavon
Porthleven	cornishName	Porthleven
Polgooth	cornishName	Pollgoodh
Port Isaac	cornishName	Porthysek
Wadebridge	cornishName	Ponswad
Cape Cornwall	cornishName	Kilgoodh Ust
Coombe, Bude	cornishName	Komm
Callington, Cornwall	cornishName	Kelliwik
Carharrack	cornishName	Karardhek
St Mawes	cornishName	Lannvowesedh
Poldhu	cornishName	Poldhu
Porthcurno	cornishName	Porthkornow
Polperro	cornishName	Porthpyra
St Just in Penwith	cornishName	Lannust
Gweek	cornishName	Gwig
Towednack	cornishName	Tewydnek
Mousehole	cornishName	Porthenys
Tywardreath	cornishName	Ti War Dreth
Flushing, Cornwall	cornishName	Nanskersys
St Columb Major	cornishName	S. Colom Veur
Par, Cornwall	cornishName	Porth
Penryn, Cornwall	cornishName	Pennrynn
Lizard Point, Cornwall	cornishName	an Lysardh
Rock, Cornwall	cornishName	Pennmeyn
Trebetherick	cornishName	Trebedrek
St Agnes, Isles of Scilly	cornishName	Aganas
St Martin's, Isles of Scilly	cornishName	Brechiek
Chacewater	cornishName	Dowr an Chas
Treen	cornishName	Tredhin
Luxulyan	cornishName	Logsulyan
Davidstow	cornishName	Lanndhewi
Paul, Cornwall	cornishName	Breweni
Lanreath	cornishName	Lannreydhow
Indian Queens	cornishName	Krows Karworgi
Bossiney	cornishName	Boskyny
Grampound	cornishName	Ponsmeur
Millbrook, Cornwall	cornishName	Govermelin
Hayle	cornishName	Heyl
Gwithian	cornishName	Godhyan
London Apprentice	cornishName	Oberden Loundres
North Petherwin	cornishName	Paderwynn Gledh
Calstock	cornishName	Kalstok
Pendeen	cornishName	Boskaswal Wartha
Morvah	cornishName	Morvedh
Trewoon	cornishName	Trewoon
Mylor Bridge	cornishName	Ponsnowyth
Budock Water	cornishName	Dowr Budhek
Cadgwith	cornishName	Porthkajwydh
St Day	cornishName	Sen Day
Zennor	cornishName	Sen Senar
St Levan	cornishName	Selevan
St Buryan	cornishName	Pluwveryan
Sancreed	cornishName	Eglossankres
Advent, Cornwall	cornishName	Sen Adhwynn
Altarnun	cornishName	Alternonn
Warbstow	cornishName	Lannwarburgh
Quethiock	cornishName	Koosek
Egloshayle	cornishName	Eglosheyl
St Mabyn	cornishName	S. Mabon
St Tudy	cornishName	Eglostudi
St Issey	cornishName	Egloskrug
St Eval	cornishName	S. Uvel
St Minver	cornishName	Sen Menvra
Kingsand	cornishName	Porthruw
Blisland	cornishName	Blyslann
Boconnoc	cornishName	Boskennek
Botusfleming	cornishName	Bosflumyes
Boyton, Cornwall	cornishName	Trevoya
St Blazey	cornishName	Lanndreth
Braddock, Cornwall	cornishName	Brodhek
Jacobstow	cornishName	Lannjago
St Ive	cornishName	Sen Iv
Constantine, Cornwall	cornishName	Lanngostentin
Delabole	cornishName	Delyow Boll
Creegbrawse	cornishName	Creegbraws
Prussia Cove	cornishName	Porth Legh
Porthcothan	cornishName	Porthkehodhon
Breage, Cornwall	cornishName	Eglosbrek
Lewannick	cornishName	Lannwenek
Mullion, Cornwall	cornishName	Eglosvelyan
Gulval	cornishName	Lannystli
Portreath	cornishName	Porthtreth
Gugh	cornishName	Keow
Polkerris	cornishName	Pollkerys
Illogan	cornishName	Egloshalow
Mawnan Smith	cornishName	Mownan an Gov
Stratton, Cornwall	cornishName	Strasnedh
St Agnes, Cornwall	cornishName	Breanek
Long Rock	cornishName	Carrek Hyr
Seaton, Cornwall	cornishName	Sethyn
St Dennis, Cornwall	cornishName	Tredhinas
Lanlivery	cornishName	Lannlyvri
St Ewe	cornishName	Lannewa
St Mewan	cornishName	Sen Mewen
St Stephen-in-Brannel	cornishName	Eglosstefan yn Branel
Crantock	cornishName	Lanngorrow
Colan, Cornwall	cornishName	Kolan
Kerris	cornishName	Kerys
Ladock	cornishName	Egloslajek
Feock, Cornwall	cornishName	Lannfyek
Perranzabuloe	cornishName	Pyran yn Treth
Gerrans	cornishName	Gerens
Cubert	cornishName	Egloskubert
Kea, Cornwall	cornishName	Sen Ke
Gwennap	cornishName	Lannwenep
St Erme	cornishName	Egloserm
Crowan	cornishName	Egloskrewen
Germoe	cornishName	Germogh
Cury	cornishName	Egloskuri
Landewednack	cornishName	Lanndewynnek
Lanner, Cornwall	cornishName	Lannergh
St Gluvias	cornishName	Bosheydhlann
St Martin-in-Meneage	cornishName	Dydemin
Wendron	cornishName	Gwendron
Lesnewth	cornishName	Lysnowyth
Port Quin	cornishName	Porth Gwynn
St Kew	cornishName	Lanndohow
Gorran Haven	cornishName	Porthust
Twelveheads	cornishName	Dewdhek Stamp
Gunnislake	cornishName	Dowrgonna
Lerryn	cornishName	Lynngonna
Hessenford	cornishName	Rys an Gwraghes
Laneast	cornishName	Lanneyst
St Merryn	cornishName	S Meryn
Port Gaverne	cornishName	Porthkaveran
Gwennap Head	cornishName	Tol pedn
Tideford	cornishName	Resteudhi
Kilkhampton	cornishName	Kylgh
St Winnow	cornishName	Sen Gwynnek
Trethevy	cornishName	Tredhewi
Menheniot	cornishName	Mahynyet
Egloskerry	cornishName	Egloskeri
Cardinham	cornishName	Kardhinan
Lanivet	cornishName	Lanneves
Portwrinkle	cornishName	Porthwykkel
Helland	cornishName	Hellann
Rame, Maker-with-Rame	cornishName	Hordh
Townshend, Cornwall	cornishName	Penn an Dre Egloskrowenn
St Endellion	cornishName	Sen Endelyn
Pentewan	cornishName	Bentewyn
Michaelstow	cornishName	Logmihal
Duloe, Cornwall	cornishName	Dewlogh
Rame, Wendron	cornishName	Hordh
Bray Shop	cornishName	Shoppa Bre
Bealsmill	cornishName	Melin Bila
Belowda	cornishName	Boslowsa
Bocaddon	cornishName	Boskadwen
Bodieve	cornishName	Bosyuv
Bodelva	cornishName	Boselwydh
Bodinnick	cornishName	Bosdinek
Bolingey	cornishName	Melinji
Boskednan	cornishName	Boskednan
Bridgerule	cornishName	Ponsrowald
Little Petherick	cornishName	Nansfenten
Withiel	cornishName	Egloswydhyel
Downderry	cornishName	Donderri
Launcells	cornishName	Lannseles
Hugus	cornishName	Ughgos
Foxhole, Cornwall	cornishName	Tollowarn
Godolphin Cross	cornishName	Krows Hirlan
Pillaton	cornishName	Trebeulyow
Pendoggett	cornishName	Penndewgos
Landrake	cornishName	Lannergh
Dobwalls	cornishName	Fos an Mogh
Fraddam	cornishName	Fradam
Cargreen	cornishName	Karrekreun
Treen	cornishName	Tredhin
Sticker, Cornwall	cornishName	Stekyer
South Hill, Cornwall	cornishName	Bre Dheghow
North Hill, Cornwall	cornishName	Bre Gledh
Temple, Cornwall	cornishName	Tempel
Four Lanes	cornishName	Peder Bownder
Albaston	cornishName	Trevalba
Ball, Cornwall	cornishName	Pelen
Bake, Cornwall	cornishName	Pobas
Golant	cornishName	Golnans
St Breock	cornishName	Nanssans
Lawhitton	cornishName	Nansgwydhenn
Crugmeer	cornishName	Krugmeur
Lezant	cornishName	Lannsant
Trevalga	cornishName	Trevelgi
Otterham	cornishName	Prasdowrgi
Poundstock	cornishName	Tregorlann
St Blazey Gate	cornishName	Yet Lanndreth
South Petherwin	cornishName	Paderwynn Dheghow
St Thomas the Apostle Rural	cornishName	Tregadylet
Tremaine, Cornwall	cornishName	Tremen
Treneglos	cornishName	Treneglos
Tresmeer	cornishName	Trewasmeur
Trewen	cornishName	Trewynn
Doublebois	cornishName	Dewgoes
Lansallos	cornishName	Lansalwys
Landulph	cornishName	Lanndhylyk
Sheviock	cornishName	Seviek
St John, Cornwall	cornishName	Sen Yowann
Bathpool, Cornwall	cornishName	Pollbath
Bilberry, Cornwall	cornishName	Krugbylla
Bissoe	cornishName	Besow
Penhale	cornishName	Pennhal
Summercourt	cornishName	Marghashir
Minions, Cornwall	cornishName	Menyon
Goonhavern	cornishName	Goonhavar
Mithian	cornishName	Mydhyan
Bugle, Cornwall	cornishName	Karnrosveur
Trelights	cornishName	Treleghrys
Cusgarne	cornishName	Kosgaran
Trewarmett	cornishName	Trewerman
Troon, Cornwall	cornishName	Trewoon
Launceston, Cornwall	cornishName	Lannstevan
Boleigh	cornishName	Boslegh
Bridge, Cornwall	cornishName	Ponsjulyan
Brea, Cornwall	cornishName	Bre
Porkellis	cornishName	Porthkellys
Carnon Downs	cornishName	Goon Karnen
Ponsanooth	cornishName	Pons an Woodh
Porthallow	cornishName	Porthalow
Burlorne Tregoose	cornishName	Boslowen Tregoos
Burlorne Pillow	cornishName	Boslowenpolbrogh
Burncoose	cornishName	Broncoosp
Chapel, Cornwall	cornishName	Chapel Kernwhily
Coswinsawsin	cornishName	Koswynnsowson
Croanford	cornishName	Res Crowyn
Vellanoweth	cornishName	Melyn Nowyth
Great Bosullow	cornishName	Bos Chiwolow
Halgabron	cornishName	Halgigbran
Gwills	cornishName	Gwyles
Hallworthy	cornishName	Halworgi
Hellesveor	cornishName	Hellys Veur
Lezerea	cornishName	Lysgre
Lower Menadue	cornishName	Menedh Du
Lower Croan	cornishName	Crowyn goles
Menadarva	cornishName	Merther Derwa
Mongleath	cornishName	Mongleudh
Nancenoy	cornishName	Nans Noy
North Darley	cornishName	Dowr Legh
Pentire, Cornwall	cornishName	Pentir
Plain-an-Gwarry	cornishName	Plen an Gwari
Polmassick	cornishName	Ponsmasek
Polpenwith	cornishName	Poll Pennrudh
Polwheveral	cornishName	Poll Hwevrer
Releath	cornishName	Reslegh
Rejerrah	cornishName	Resworow
Ponjeravah	cornishName	Pons a Revedh
Rose, Cornwall	cornishName	Ros
Trewidland	cornishName	Trewythelan
Trewithian	cornishName	Trewydhyan
