Secretariat	dam	Somethingroyal
Northern Dancer	dam	Natalma
Nijinsky	dam	Flaming Page
Shergar	dam	Sharmeen
Greyhound	dam	Elizabeth
Abercrombie	dam	Bergdorf
Cam Fella	dam	Nan Cam
Funny Cide	dam	Belle's Good Cide
Man o' War	dam	Mahubah
Seattle Slew	dam	My Charmer
Sir Barton	dam	Lady Sterling
Tom Rolfe	dam	Pocahontas
Exceller	dam	Too Bald
Smarty Jones	dam	I'll Get Along
Ruffian	dam	Shenanigans
Native Dancer	dam	Geisha
Count Fleet	dam	Quickly
Makybe Diva	dam	Tugela
Eclipse	dam	Spilletta
Octagonal	dam	Eight Carat
Narita Brian	dam	Pacificus
Ouija Board	dam	Selection Board
Giacomo	dam	Set Them Free
Dubai Millennium	dam	Colorado Dancer
Hawk Wing	dam	La Lorgnette
Galileo	dam	Urban Sea
Lammtarra	dam	Snow Bride
Alysheba	dam	Bel Sheba
Dance Smartly	dam	Classy 'n Smart
Go For Wand	dam	Obeah
Neil Gow	dam	Chelandry
Ormonde	dam	Lily Agnes
Red Rum	dam	Mared
Sunday Silence	dam	Wishing Well
Brew	dam	Horlicks
Snow Bride	dam	Awaasif
Kingston Rule	dam	Rose of Kingston
Precipitation	dam	Double Life
Stockwell	dam	Pocahontas
Glencoe I	dam	Trampoline
Swale	dam	Tuerta
Kayak II	dam	Mosquita
A.P. Warrior	dam	Warrior Queen
Reset	dam	Assertive Lass
Cape of Good Hope	dam	Cape Merino
Hanover	dam	Bourbon Belle
Charismatic	dam	Bali Babe
Tim Tam	dam	Two Lea
Numbersixvalverde	dam	Queens Tricks
Buckpasser	dam	Busanda
Jazil	dam	Better Than Honour
A.P. Indy	dam	Weekend Surprise
Sir Percy	dam	Percy's Lass
Rock Sand	dam	Roquebrune
L'Enjoleur	dam	Fanfreluche
Thunder Gulch	dam	Line Of Thunder
Slew o' Gold	dam	Alluvial
Storm Cat	dam	Terlingua
Singspiel	dam	Glorious Song
First Landing	dam	Hildene
Sky Classic	dam	No Class
Galopin	dam	Flying Duchess
Kayf Tara	dam	Colorspin
Storm Bird	dam	South Ocean
Giant's Causeway	dam	Mariah's Storm
Fantastic Light	dam	Jood
Dancethruthedawn	dam	Dance Smartly
Storm Flag Flying	dam	My Flag
My Flag	dam	Personal Ensign
Bimelech	dam	La Troienne
Dance in the Dark	dam	Dancing Key
Shuvee	dam	Levee
Nashwan	dam	Height of Fashion
Holy Roller	dam	Secret Blessing
Graustark	dam	Flower Bowl
Never Bend	dam	Lalun
Marsyas	dam	Astronomie
Sir Gallahad	dam	Plucky Liege
Awesome Again	dam	Primal Force
Ethereal	dam	Romanee Conti
Ksar	dam	Kizil Kourgan
War Relic	dam	Friar's Carse
Pleasantly Perfect	dam	Regal State
King Tom	dam	Pocahontas
Bowl of Flowers	dam	Flower Bowl
Somethingroyal	dam	Imperatrice
Horatio Nelson	dam	Imagine
Smart Strike	dam	Classy 'n Smart
Rags to Riches	dam	Better Than Honour
Real Shadai	dam	Desert Vixen
Depth Charge	dam	Quickly
Little Polveir	dam	Blue Speedwell
Rahy	dam	Glorious Song
Halo	dam	Cosmah
Glorious Song	dam	Ballade
Agnes Tachyon	dam	Agnes Flora
Raise a Native	dam	Raise You
Agnes Flight	dam	Agnes Flora
Urban Sea	dam	Allegretta
My Typhoon	dam	Urban Sea
Sakhee	dam	Thawakib
East of the Moon	dam	Miesque
Summer Squall	dam	Weekend Surprise
Kingmambo	dam	Miesque
Empire Maker	dam	Toussaud
Friar Rock	dam	Fairy Gold
Bay Middleton	dam	Cobweb
Tiago	dam	Set Them Free
Golden Fleece	dam	Exotic Treat
Success Express	dam	Au Primtemps
Is It True	dam	Roman Rockette
Capote	dam	Too Bald
Boston Harbor	dam	Harbor Springs
Rhythm	dam	Dance Number
Silver Patriarch	dam	Early Rising
Celtic Swing	dam	Celtic Ring
Finsceal Beo	dam	Musical Treat
Coastal	dam	Alluvial
Pulpit	dam	Preach
Awesome Gem	dam	Piano
Playful Act	dam	Magnificient Style
Affectionately	dam	Searching
Native Diver	dam	Fleet Diver
Black Toney	dam	Belgravia
Searching	dam	Big Hurry
Star Over The Bay	dam	Lituva Bay
Ta Wee	dam	Aspidistra
Black Helen	dam	La Troienne
Roseben	dam	Rose Leaf
Broomstick	dam	Elf
Sir Archy	dam	Castianira GB
Myrtlewood	dam	Frizeur
Tosmah	dam	Cosmah
Flawlessly	dam	La Confidence
Dayjur	dam	Gold Beauty
Ardross	dam	Le Melody
Colorado	dam	Canyon
Landaluce	dam	Strip Poker
Emperor of Norfolk	dam	Marian
Diamond Jubilee	dam	Perdita
Persimmon	dam	Perdita
Yo Tambien	dam	Marian
Pinza	dam	Pasqua
Triptych	dam	Trillion
Inferno	dam	Bon Ino
Silmaril	dam	Kattebuck
Hurley Burley	dam	Helter Skelter
Iroquois	dam	Maggie B. B.
Bold 'n Determined	dam	Pidi
Bull Dog	dam	Plucky Liege
Commentator	dam	Outsource
Jalil	dam	Tranquility Lake
Northernette	dam	South Ocean
Shenanigans	dam	Bold Irish
Peppers Pride	dam	Lady Pepper
Tale of Ekati	dam	Silence Beauty
Casino Drive	dam	Better Than Honour
Symboli Kris S	dam	Tee Kay
Taiki Shuttle	dam	Welsh Muffin
Open Mind	dam	Stage Luck
Da' Tara	dam	Torchera
New Approach	dam	Park Express
Cacique	dam	Hasili
Hystericalady	dam	Sacramentada
Royal Palace	dam	Crystal Palace
Regal Classic	dam	No Class
La Voyageuse	dam	Fanfreluche
Silver Spoon	dam	Silver Fog
Tin Cup Chalice	dam	Twice Forbidden
Zenyatta	dam	Vertigineux
Purchase	dam	Cherryola
Leonatus	dam	Semper Felix
Ponder	dam	Miss Rushin
Natalma	dam	Almahmoud
Mark-Ye-Well	dam	Mar-Kell
Bold Reason	dam	Lalun
Harold	dam	Maggie B. B.
Squirtle Squirt	dam	Lost The Code
Cum Laude Laurie	dam	Primonetta
Mar-Kell	dam	Nellie Flag
Trigo	dam	Athasi
Faultless	dam	Unerring
Smuggler	dam	Inside Information
Menow	dam	Alcibiades
Lomond	dam	My Charmer
Lush Lashes	dam	Dance For Fun
Four-and-Twenty	dam	Sixpence
J. O. Tobin	dam	Hill Shade
Bel Sheba	dam	Belthazar
Volksraad	dam	Celtic Assembly
Rogan Josh	dam	Eastern Mysyique
Next Move	dam	Now What
Mine That Bird	dam	Mining My Own
In Reality	dam	My Dear Girl
Classy 'n Smart	dam	No Class
Fonso	dam	Weatherwitch
Personality	dam	Affectionately
Sea the Stars	dam	Urban Sea
Black Bear Island	dam	Kasora
Niche	dam	Cubby Hole
Tapit	dam	Tap Your Heels
Remember Rose	dam	Couture Rose
Cape Cross	dam	Park Appeal
Dunkirk	dam	Secret Status
His Eminence	dam	Patroness
Phalanx	dam	Jacola
Eye of the Leopard	dam	Eye of the Sphynx
Vagrancy	dam	Valkyr
Meddler	dam	Busybody
Elusive Wave	dam	Multicolour Wave
Devil's Bag	dam	Ballade
Big Drama	dam	Riveting Drama
El Rio Rey	dam	Marian
Bois Roussel	dam	Plucky Liege
Boldnesian	dam	Alanesian
Be My Guest	dam	What a Treat
Straw Bear	dam	Highland Ceilidh
Harchibald	dam	Dame D’Harvard
Johar	dam	Windsharp
Gone West	dam	Secrettame
Bold Lad	dam	Misty Morn
Successor	dam	Misty Morn
Zensational	dam	Joke
Misremembered	dam	Beyond Perfection
Imperatrice	dam	Cinquepace
Key to the Moon	dam	Kamar
Swift Temper	dam	Glasgow's Gold
Charlottown	dam	Meld
Johnny D.	dam	Dusk
Tourbillon	dam	Durban
Champs Elysees	dam	Hasili
Swynford	dam	Canterbury Pilgrim
Man of Iron	dam	Better Than Honour
Banks Hill	dam	Hasili
Intercontinental	dam	Hasili
Go Native	dam	Native Idea
Dunguib	dam	Edermine Berry
Take Control	dam	Azeri
Seattle Dancer	dam	My Charmer
Pounced	dam	Golden Cat
Noverre	dam	Danseur Fabuleux
His Majesty	dam	Flower Bowl
Northern Queen	dam	Victoriana
Windfields	dam	Nandi
Secrettame	dam	Tamerett
Comic Court	dam	Witty Maid
Saoirse	dam	Apelia
Vallée Enchantée	dam	Verveine
Backtalk	dam	Apasionata Sonata
Percy Hope	dam	Ridinghood
Binocular	dam	Bleu Ciel Et Blanc
Winslow Homer	dam	Summer Raven
Daryakana	dam	Daryaba
Unrivaled Belle	dam	Queenie Belle
Dar Re Mi	dam	Darara
Aces Four	dam	Special Trix
Sharp Cat	dam	In Neon
Fluvanna	dam	High Pass
The French Furze	dam	Exciting
Evening Jewel	dam	Jewel of the Night
Super Saver	dam	Supercharger
Mona de Momma	dam	Society Gal
Arcalis	dam	Aristocratique
Al Eile	dam	Kilcsem Eile
Solwhit	dam	Toowhit Towhee
Dotties Pick	dam	Pick Up
Weapon's Amnesty	dam	Victoria Theatre
Deceit Dancer	dam	Deceit
Grey Classic	dam	No Class
American Lion	dam	Storm Tide
Workforce	dam	Soviet Moon
Drosselmeyer	dam	Golden Ballet
Allied Powers	dam	Always Friendly
Zino	dam	Cyriana
Captain's Gig	dam	Make Sail
Dance Spell	dam	Obeah
Chelokee	dam	Dixie Ghost
King's Best	dam	Allegretta
Tartan Bearer	dam	Highland Gift
Lisa's Booby Trap	dam	Ennuhway
Frankel	dam	Kind
Paco Boy	dam	Tappen Zee
Weekend Surprise	dam	Lassie Dear
Americain	dam	America
Chester House	dam	Toussaud
Topsider	dam	Drumtop
Gen. Duke	dam	Wistful
Sir Gaylord	dam	Somethingroyal
Bardstown	dam	Twilight Tear
Black Caviar	dam	Helsinge
Nellie Flag	dam	Nellie Morse
Nellie L.	dam	Nellie Flag
Shorelint	dam	South Shore
Royal Glint	dam	Regal Gleam
What A Summer	dam	Summer Tan
Princessnesian	dam	Alanesian
Unfuwain	dam	Height of Fashion
Bosra Sham	dam	Korveya
Stamina	dam	Endurance by Right
Pharamond II	dam	Selene
Rewilding	dam	Darara
Nathaniel	dam	Magnificient Style
Malibu Pier	dam	Blue Moon
Haafhd	dam	Al Bahathri
Nayef	dam	Height of Fashion
Dubawi	dam	Zomaradah
Embassy	dam	Pass the Peace
Alhaarth	dam	Irish Valley
Morston	dam	Windmill Girl
Tobougg	dam	Lacovia
Aljabr	dam	Sierra Madre
Drum Taps	dam	Lavendula Rose
Royal Applause	dam	Flying Melody
Continent	dam	Krisia
Reverence	dam	Imperial Bailiwick
Stravinsky	dam	Fire The Groom
Anabaa	dam	Balbonella
Dunaden	dam	La Marlia
Humorist	dam	Jest
Blakeney	dam	Windmill Girl
Arctic Prince	dam	Arctic Sun
Relaxing	dam	Marking Time
A Gleam	dam	Twilight Tear
Pearl Diver	dam	Pearl Cap
Jeddah	dam	Pilgrimage
War Chant	dam	Hollywood Wildcat
Blair Athol	dam	Blink Bonny
Eleanor	dam	Young Giantess
Thormanby	dam	Alice Hawthorn
Beadsman	dam	Mendicant
Surplice	dam	Crucifix
Whalebone	dam	Penelope
Natchez	dam	Creole Maid
Phosphorus	dam	Rubens mare
Go Marching	dam	Leallah
Cadland	dam	Sorcery
Private Account	dam	Numbered Account
Dance Number	dam	Numbered Account
Whisker	dam	Penelope
Pope	dam	Prunella
Beauty Flash	dam	Wychwood Rose
Big Game	dam	Myrobella
Atlantic	dam	Hurricane
Nicolaus Silver	dam	Rays of Montrose
Buena Vista	dam	Biwa Heidi
Sixties Icon	dam	Love Divine
Rule of Law	dam	Crystal Crossing
Brian Boru	dam	Eva Luna
Alcohol	dam	Tendue
Golden Lilac	dam	Grey Lilas
On-and-On	dam	Two Lea
Dullahan	dam	Mining My Own
Boucher	dam	Glamour
Fortria	dam	Senria
Bona Vista	dam	Vista
Shadayid	dam	Desirable
Salsabil	dam	Flame of Tara
Eswarah	dam	Midway Lady
Imagine	dam	Doff the Derby
Moonshell	dam	Moon Cactus
Jet Ski Lady	dam	Bemissed
Great Heavens	dam	Magnificient Style
Black Tarquin	dam	Vagrancy
Ossory	dam	Lily Agnes
Encke	dam	Shawanda
Busybody	dam	Spinaway
Dansili	dam	Hasili
Bartlett's Childers	dam	Betty Leedes
Corinne	dam	Briseis
Luskin Star	dam	Promising
Arab	dam	Zeal
Whizgig	dam	Penelope
Tontine	dam	Pope Joan
Pastille	dam	Parasol
Oxygen	dam	Whizgig
Turquoise	dam	Pope Joan
Camarine	dam	Rubens mare
May-day	dam	Rubens mare
Firebrand	dam	Rubens mare
Gentildonna	dam	Donna Blini
Pelisse	dam	Prunella
Bronze	dam	Alexander mare
Selim	dam	Alexander mare
Rubens	dam	Alexander mare
Ten Most Wanted	dam	Wanted Again
Apalachee	dam	Moccasin
Caracalla	dam	Astronomie
Arbar	dam	Astronomie
Pope Joan	dam	Prunella
Penelope	dam	Prunella
Sorcerer	dam	Young Giantess
Memnon	dam	Manuella
Twist Magic	dam	Twist Scarlett
Paulina	dam	Pewett
Persian War	dam	Warning
Parasol	dam	Prunella
Pindarrie	dam	Parasol
Forpadydeplasterer	dam	Run Artiste
Seabreeze	dam	St Marguerite
Hannah	dam	Mentmore Lass
Desmond	dam	L'Abbesse de Jouarre
Twilight Ridge	dam	Waving Sky
Flanders	dam	Starlet Storm
Newminster	dam	Beeswing
Carnegie	dam	Detroit
Estimate	dam	Ebaziya
Marling	dam	Marwell
Islington	dam	Hellenic
Enzeli	dam	Ebaziya
Walton	dam	Arethusa
Edabiya	dam	Ebaziya
Halfway to Heaven	dam	Cassandra Go
Combat	dam	Commotion
Take Charge Indy	dam	Take Charge Lady
Height of Fashion	dam	Highclere
Will Take Charge	dam	Take Charge Lady
Gildoran	dam	Durtal
Cash Run	dam	Shared Interest
Milligram	dam	One In A Million
Forest Flower	dam	Leap Lively
Awaasif	dam	Royal Statute
Hightail	dam	Stormy Renee
Folklore	dam	Contrive
Tolmi	dam	Stilvi
Gorytus	dam	Glad Rags
Tyrnavos	dam	Stilvi
Tromos	dam	Stilvi
Honor Code	dam	Serena's Cat
Australia	dam	Ouija Board
Kingman	dam	Zenda
Lucky Pulpit	dam	Lucky Soph
Miss France	dam	Miss Tahiti
Solinus	dam	Cawston's Pride
Noble Mission	dam	Kind
Empire Glory	dam	Spearfish
Invincible Spirit	dam	Rafha
Cherry Hinton	dam	Popkins
Scatter the Gold	dam	Dance Smartly
Integral	dam	Echelon
Adelaide	dam	Elletelle
Gentle Thoughts	dam	Solid Thought
Take Charge Brandi	dam	Charming
Epiphaneia	dam	Cesario
Surfside	dam	Flanders
American Pharoah	dam	Littleprincessemma
Found	dam	Red Evie
John F Kennedy	dam	Rumplestiltskin
Tapestry	dam	Rumplestiltskin
Hours After	dam	Brown Berry
Mirska	dam	Musa
Exclusive	dam	Exclusive Order
Sophisticat	dam	Serena's Song
So Factual	dam	Sookera
Quiff	dam	Wince
Minding	dam	Lillie Langtry
Reine Enchanteur	dam	Libra
Shamshir	dam	Free Guest
Aqaarid	dam	Ashayer
Gossamer	dam	Brocade
Admire Vega	dam	Vega
Ibn Khaldun	dam	Gossamer
Cellini	dam	Gamely
Tachypous	dam	Stilvi
Star of Seville	dam	Stage Presence
US Army Ranger	dam	Moonstone
Prince of Dance	dam	Sun Princess
Tante Rose	dam	My Branch
Rachel's Valentina	dam	Rachel Alexandra
Goodricke	dam	Star
