C.D. Motagua	fansgroup	La Revo 1928
C.D. Motagua	fansgroup	Macro Azurra
Real C.D. España	fansgroup	Mega Locos
UNB Varsity Reds	fansgroup	
Gaziantepspor	fansgroup	Gençlik27
Göztepe S.K.	fansgroup	Yalı
York Region Shooters	fansgroup	Shooters Soccer Fan Club
Tokatspor	fansgroup	Onbeşliler
NK Belišće	fansgroup	Baraberi
Syrianska FC	fansgroup	Gefe Fans
Philadelphia Independence	fansgroup	Sons of Ben
Saint Louis Athletica	fansgroup	Laclede's Army
Saint Louis Athletica	fansgroup	Verde Azul
Saint Louis Athletica	fansgroup	River City Saints
Strømmen IF	fansgroup	Strømmen Greyhounds
Elon Phoenix men's soccer	fansgroup	Phoenix Phanatics
Kansas City Comets	fansgroup	Comets Nation
FK Brodarac	fansgroup	Brodarac Ultras 2008
Spårvägens FF	fansgroup	Konduktörerna
Futsal Klub Tirana	fansgroup	Tirona Fanatics
Capital City F.C.	fansgroup	\
Dallas Sidekicks	fansgroup	Rowdies
Arizona United SC	fansgroup	La Furia Roja 1881
KF Tirana B	fansgroup	Tirona Fanatics
Lane United FC	fansgroup	Red Aces
Temecula FC	fansgroup	Topknots
Arizona Impact	fansgroup	La Furia Roja 1881
Calgary Foothills F.C.	fansgroup	Foot Soldiers Supporters Group
Albion SC Pros	fansgroup	The Deep End Supporters Group
Kokomo Mantis FC	fansgroup	KokoManiacs
FC Feniks Drenas	fansgroup	Tigrat e Zi
