John Player Trophy	finalChampion	Ross Whitehead
Volvo Masters	finalChampion	Søren Kjeldsen
NEC World Series of Golf	finalChampion	David Duval
The International	finalChampion	Dean Wilson
Johnnie Walker Championship at Gleneagles	finalChampion	Tommy Fleetwood
Wales Open	finalChampion	Joost Luiten
Johnnie Walker Classic	finalChampion	Danny Lee
Scandinavian Enterprise Open	finalChampion	Craig Stadler
Trophée Lancôme	finalChampion	Retief Goosen
Deutsche Bank Players Championship of Europe	finalChampion	Andrés Romero
German Masters	finalChampion	James Kingston
Mallorca Classic	finalChampion	Grégory Bourdy
Portuguese Open	finalChampion	Thomas Bjørn
LPGA Tour Championship	finalChampion	Maria Hjorth
Singapore Masters	finalChampion	Liang Wen-Chong
BMW Asian Open	finalChampion	Darren Clarke
Buick Open	finalChampion	Tiger Woods
Vodacom Championship	finalChampion	Hennie Otto
Benson & Hedges International Open	finalChampion	Paul Casey
English Open	finalChampion	Darren Clarke
Belgian Open	finalChampion	Lee Westwood
Regions Charity Classic	finalChampion	Dan Forsman
Michelob Championship	finalChampion	Charles Howell III
Pennsylvania Classic	finalChampion	Ben Curtis
Atlanta Classic	finalChampion	Ryuji Imada
Booz Allen Classic	finalChampion	Ben Curtis
Greater Milwaukee Open	finalChampion	Bo Van Pelt
Walt Disney World Golf Classic	finalChampion	Charlie Beljan
Jacob's Creek Open Championship	finalChampion	Scott Sterling
Oregon Classic	finalChampion	Matt Bettencourt
Martini International	finalChampion	Nick Faldo
Cannes Open	finalChampion	Jorge Berendt
Car Care Plan International	finalChampion	Mark Mouland
Czech Open	finalChampion	Oliver Fisher
Catalan Open	finalChampion	Paul Lawrie
Uniroyal International Championship	finalChampion	Seve Ballesteros
AGF Open	finalChampion	Brett Ogle
Welsh Golf Classic	finalChampion	Gordon Brand, Jnr
PLM Open	finalChampion	Ronan Rafferty
Glasgow Open	finalChampion	Howard Clark
Greater Manchester Open	finalChampion	Bernard Gallacher
Open Mediterrania	finalChampion	Robert Karlsson
Open de Baleares	finalChampion	Greg Turner
Bob Hope British Classic	finalChampion	Paul Broadhurst
Volvo Open di Firenze	finalChampion	Anders Forsbrand
Tournament Players Championship	finalChampion	Jaime Gonzalez
Brunei Open	finalChampion	Siddikur Rahman
Western Open	finalChampion	Trevor Immelman
North and South Open	finalChampion	Tommy Bolt
LPGA State Farm Classic	finalChampion	Yani Tseng
Ginn Open	finalChampion	Lorena Ochoa
Wegmans LPGA	finalChampion	Jiyai Shin
LPGA Corning Classic	finalChampion	Yani Tseng
Sybase Classic	finalChampion	Ji Young Oh
Tres Marias Championship	finalChampion	Ai Miyazato
SBS Open at Turtle Bay	finalChampion	Angela Stanford
B.C. Open	finalChampion	John Rollins
Turning Stone Resort Championship	finalChampion	Bill Lunde
Doral Open	finalChampion	Tiger Woods
British PGA Matchplay Championship	finalChampion	Des Smyth
Open de Andalucía	finalChampion	Julien Quesne
Greater Hickory Kia Classic at Rock Barn	finalChampion	Jay Haas
GTE Northwest Classic	finalChampion	Walter Morgan
The Greenbrier American Express Championship	finalChampion	Bruce Crampton
Pine Valley Beijing Open	finalChampion	Hiroyuki Fujita
Telenet Trophy	finalChampion	Daniel Gaunt
Indian Masters	finalChampion	Shiv Chowrasia
Ginn sur Mer Classic	finalChampion	Ryan Palmer
The Championship at Laguna National	finalChampion	Felipe Aguilar
Colombia Masters	finalChampion	Alan Wagner
Costa Rica Open	finalChampion	Miguel Rodríguez
Allianz Golf Open du Grand Toulouse	finalChampion	Julien Brun
ECCO Tour Championship	finalChampion	Alessandro Tadini
Challenge of Ireland	finalChampion	Robert Coles
Doc Salbe PGA European Challenge	finalChampion	Peter Whiteford
Dutch Futures	finalChampion	Nicolas Colsaerts
Hana Bank Vietnam Masters	finalChampion	Thongchai Jaidee
Piccadilly Medal	finalChampion	Sam Torrance
Abama Open de Canarias	finalChampion	John Bickerton
ANZ Championship	finalChampion	Brian Davis
Rubber City Open Invitational	finalChampion	Tom Nieporte
American Golf Classic	finalChampion	David Graham
Lucky International Open	finalChampion	Steve Spray
Esso Golden Tournament	finalChampion	Kel Nagle and Peter Thomson
Alcan Open	finalChampion	Bruce Devlin
Japan PGA Match-Play Championship	finalChampion	Todd Hamilton
Daks Tournament	finalChampion	Neil Coles and  Brian Huggett
Agfa-Gevaert Tournament	finalChampion	Peter Oosterhuis
Moonah Classic	finalChampion	Jim Herman
Pringle of Scotland Tournament	finalChampion	Tony Jacklin
W.D. & H.O. Wills Tournament	finalChampion	Neil Coles
Airbus LPGA Classic	finalChampion	Jessica Korda
Castelló Masters	finalChampion	Sergio García
Madrid Masters	finalChampion	Lee Slattery
Kerrygold International Classic	finalChampion	Liam Higgins
Platinum Classic	finalChampion	Neil Schietekat
MTC Namibia PGA Championship	finalChampion	J. G. Claassen
South African Masters	finalChampion	Shaun Norris
HSBC Brazil Cup	finalChampion	Pornanong Phatlum
Moroccan Golf Classic	finalChampion	Chris Baker
Piemonte Open	finalChampion	Edoardo Molinari
Allianz Open de Lyon	finalChampion	Chris Doak
DHL Wroclaw Open	finalChampion	Eric Ramsay
Asian Tour International	finalChampion	Gaganjeet Bhullar
The Princess	finalChampion	Ricardo Santos
pharmacy LPGA Challenge	finalChampion	Beatriz Recari
Esmeralda Open	finalChampion	Herman Keiser
Soboba Golf Classic	finalChampion	Andres Gonzales
Fred Meyer Challenge	finalChampion	Brian Henninger and Scott McCarron
Portland Open Invitational	finalChampion	Bert Yancey
Carroll's International	finalChampion	Bernard Gallacher
Black Mountain Masters	finalChampion	Tetsuji Hiratsuka
Eagle Classic	finalChampion	Marissa Steen
SAS Masters	finalChampion	Diana Luna
Avantha Masters	finalChampion	Thomas Aiken
John Player Classic	finalChampion	Charles Coody
Timex Open	finalChampion	Michael Clayton
Allianz EurOpen Strasbourg	finalChampion	Romain Wattel
Copa Antioquia	finalChampion	Joaquín Estévez
Madrid Ladies Masters	finalChampion	Azahara Muñoz
Iberdrola Open	finalChampion	Darren Clarke
Vivendi Cup	finalChampion	John Parry
Mylan Classic	finalChampion	Ben Martin
Sybase Match Play Championship	finalChampion	Azahara Muñoz
Open V33 Grand Lyon	finalChampion	Stephen Ames
Brazil São Paulo 500 Years Open	finalChampion	Darren Fichardt
Brazil Rio de Janeiro 500 Years Open	finalChampion	Roger Chapman
Abierto Internacional de Golf del Eje Cafetero	finalChampion	Óscar Álvarez
Mugello Tuscany Open	finalChampion	Marco Crespi
Margara Golf Open	finalChampion	Mads Vibe-Hastrup
Neuchâtel Open Golf Trophy	finalChampion	Marcus Knight
Atlantic Open	finalChampion	Stephen McAllister
Barcelona Open	finalChampion	David Whelan
Pennsylvania Classic	finalChampion	Cathryn Bristow
Safeco Classic	finalChampion	Maria Hjorth
WUI Classic	finalChampion	Beth Daniel
Corpus Christi Civitan Open	finalChampion	Sharon Miller
Songdo IBD Championship	finalChampion	Jay Don Blake
Shirley Englehorn Invitational	finalChampion	Carol Mann
Russian Challenge Cup	finalChampion	Alexandre Kaleka
Idaho Centennial Ladies' Open	finalChampion	Mickey Wright
Spokane Women's Open	finalChampion	Kathy Whitworth
Andalucía Masters	finalChampion	Sergio García
Volvo Golf Champions	finalChampion	Louis Oosthuizen
Gujarat Kensville Challenge	finalChampion	Shiv Kapur
Gallaher Ulster Open	finalChampion	Tommy Horton
Sicilian Open	finalChampion	Thorbjørn Olesen
Pasadena Open	finalChampion	Henry Picard
Thomasville Open	finalChampion	Harold \
Challenge de France	finalChampion	Nicolas Meitinger
Acaya Open	finalChampion	Espen Kofstad
Hero Honda Masters	finalChampion	Arjun Atwal
Chile Classic	finalChampion	Dawie van der Walt
Handa Faldo Cambodian Classic	finalChampion	David Lipsky
Challenge Provincia di Varese	finalChampion	Raymond Russell
Pacific Rubiales Colombia Classic	finalChampion	Phillip Archer
Crowne Plaza Copenhagen Challenge	finalChampion	Kristoffer Broberg
Nelson Mandela Championship	finalChampion	Dawie van der Walt
Telkom PGA Pro-Am	finalChampion	Oliver Bekker
Hotel Fitness Championship	finalChampion	Henrik Norlander
NH Collection Open	finalChampion	Marco Crespi
Puerto Rico Classic	finalChampion	Ryan Sullivan
Nova Scotia Open	finalChampion	Abraham Ancer
Dunlop-Southport Tournament	finalChampion	Fred Daly
Rörstrand Ladies Open	finalChampion	Karolina Andersson
Catalonia Ladies Masters	finalChampion	Ashleigh Simon
Göteborg Masters	finalChampion	Gwladys Nocera
Chrysler Open	finalChampion	Carin Koch
Danish Ladies Open	finalChampion	Laura Davies
Danish Ladies Masters	finalChampion	Martina Eberl
Haninge Ladies Open	finalChampion	Annika Sörenstam
Volvo Cross Country Challenge	finalChampion	Kiran Matharu
BT Ladies Open	finalChampion	Sophie Gustafson
Biarritz Ladies Classic	finalChampion	Marlene Hedblom
Marrakech Palmeraie Open	finalChampion	Alison Munt
Air France Madame Open	finalChampion	Sofia Grönberg-Whitmore
Ladies Hannover Expo 2000 Open	finalChampion	Alison Munt
Hennessy Cup	finalChampion	Laura Davies
South African Ladies Masters	finalChampion	Ashleigh Simon
Royal Marie-Claire Open	finalChampion	Silvia Cavalleri
Roehampton Invitation Tournament	finalChampion	Archie Compston
Glasgow Herald Tournament	finalChampion	Charles Whitcombe
Dunlop-Metropolitan Tournament	finalChampion	Alf Perry
Greater Dallas Open	finalChampion	Tyler Aldridge
Daily Mail Tournament	finalChampion	Charlie Ward
McVitie & Price Tournament	finalChampion	Joe Kirkwood, Sr.
Southend Tournament	finalChampion	Charles Whitcombe
Silver King Tournament	finalChampion	Flory Van Donck
News Chronicle Tournament	finalChampion	Ken Bousfield
True Temper Foursomes Tournament	finalChampion	Dick Burton and Fred Robson
Penfold Professional Golf League	finalChampion	Henry Cotton and Charles Whitcombe
Sphere and Tatler Foursomes Tournament	finalChampion	James Batley and Len Holland
Portmarnock Professional Tournament	finalChampion	James Sherlock
Ryder Tournament	finalChampion	Bill Davies and Abe Mitchell
London Professional Foursomes Tournament	finalChampion	Tom Ball and Fred Robson
Grand Duke Michael's Tournament	finalChampion	Arnaud Massy
Cruden Bay Professional Tournament	finalChampion	Harry Vardon
Bramshot Cup	finalChampion	Harry Vardon
Bishop's Stortford Tournament	finalChampion	George Duncan
Golf Illustrated Gold Vase	finalChampion	Andrew Inglis
Brand-Lochryn Tournament	finalChampion	Charlie Ward
Daily Sketch Fourball Tournament	finalChampion	William Anderson and Reg Whitcombe
The Star Tournament	finalChampion	Norman Von Nida
Lotus Tournament	finalChampion	Bobby Locke
Spalding Tournament	finalChampion	Harry Weetman
Manchester Evening Chronicle Tournament	finalChampion	Fred Daly
North British-Harrogate Tournament	finalChampion	Eric Lester
Irish Hospitals Tournament	finalChampion	Christy O'Connor Snr
Goodwin	finalChampion	Sidney Collins, Jr.
Goodwin	finalChampion	and
Goodwin	finalChampion	Bernard Hunt
Stuart C. Goodwin Tournament	finalChampion	Eric Brown and John Fallon
Coombe Hill Assistants' Tournament	finalChampion	Tony Jacklin
Rediffusion Tournament	finalChampion	Peter Alliss
Sprite Tournament	finalChampion	Harold Henning
Irish Championship Meeting Professional Tournament	finalChampion	Sandy Herd
Greenore Professional Tournament	finalChampion	James Braid
County Down Professional Tournament	finalChampion	Harry Vardon
Bowmaker Tournament	finalChampion	Peter Oosterhuis
Daily Telegraph Foursomes Tournament	finalChampion	Bill Cox and Walter McLeod
Classic International	finalChampion	Peter Butler
R.T.V. International Trophy	finalChampion	Peter Butler
Ivory Coast Open	finalChampion	Ian Poulter
Taiwan Ladies Open	finalChampion	Raquel Carriedo
England–Scotland Professional Match	finalChampion	England
Czechoslovak Open	finalChampion	Henry Cotton
Joy Cup	finalChampion	British Isles
Slazenger Trophy	finalChampion	Great Britain and Ireland
Triangular Professional Tournament	finalChampion	Scotland
Ireland–Scotland Professional Match	finalChampion	Ireland
England–Ireland Professional Match	finalChampion	England
Jeyes Tournament	finalChampion	Dave Thomas
Carling-Caledonian Tournament	finalChampion	Christy O'Connor Snr
Ballantine Tournament	finalChampion	Neil Coles
Senior Service Tournament	finalChampion	Cobie Legrange
Cox Moore Tournament	finalChampion	Peter Butler
Sherwood Forest Foursomes Tournament	finalChampion	Dai Rees
Sherwood Forest Foursomes Tournament	finalChampion	and
Sherwood Forest Foursomes Tournament	finalChampion	Dennis Smalldon
Honda Foursomes Tournament	finalChampion	Jimmy Hitchcock
Honda Foursomes Tournament	finalChampion	and
Honda Foursomes Tournament	finalChampion	Bill Large
Addington Foursomes	finalChampion	Dai Rees and Alfred Critchley
Dunlop Cup	finalChampion	Robert Thomson
Port Seton Professional Tournament	finalChampion	George Duncan
Ramlösa Open	finalChampion	Eric Carlberg
Costa Blanca Challenge	finalChampion	Johan Ryström
BTC Slovenian Open	finalChampion	Grant Dodd
KB Golf Challenge	finalChampion	Stephen Gallacher
Lomas Bosque Challenge	finalChampion	Per Nyman
Albarella International Open	finalChampion	Fredrik Lindgren
Himmerland Open	finalChampion	Søren Hansen
Canarias Challenge	finalChampion	Michele Reale
Campeonato de Castilla	finalChampion	Juan Carlos Piñero
Audi Quattro Trophy	finalChampion	Marcello Santi
Challenge Novotel	finalChampion	Jarmo Sandelin
Is Molas Challenge	finalChampion	Bradley Dredge
Torneo Islantilla Golf	finalChampion	Magnus Persson Atlevi
Nice International Tournament	finalChampion	Harry Vardon
OKI Telepizza Challenge	finalChampion	David Park
Open Ribera de Duero	finalChampion	José Salgado
Stiga Open	finalChampion	Pierre Fulke
