Aberfoyle, Stirling	gaelicName	Obar Phuill
Aberdour	gaelicName	Obar Dobhair
Alexandria, West Dunbartonshire	gaelicName	Am Magh Leamhna
Achduart	gaelicName	Achadh Dhubhaird
Achiltibuie	gaelicName	Achd Ille Bhuidhe
Fort William, Highland	gaelicName	An Gearasdan
Hawick	gaelicName	Hamhaig
Back of Keppoch	gaelicName	Cùl na Ceapaich
Cardonald	gaelicName	Cair Dhòmhnaill
Perth, Scotland	gaelicName	Peairt
Airdrie, North Lanarkshire	gaelicName	An t-Àrd Ruigh
Stirling	gaelicName	Sruighlea
Glasgow	gaelicName	Glaschu
Arbroath	gaelicName	Obar Bhrothaig
Milngavie	gaelicName	Muileann-Gaidh
Millport, Cumbrae	gaelicName	Port a' Mhuilinn
Fort Augustus	gaelicName	Cille Chuimein
Dumfries	gaelicName	Dùn Phris
Ruthwell	gaelicName	Ruadhail
Castle Douglas	gaelicName	Caisteal Dhùghlais
Moniaive	gaelicName	Am Moine Naomh
Kirkcudbright	gaelicName	Cille Chuithbeirt
Sanquhar	gaelicName	Seanchair
Ecclefechan	gaelicName	Eaglais Fheichein
Wigtown	gaelicName	Baile na h-Ùige
Stranraer	gaelicName	An t-Sròn Reamhar
Leith	gaelicName	Lìte
Inverness	gaelicName	Inbhir Nis
North Queensferry	gaelicName	Port na Banrighinn
Glencoe, Highland	gaelicName	A’ Chàrnaich
Thornhill, Dumfries and Galloway	gaelicName	Bàrr na Driseig
Thornhill, Stirling	gaelicName	Cnoc na Driseig
Stonehaven	gaelicName	Cala na Creige
Dalgety Bay	gaelicName	Bàgh Dhealgadaidh
Cromarty	gaelicName	Cromba
Innerleithen	gaelicName	Inbhir Leitheann
Ayr	gaelicName	Inbhir Àir
Fraserburgh	gaelicName	A' Bhruaich
Dunbar	gaelicName	Dùn Bàrr
Dunfermline	gaelicName	Dùn Phàrlain
Bishopbriggs	gaelicName	Coille Dobhair
Maryhill	gaelicName	Cnoc Mhoire
Brodick	gaelicName	Breadhaig/Tràigh a' Chaisteil
Dunoon	gaelicName	Dùn Omhain
Partick	gaelicName	Partaig
Govan	gaelicName	Baile a' Ghobhainn
Jordanhill	gaelicName	Cnoc Iòrdain
Bannockburn	gaelicName	Allt a' Bhonnaich
South Queensferry	gaelicName	Cas Chaolais
Forfar	gaelicName	Baile Fharfair
Livingston, West Lothian	gaelicName	Baile Dhùn Lèibhe
Rutherglen	gaelicName	An Ruadh Ghleann
Montrose, Angus	gaelicName	Monadh Rois
Lanark	gaelicName	Lannraig
Riddrie	gaelicName	An Ruadh Ruigh
Lamlash	gaelicName	An t-Eilean Àrd
Elgin, Moray	gaelicName	Eilginn
Plockton	gaelicName	Am Ploc
Gairloch	gaelicName	Geàrrloch
Paisley, Renfrewshire	gaelicName	Pàislig
Melrose, Scottish Borders	gaelicName	Maolros
Cambuslang	gaelicName	Camas Long
East Kilbride	gaelicName	Cille Bhrìghde an Ear
Knoydart	gaelicName	Cnòideart
Crieff	gaelicName	Craoibh
Blackwaterfoot	gaelicName	Bun na Dubh Abhainn
Lochranza	gaelicName	Loch Raonasa
Whiting Bay	gaelicName	Eadar Dhà Rubha
Kinlochleven	gaelicName	Ceann Loch Lìobhann
Irvine, North Ayrshire	gaelicName	Irbhinn
Motherwell	gaelicName	Tobar na Màthar
Greenock	gaelicName	Grianaig
Dornoch	gaelicName	Dòrnach
Ullapool	gaelicName	Ulapul
Thurso	gaelicName	Inbhir Theòrsa
St Andrews	gaelicName	Cill Rìmhinn
Falkirk	gaelicName	An Eaglais Bhreac
Bridge of Allan	gaelicName	Drochaid Alain
Kilmarnock	gaelicName	Cille Mheàrnaig
Kirkcaldy	gaelicName	Cair Chaladain
Dumbarton	gaelicName	Dùn Breatann
Portree	gaelicName	Port Rìgh
Bo'ness	gaelicName	Ceann Fhàil
Helensburgh	gaelicName	Baile Eilidh
Broughty Ferry	gaelicName	Bruach Tatha
Dunblane	gaelicName	Dùn Bhlàthain
Rothesay, Bute	gaelicName	Baile Bhòid
Armadale, Skye	gaelicName	Armadal
Auchterarder	gaelicName	Uachdar Àrdair
Dalkeith	gaelicName	Dail Cheith
Dingwall	gaelicName	Inbhir Pheofharain
Dufftown	gaelicName	Baile Bhainidh
Lochboisdale	gaelicName	Loch Baghasdail
Daliburgh	gaelicName	Dalabrog
Broxburn, West Lothian	gaelicName	Srath Bhroc
Uphall	gaelicName	Ubhalaidh
Forres	gaelicName	Farrais
Tobermory, Mull	gaelicName	Tobar Mhoire
Cupar	gaelicName	Cùbar
Lochgilphead	gaelicName	Ceann Loch Gilb
Largs	gaelicName	An Leargaidh Ghallda
Lauder	gaelicName	Labhdar
Peebles	gaelicName	Na Pùballan
North Berwick	gaelicName	Bearaig-a-Tuath
Pitlochry	gaelicName	Baile Chloichridh
Lossiemouth	gaelicName	Inbhir Losaidh
Tain	gaelicName	Baile Dhubhthaich
Nairn	gaelicName	Inbhir Narann
Halkirk	gaelicName	Hacraig
Crail	gaelicName	Cathair Aile
Gourock	gaelicName	Guireag
Girvan	gaelicName	Inbhir Gharbhain
Kinghorn	gaelicName	Ceann Gronna
Kinross	gaelicName	Ceann Rois
Kirriemuir	gaelicName	Cearan Mhoire
Grantown-on-Spey	gaelicName	Baile nan Granndach
Galashiels	gaelicName	An Geal Àth
Campbeltown	gaelicName	Ceann Loch Chille Chiarain
Portsoy	gaelicName	Port Saoidh
Newton Stewart	gaelicName	Baile Ùr nan Stiùbhartach
Port Glasgow	gaelicName	Port Ghlaschu
Callander	gaelicName	Calasraid
Culross	gaelicName	Cuileann Ros
Coldstream	gaelicName	An Sruthan Fuar
Cumnock	gaelicName	Cumnag
Doune	gaelicName	An Dùn
Fortrose	gaelicName	A' Chananaich
Grangemouth	gaelicName	Inbhir Ghrainnse
Inverurie	gaelicName	Inbhir Uraidh
Langholm	gaelicName	Langaim
Kingussie	gaelicName	Ceann a' Ghiùthsaich
Inveraray	gaelicName	Inbhir Aora
Inverkeithing	gaelicName	Inbhir Chèitinn
Brechin	gaelicName	Breichinn
Burghead	gaelicName	Am Broch
Banchory	gaelicName	Beannchar
Ballater	gaelicName	Bealadair
Clydebank	gaelicName	Bruach Chluaidh
Bearsden	gaelicName	Cille Phàdraig Ùr
Callanish	gaelicName	Calanais
Blantyre, South Lanarkshire	gaelicName	Baile an t-Saoir
Blairgowrie and Rattray	gaelicName	Blàr Ghobhraidh
Loudoun	gaelicName	Lughdan
Coatbridge	gaelicName	Drochaid a' Chòta
Gretna, Dumfries and Galloway	gaelicName	Greatna
Mull of Kintyre	gaelicName	Maol Chinn Tìre
Cowdenbeath	gaelicName	Cùl Dùn Beithe
Troon	gaelicName	An Truthail / An t-Sròn
Durness	gaelicName	Diùranais
Mallaig	gaelicName	Malaig
Luss	gaelicName	Lus
Beith	gaelicName	Beithe
Cathcart	gaelicName	Coille Chart
Saltcoats	gaelicName	Baile an t-Salainn.
Strontian	gaelicName	Sròn an t-Sìthein
Tongue, Highland	gaelicName	Tunga
Stornoway	gaelicName	Steòrnabhagh
Kilchoan	gaelicName	Cille Chòmhghain
Helmsdale	gaelicName	Bun Ilidh
Kilsyth	gaelicName	Cill Saidhe
Rosyth	gaelicName	Ros Fhìobh
Kelvinbridge	gaelicName	Drochaid Chaol-Aibhne
Alloway	gaelicName	Allmhaigh
Roxburgh	gaelicName	Rosbrog
Ralston, Renfrewshire	gaelicName	Baile Raghnaill
Lochwinnoch	gaelicName	Loch Eanach
Elderslie	gaelicName	Ach na Feàrna
Erskine	gaelicName	Arasgain
Barrhead	gaelicName	Ceann a' Bharra
Longniddry	gaelicName	Nuadh-Treabh Fada
Ibrox, Glasgow	gaelicName	Àth Bruic
Lesmahagow	gaelicName	Lios MoChuda
Baillieston	gaelicName	Baile Bhàillidh
Newton Mearns	gaelicName	Baile Ùr na Maoirne
Glenrothes	gaelicName	Gleann Ràthais
Port Ellen	gaelicName	Port Ìlein
Larkhall	gaelicName	Taigh na h-Uiseig
Lagavulin	gaelicName	Lag a' Mhuilinn
Kirkintilloch	gaelicName	Cair Cheann Tulaich
Blair Atholl	gaelicName	Blàr Athall
Newtown St Boswells	gaelicName	Baile Ùr Chille Bhoisil
Giffnock	gaelicName	Giofnag
Cults, Aberdeen	gaelicName	A' Chùilt
Ballachulish	gaelicName	Baile a' Chaolais
Arrochar, Argyll	gaelicName	An t-Àrchar
Buckie	gaelicName	Bucaidh
Rosehearty	gaelicName	Ros Abhartaich
Stenhousemuir	gaelicName	Am Featha Taigh nan Clach
Dyce	gaelicName	Deis
Braemar	gaelicName	Bràigh Mhàrr
Glen Coe	gaelicName	Gleann Comhan
Glenfinnan	gaelicName	Gleann Fhionghain
Uig, Lewis	gaelicName	Ùig
Castlemilk	gaelicName	Caisteal Mheilc
Kilwinning	gaelicName	Cill Fhinnein
Cramond	gaelicName	Cathair Amain
Mull of Galloway	gaelicName	Maol nan Gall
Carnoustie	gaelicName	Càrn Ùstaidh
Kelvindale	gaelicName	Dail Chealbhainn
Lochcarron	gaelicName	Loch Carrann
Kyle of Lochalsh	gaelicName	Caol Loch Aillse
Kinlochbervie	gaelicName	Ceann Loch Biorbhaidh
Findochty	gaelicName	Am Fionn Ochdamh
Strathaven	gaelicName	Strath Aibhne
Rodel	gaelicName	Roghadal
Peterculter	gaelicName	Cultair
Yoker	gaelicName	An Eochair
Hillhead	gaelicName	Ceann a' Chnuic
Pittenweem	gaelicName	Baile na h-Uaimh
Townhead	gaelicName	Ceann a' Bhaile
Cowcaddens	gaelicName	Coille Challtainn
Johnstone	gaelicName	Baile Iain
Ardrossan	gaelicName	Àird Rosain
Wishaw	gaelicName	Camas Neachdain
Ellon, Aberdeenshire	gaelicName	Eilean
Polmont	gaelicName	Poll-Mhonadh
Fochabers	gaelicName	Fothabair
Kilbarchan	gaelicName	Cill Bhearchain
Ranfurly, Renfrewshire	gaelicName	Rann Feòirling
Inchinnan	gaelicName	Innis Fhionghain
Howwood	gaelicName	Coille an Dail
Bishopton, Renfrewshire	gaelicName	Baile an Easbaig
Shettleston	gaelicName	Baile Nighean Sheadna
Aboyne	gaelicName	Abèidh
Summerston	gaelicName	Baile Samhraidh
Port Bannatyne	gaelicName	Port MhicEamailinn
Wemyss Bay	gaelicName	Bagh nan Uaimhean
Drymen	gaelicName	Druiminn
Anderston	gaelicName	Baile Aindrea
North Kelvinside	gaelicName	Cealbhainn a Tuath
Dysart, Fife	gaelicName	Dìseart
Aberchirder	gaelicName	Obar Chiardair
Aberlour	gaelicName	Obar Lobhair
Abernethy, Perth and Kinross	gaelicName	Obar Neithich
Alyth	gaelicName	Ailt
Auchtermuchty	gaelicName	Uachdar Mucadaidh
Bathgate	gaelicName	Both Chèit
Bellshill	gaelicName	Cnoc a' Chluig
Carluke	gaelicName	Cathair MoLuaig
Musselburgh	gaelicName	Baile nam Feusgan
Cockenzie and Port Seton	gaelicName	Cùil Choinnich
Coupar Angus	gaelicName	Cùbar Aonghais
Cullen, Moray	gaelicName	Inbhir Cuilinn
Dalbeattie	gaelicName	Dail Bheithe
Denny, Falkirk	gaelicName	Deanaidh
Galston, East Ayrshire	gaelicName	Baile nan Gall
Coldbackie	gaelicName	Callbacaidh
Onich	gaelicName	Omhanaich
Leverburgh	gaelicName	An Tòb / An t-Òb
Leuchars	gaelicName	Luachar
Carmunnock	gaelicName	Cathair Mhanach or Coire Manaich
Duntocher	gaelicName	Dùn Tòchair
Kennacraig	gaelicName	Ceann na Creige
Anstruther	gaelicName	Ànsruthair
Tillicoultry	gaelicName	Tulach Cultaire, Tulach Cultraidh
Latheronwheel	gaelicName	Latharn a' Phuill
Tomintoul	gaelicName	Tom an t-Sabhail
Aberfeldy, Perth and Kinross	gaelicName	Obar Pheallaidh
Dunvegan	gaelicName	Dùn Bheagain
Portmahomack	gaelicName	Port Mo Chalmaig
Hill of Fearn	gaelicName	Baile an Droma
Dalneigh	gaelicName	Dail an Eich
Leven, Fife	gaelicName	Inbhir Lìobhann
Knockan	gaelicName	An Cnocan
Bunessan	gaelicName	Bun Easain
Blackburn, West Lothian	gaelicName	An Dubh Allt
Portpatrick	gaelicName	Port Phàdraig
Crianlarich	gaelicName	A' Chrìon Làraich
Dunkeld	gaelicName	Dùn Chailleann
Bridgeton, Glasgow	gaelicName	Baile na Drochaid
Castlebay	gaelicName	Bàgh a' Chaisteil
Southend, Argyll	gaelicName	Ceann mu Dheas
Fintry	gaelicName	Fionn Treabh
Kintra	gaelicName	Ceann na Tràgha
Auchinleck	gaelicName	Achadh nan Leac
Cruden Bay	gaelicName	Inbhir Chruidein
Maybole	gaelicName	Am Magh Baoghail
Wick, Caithness	gaelicName	Inbhir Ùige
Bargeddie	gaelicName	Bàrr Geadaidh
Balivanich	gaelicName	Baile a' Mhanaich
Invermoriston	gaelicName	Inbhir Mhoireastain
Auchenshuggle	gaelicName	Achadh an t-Seagail
Turriff	gaelicName	Torraibh / Baile Thurra
Ardlui	gaelicName	Àird Laoigh
Arisaig	gaelicName	Àrasaig
Keith, Moray	gaelicName	Baile Chèith
Lairg	gaelicName	An Luirg
Greater Glasgow	gaelicName	Mòr-Ghlaschu
Back, Lewis	gaelicName	Am Bac
Strathpeffer	gaelicName	Srath Pheofhair
Loch Kishorn	gaelicName	Ciseòrn
Tyndrum	gaelicName	Taigh an Droma
Castletown, Highland	gaelicName	Baile a' Chaisteil
Knock, Isle of Lewis	gaelicName	An Cnoc
Crookston, Glasgow	gaelicName	Baile Cruic
Morar	gaelicName	Mòrar
Glenelg, Highland	gaelicName	Glinn Eilg
Bowmore	gaelicName	Bogh Mòr
Craighouse	gaelicName	Taigh na Creige
Saltburn, Ross-shire	gaelicName	Alltan an t-Salainn
New Galloway	gaelicName	Baile Ur Ghall-Ghaidhealaibh
Kelso, Scottish Borders	gaelicName	Cealsaidh
Tarbert, Argyll and Bute	gaelicName	Tairbeart Loch Fìne/An Tairbeart
Alford, Aberdeenshire	gaelicName	Athfort
Larbert	gaelicName	Lèirbeart/Larbairt/Leth-pheairt
Penicuik	gaelicName	Peighinn na Cuthaig
Rothes	gaelicName	Ràthais
Ardmore, Barra	gaelicName	Aird Mhòr
Stevenston	gaelicName	Baile Steaphain
Dunnet	gaelicName	Dùnaid
Hurlford	gaelicName	Àth Cliath
Darvel	gaelicName	Darbhail
Robroyston	gaelicName	Baile Raibeart Ruadh
Dornie	gaelicName	An Dòrnaidh
Kirkconnel	gaelicName	Cille Chonaill
Forsinard	gaelicName	Forsan Àird
Abercorn	gaelicName	Obar Chùirnidh
Uddingston	gaelicName	Baile Udain
Brora	gaelicName	Brùra
Drumnadrochit	gaelicName	Druim na Drochaid
Latheron	gaelicName	Latharn
Tollcross, Glasgow	gaelicName	Toll na Croise
Old Aberdeen	gaelicName	Seann Obar Dheathain
Boat of Garten	gaelicName	Coit a' Ghartain
Kilbirnie	gaelicName	Cill Bhraonaigh
Dollar, Clackmannanshire	gaelicName	Dolair
Balmullo	gaelicName	Baile Mhullaich
Annan, Dumfries and Galloway	gaelicName	Anainn
Glen Orchy	gaelicName	Gleann Urchaidh
Brig o' Turk	gaelicName	Ceann Drochaid
Menstrie	gaelicName	Meanstraidh
Tranent	gaelicName	Tranant
Scourie	gaelicName	Sgobhairigh
Inverallochy and Cairnbulg	gaelicName	Inbhir Aileachaidh
Lochbuie, Mull	gaelicName	Locha Buidhe
Ness, Lewis	gaelicName	Nis
Inveresk	gaelicName	Inbhir Easg
Drummore	gaelicName	An Druim Mòr
Laurencekirk	gaelicName	Coinmheadh
Comrie	gaelicName	Cuimrigh
Lochinver	gaelicName	Loch an Inbhir
Kenmore, Perth and Kinross	gaelicName	A' Cheannmhor
Falkland, Fife	gaelicName	Fàclann
Stewarton	gaelicName	Baile nan Stiùbhartach
Balloch, West Dunbartonshire	gaelicName	Am Bealach
Reay	gaelicName	Ràth
Achnacarry	gaelicName	Achadh na Cairidh
Edinbane	gaelicName	An t-Aodann Bàn
Watten, Highland	gaelicName	Bhatan
Carmyle	gaelicName	An Càrn Maol
Lochgelly	gaelicName	Loch Gheallaidh
Cairnryan	gaelicName	Machair an Sgithich
Mount Florida	gaelicName	Cnoc Florida
Arden, Glasgow	gaelicName	Àirdean
Croftfoot	gaelicName	Bun a' Chroit
Craigton, Glasgow	gaelicName	Baile Chreig
Bellahouston	gaelicName	Baile Ùistein
Renton, West Dunbartonshire	gaelicName	An Reantan
Craignure	gaelicName	Creag an Iubhair
Drumchapel	gaelicName	Druim a' Chapaill
Ullinish	gaelicName	Uilfhinis
Balquhidder	gaelicName	Both Chuidir or Both Phuidir
Earlston	gaelicName	Dùn Airchill
Kyleakin	gaelicName	Caol Àcain
Portnaguran	gaelicName	Port nan Giùran
Aignish	gaelicName	Aiginis
Cawdor	gaelicName	Caladar
Tarbet, Argyll	gaelicName	An Tairbeart
Shawbost	gaelicName	Siabost
Jamestown, West Dunbartonshire	gaelicName	Baile Sheumais
Bonhill	gaelicName	Both an Uillt
Hillington, Scotland	gaelicName	Hileantan
Achnashellach	gaelicName	Achadh nan Seileach
Lenzie	gaelicName	Lèanaidh
Fauldhouse	gaelicName	Falas
Crossmyloof	gaelicName	Crois Mo Liubha
Applecross	gaelicName	A' Chomraich
Shandwick	gaelicName	Seannduaig
Balintore, Easter Ross	gaelicName	Baile an Todhair
Hilton of Cadboll	gaelicName	Baile a' Chnuic
Scarinish	gaelicName	Sgairinis
Altnabreac	gaelicName	Allt nam Breac
Springburn	gaelicName	Allt an Fhuairain
Gravir	gaelicName	Grabhar
Old Kilpatrick	gaelicName	Cille Phàdraig
Inverbervie	gaelicName	Inbhir Biorbhaidh
Uig, Skye	gaelicName	Ùige
Bettyhill	gaelicName	Am Blàran Odhar
Garenin	gaelicName	Na Gearrannan
Barvas	gaelicName	Barabhas, Barbhas
Aberargie	gaelicName	Obar Fhargaidh
Aberarder	gaelicName	Obar Àrdair
Duntulm	gaelicName	Dùn Thuilm
Aberdalgie	gaelicName	Obar Dheilgidh
Aberlady	gaelicName	Obar Lìobhaite
Aberlemno	gaelicName	Obar Leamhnach
Aberuthven	gaelicName	Obar Ruadhainn
Inverie	gaelicName	Inbhir Aoidh
Abriachan	gaelicName	Obar Itheachan
Acha, Coll	gaelicName	An t-Achadh
Golspie	gaelicName	Goillspidh
Achanalt	gaelicName	Achadh nan Allt
Achfary	gaelicName	Achadh Taigh Phairidh
Acharacle	gaelicName	Àth Tharracail
Achmelvich	gaelicName	Achadh Mhealbhaich
Achnacarnin	gaelicName	Achadh nan Càrnan
Achintee, Fort William	gaelicName	Achadh an t-Suidhe
Achandunie	gaelicName	Achadh an Dùnaidh
Achmore, Lewis	gaelicName	An t-Acha Mòr
Achnaconeran	gaelicName	Achadh nan Conbhairean
Achnagarron	gaelicName	Achadh nan Gearran
Achnafauld	gaelicName	Achadh na Follt
Achosnich	gaelicName	Achadh Osnaich
Achvaich	gaelicName	Achadh a' Bhàthaich
Achtoty	gaelicName	Achadh Toitidh
Achriesgill	gaelicName	Achadh Rìdhisgil
Achriabhach	gaelicName	An t-Achadh Riabhach
Achnasheen	gaelicName	Achadh na Sìne
Addiewell	gaelicName	Tobar Adaidh
Inverkip	gaelicName	Inbhir Chip
Advie	gaelicName	Àbhaidh
Assynt	gaelicName	Asainte
Catacol	gaelicName	Catagal
Insch	gaelicName	An Innis or Innis Mo Bheathain
Port Askaig	gaelicName	Port Asgaig
Portnahaven	gaelicName	Port na h-Abhainne
Bridgend, Islay	gaelicName	Beul an Àtha
Balornock	gaelicName	Both Lobharnaig
Anniesland	gaelicName	Fearann Anna
Barmulloch	gaelicName	Barr a' Mhullaich
Cadder	gaelicName	Coile Dobhair
Calton, Glasgow	gaelicName	A' Challtainn
Carntyne	gaelicName	Càrn an Teine
Garrowhill	gaelicName	An Cnoc Garbh
Haghill	gaelicName	Cnoc na Cailliche
Garscadden	gaelicName	Gart Sgadan
Dalmarnock	gaelicName	Dail Mheàrnaig
Easterhouse	gaelicName	Am Baile Sear
Ardminish	gaelicName	Aird Mhèanais
Whiteinch	gaelicName	Innis Bhàn
Carnwadric	gaelicName	A' Chloch
Hillpark	gaelicName	Pàirc a' Chnuic
Dumbreck	gaelicName	An Dùn Breac
Mosspark	gaelicName	Pàirc na Mòna
Govanhill	gaelicName	Cnoc a' Ghobhainn
Muirend	gaelicName	Ceann an t-Slèibh
Polmadie	gaelicName	Poll Mac Dè
South Nitshill	gaelicName	Cnoc nan Cnòthan a Deas
Hutchesontown	gaelicName	Baile MacUisdein
Langside	gaelicName	An Leathad Fada
Kennishead	gaelicName	Ceann Ceanais
Kippen	gaelicName	An Ceapan
Balerno	gaelicName	Baile Àirneach
Bowling, West Dunbartonshire	gaelicName	Bolan
Carrbridge	gaelicName	Drochaid Chàrr
Crimond	gaelicName	Crith Mhonadh
Crimond	gaelicName	or Crioch Mhonadh
Alness	gaelicName	Alanais
Macmerry	gaelicName	Magh Mhoire
Struan, Skye	gaelicName	An Sruthan
Aird, Lewis	gaelicName	Àird an Rubha
Aird of Sleat	gaelicName	Aird Shlèite
Ardhasaig	gaelicName	Àird Àsaig
Balallan	gaelicName	Baile Ailein
Newtonmore	gaelicName	Baile Ùr an t-Slèibh
Airlie, Angus	gaelicName	Iarlaidh
Airntully	gaelicName	Àird an Tulaich
Rosemarkie	gaelicName	Ros Mhaircnidh
Bragar	gaelicName	Bràgar
Skarfskerry	gaelicName	Sgarbh Sgeir
Achintraid	gaelicName	Achadh na Tràghad
Portuairk	gaelicName	Port Uairce
Appin	gaelicName	An Apainn
Lochmaddy	gaelicName	Loch nam Madadh
Cambuskenneth	gaelicName	Camas Choinnich
Glengarnock	gaelicName	Gleann Gairneig
Avonbridge	gaelicName	Droichaid Abhainne
Mauchline	gaelicName	Machlainn
Beauly	gaelicName	A' Mhanachainn
Alva, Clackmannanshire	gaelicName	Allmhagh Beag
Hushinish	gaelicName	Hùisinis
Drummuir	gaelicName	Druim Iubhair
Stromeferry	gaelicName	Port an t-Sròim
Lybster	gaelicName	Liabost
Oldmeldrum	gaelicName	Meall Druim
Carloway	gaelicName	Càrlabhagh
Kylerhea	gaelicName	Caol Reatha
Ballygrant	gaelicName	Baile a' Ghràna
Carfin	gaelicName	An Càrn Fionn
Tarbert, Harris	gaelicName	An Tairbeart
Scalasaig	gaelicName	Sgalasaig
Clackmannan	gaelicName	Clach Mhanainn
Ruthven, Badenoch	gaelicName	Ruadhainn
Ratho	gaelicName	Ràthach
Monifieth	gaelicName	Monadh Feith
Newcastleton	gaelicName	Baile a' Chaisteil Nuadh
Croy, North Lanarkshire	gaelicName	An Crò
Gullane	gaelicName	Gualainn
St Fillans	gaelicName	Am Port Mòr
Evanton	gaelicName	Baile Eòghainn
Kildary	gaelicName	Caoldaraigh
Kilmaurs	gaelicName	Cill Mhàrais
Ardersier	gaelicName	Àird nan Saor
Northbay	gaelicName	Am Bàgh a Tuath
Sollas	gaelicName	Solas
Howmore	gaelicName	Togh Mòr / Tobha Mor
Carinish	gaelicName	Càirinis
Dalmellington	gaelicName	Dail M'Fhaolain
Sligachan	gaelicName	Sligeachan
Baldernock	gaelicName	Baile Deàrnaig
Dalry, North Ayrshire	gaelicName	Dail Ruighe
St Boswells	gaelicName	Cille Bhoisil
Rosneath	gaelicName	Ros Neimhidh
Neilston	gaelicName	Baile Nèill
Corkerhill	gaelicName	Cnoc Chorcair
Shieldaig	gaelicName	Sìldeag
Kinlochewe	gaelicName	Ceann Loch Iù
Kilmahog	gaelicName	Cille MoChùig
Killin	gaelicName	Cill Fhinn
Peterhead	gaelicName	Ceann Phàdraig
Currie	gaelicName	Currach
Skigersta	gaelicName	Sgiogarstaigh
Fresgoe	gaelicName	Gleann Fhionnainn
Torrance, East Dunbartonshire	gaelicName	An Toran
Poolewe	gaelicName	Poll Iù
Blackford, Perth and Kinross	gaelicName	Srath Gaoithe
Dalmeny	gaelicName	Dail Mheinidh, Dail M'Eithne
Kinmylies	gaelicName	Ceann a' Mhìlidh
Dirleton	gaelicName	Duighreach
Killiecrankie	gaelicName	Coille Chreithnich
Portlethen	gaelicName	Port Leathain
Raploch	gaelicName	An Raplach
Dalmuir	gaelicName	Dail Mhoire
Armadale, West Lothian	gaelicName	Armadal
Dallas, Moray	gaelicName	Dalais
Scoraig	gaelicName	Sgoraig
Laggan, Great Glen	gaelicName	An Lagan
Broadford, Skye	gaelicName	An t-Àth Leathann
Ardwell	gaelicName	Àrd Bhaile
Auchlyne	gaelicName	Achadh Loinne
Dunragit	gaelicName	Dùn Reicheit
Portvoller	gaelicName	Port Mholair
Broker, Lewis	gaelicName	Brocair
Muckhart	gaelicName	Muc-Àird
Blairlogie	gaelicName	Blàr Lagaidh
Flesherin	gaelicName	Na Fleisirean
Bonnybridge	gaelicName	Drochaid a'Bhuinne
Blackhill, Glasgow	gaelicName	Cnoc Dubh
King's Park, Glasgow	gaelicName	Pàirc Rìgh
Lennoxtown	gaelicName	Baile na Leamhnachd
Ballencrieff, East Lothian	gaelicName	Baile na Craoibhe
Bridge of Earn	gaelicName	Drochaid Èireann
Breasclete	gaelicName	Brèascleit
Melbost	gaelicName	Mealabost
Bayble	gaelicName	Pabail
Dunbeath	gaelicName	Dùn Bheithe
Buchlyvie	gaelicName	Both Shlèibhidh
Lochearnhead	gaelicName	Ceann Loch Èireann
Tullibody	gaelicName	Tulach Bòide
Garelochhead	gaelicName	Ceann a' Gheàrr-loch
Blackness, Falkirk	gaelicName	An Dubh-Nis
Lawers	gaelicName	Labhar
Balmedie	gaelicName	Baile Mheadhain
Kincardine	gaelicName	Cinn Chàrdainn
Killearn	gaelicName	Cill Fhearann, orig. Ceann Fhearann
Finzean	gaelicName	Fìnnean
Torry	gaelicName	Torraidh
Isleornsay	gaelicName	Eilean Iarmain
Fortingall	gaelicName	Fartairchill
Kittybrewster	gaelicName	Cuidhe Briste
Markinch	gaelicName	Marc Innis
Laggan, Badenoch	gaelicName	Lagan
Walkerburn	gaelicName	Allt an Fhùcadair
Holytown	gaelicName	Baile a' Chuilinn
Conon Bridge	gaelicName	Drochaid Sguideil
Dullatur	gaelicName	Dubh Leitir
Morvern	gaelicName	A' Mhorbhairne
Gress	gaelicName	Griais
Banknock	gaelicName	Baile nan Cnoc
Balgowan, Dundee	gaelicName	Baile Ghobhainn
North Kessock	gaelicName	Ceasag a Tuath
Foresterhill	gaelicName	Cnoc an Fhorsair
Tillydrone	gaelicName	Tulach Droighne
Dalwhinnie	gaelicName	Dail Chuinnidh
Douglas, South Lanarkshire	gaelicName	Dùbhghlas
Footdee	gaelicName	Bun Dè
Stoneyburn	gaelicName	Allt nan Clach
Fearnan	gaelicName	Feàrnan
Weem	gaelicName	Baile a' Chlachain
Methven, Perth and Kinross	gaelicName	Meadhainnigh
Tarskavaig	gaelicName	Tarsgabhaig
Auldearn	gaelicName	Allt Èireann
Westhill, Inverness	gaelicName	Cnoc Shuas
Smithton, Inverness	gaelicName	Baile a' Ghobhainn
Balloch, Highland	gaelicName	Baile an Locha
Dunipace	gaelicName	Dùin na Bàis
Strathblane	gaelicName	Strath Bhlàthain
Buckhaven	gaelicName	Baile 'Ic Eòghainn
Clunie	gaelicName	Cluainidh
Rowardennan	gaelicName	Rubha Aird Eònain
Methlick	gaelicName	Maothulach
Cummingston	gaelicName	an Coileach
Shulishader	gaelicName	Siadar an Rubha
Leurbost	gaelicName	Liùrbost
Corrie, Arran	gaelicName	An Coire
West Calder	gaelicName	Calder an Iar
Macduff, Aberdeenshire	gaelicName	An Dùn
Banff, Aberdeenshire	gaelicName	Banbh
Munlochy	gaelicName	Bun Lòchaidh/Poll Lòchaidh
Linlithgow	gaelicName	Gleann Iucha
Torridon	gaelicName	Toirbheartan
Aultbea	gaelicName	An t-Allt Beithe
Arbuthnott	gaelicName	Obar Bhuadhnait
Banavie	gaelicName	Banbhaidh
Spittal of Glenshee	gaelicName	Spideal Ghlinn Sìdh
Finegand	gaelicName	Fèith nan Ceann
Avoch	gaelicName	Abhach
Edderton	gaelicName	Eadardan
Lochailort	gaelicName	Ceann Loch Ailleart
Tore, Scotland	gaelicName	An Todhar
Partickhill	gaelicName	Bhrae na Partaig
Ballinluig	gaelicName	Baile an Luig
Ardgay	gaelicName	Àird Gaoith
Muir of Ord	gaelicName	Am Blàr Dubh
Kinbrace	gaelicName	Ceann a' Bhràist
Rogart	gaelicName	Raoghard
Duirinish, Lochalsh	gaelicName	Diùirinis
Garve	gaelicName	Gairbh
Coalsnaughton	gaelicName	Caolas Neachdainn
Colbost	gaelicName	Cealabost
Corran, Loch Hourn	gaelicName	An Corran
Gilmerton	gaelicName	Baile GhilleMhoire
Stracathro	gaelicName	Srath Catharach
Caol	gaelicName	An Caol
Kilmory, Arran	gaelicName	Cill Mhoire
Sliddery	gaelicName	Slaodraidh
Dunlop, East Ayrshire	gaelicName	Dùn Lùib
Inveran	gaelicName	Inbhirean
Strathwhillan	gaelicName	Srath Chuilinn
Shiskine	gaelicName	An t-Seasgann
Kildonan, Arran	gaelicName	Cill Donnain
Edzell	gaelicName	Eigill
Inverkeilor	gaelicName	Inbhir Chìollair
Dalmally	gaelicName	Clachan an Dìseirt, Dail Mhàilidh
St Cyrus	gaelicName	Eaglais Chiric
Garynahine	gaelicName	Gearraidh na h-aibhne
Fintry, Dundee	gaelicName	Fionn Treabh
Stoneybridge	gaelicName	Staoinebrig
Milton, Easter Ross	gaelicName	Baile Mhuilinn Anndra
Torrin	gaelicName	Na Torrain
Stepps	gaelicName	Na Steap
Embo	gaelicName	Earabol
Invergowrie	gaelicName	Inbhir Ghobharaidh
Croftamie	gaelicName	Croit Sheumaidh
Redding, Falkirk	gaelicName	Reidean
Westquarter	gaelicName	Ceathramh-an-Iar
Camelon	gaelicName	Camlann
Ardeonaig	gaelicName	Aird Eòdhanaig
Ardtalnaig	gaelicName	Àird Talanaig
Pirnmill	gaelicName	Muileann nam Piùirneachan
Sannox	gaelicName	Sannaig
Cladach	gaelicName	An Cladach
Ose, Skye	gaelicName	Òs
Tigharry	gaelicName	Taigh a' Ghearraidh
Muirkirk	gaelicName	Eaglais an t-Sléibh
Cannich	gaelicName	Canaich
Bridge of Don	gaelicName	Drochaid Dheathain
Dull, Perth and Kinross	gaelicName	Dul
Upper Breakish	gaelicName	Breacais Àrd
Achgarve	gaelicName	An t-Achadh Garbh
Achavandra Muir	gaelicName	Achadh Anndra
Achaphubuil	gaelicName	Achadh a' Phùbaill
Achachork	gaelicName	Achadh a' Choirce
Aberchalder	gaelicName	Obar Chaladair
Adabroc	gaelicName	Adabroc
Balnacra	gaelicName	Beul-àtha na Crà
Tweedbank	gaelicName	Bruach Thuaidh
Letham, Falkirk	gaelicName	Leathann
Logierait	gaelicName	Lag an Ratha
Muthill	gaelicName	Maothail
Blackridge, West Lothian	gaelicName	An Druim Dubh
Kirknewton, West Lothian	gaelicName	Eaglais a' Bhaile Ùir
Dechmont	gaelicName	Deagh Mhonadh
Tong, Lewis	gaelicName	Tunga
Ancrum	gaelicName	Alan Crom
Barbaraville	gaelicName	An Cladach
Garvald, East Lothian	gaelicName	Garbh Allt
Uisken	gaelicName	Uisgean
Deanston	gaelicName	Baile an Deadhain
Ruskie	gaelicName	Ruisgidh
Fordoun	gaelicName	Fordun
Tarbrax	gaelicName	An Tòrr Breac
Eriboll	gaelicName	Earabol
Auchencairn	gaelicName	Achadh an Cairn
Balmore	gaelicName	Baile Mòr
Rockfield, Highland	gaelicName	Creag Tarail Bhig
Garrabost	gaelicName	Garrabost
Spean Bridge	gaelicName	Drochaid Aonachain
Strathy	gaelicName	Srathaidh
Luncarty	gaelicName	Longartaidh
Melvich	gaelicName	A' Mhealbhaich
Dalrigh	gaelicName	Dail Rìgh
Arnol	gaelicName	Àrnol
Auchentiber	gaelicName	Achadh an Tiobair
Temple, Midlothian	gaelicName	Baile nan Trodach
Trinafour	gaelicName	Trian a' Phùir
Kilmory, Highland	gaelicName	Cill Mhoire
Maryburgh	gaelicName	Baile Màiri
Kinnaird, Atholl	gaelicName	An Ceann Àrd
Kincardine O'Neil	gaelicName	Cinn Chàrdainn
Tornagrain	gaelicName	Tòrr na Grèine
Lagg	gaelicName	An Lag
Tarfside	gaelicName	Bruach Tarbha
Belhelvie	gaelicName	Baile Shealbhaigh
Nigg, Highland	gaelicName	An Neag
Kilaulay	gaelicName	Cill Amhlaigh
Innerwick	gaelicName	Inbhir Mhuice
Westfield, West Lothian	gaelicName	an t-Achadh Siar
Boreraig	gaelicName	Boraraig
Nethy Bridge	gaelicName	Cinn Drochaid
Balmaha	gaelicName	Baile MoThatha
Head of Muir	gaelicName	Ceann a' Mhonaidh
Invergarry	gaelicName	Inbhir Garadh
Camlachie	gaelicName	Camadh Làthaich
Tibbermore	gaelicName	An Tiobar Mòr
Auldhouse	gaelicName	An Taigh Sean
Balnain	gaelicName	Baile an Fhàin
Big Sand	gaelicName	Sannda Mhòr
Binniehill	gaelicName	Am Binnean
Blaich	gaelicName	Blàthaich
Achrimsdale	gaelicName	Achadh Rumasdail
Askernish	gaelicName	Àisgearnais
Aldclune	gaelicName	Allt Cluaine
Allasdale	gaelicName	Allathasdal
Alves, Moray	gaelicName	An Àbhais or An Àbhas
Ardchronie	gaelicName	Àird Chrònaidh
Ardelve	gaelicName	Àird Eilbh
Ardchyle	gaelicName	Àrd Choille
Ardheisker	gaelicName	Àird Heillsgeir
Arpafeelie	gaelicName	Arpa Phìlidh
Artafallie	gaelicName	Àirde Fàillidh
Ardveenish	gaelicName	Àird Mhèanais
Arinagour	gaelicName	Àirigh nan Gobhar
Ardvasar	gaelicName	Àird a' Bhàsair
Ardtun	gaelicName	Àird Tunna
Ardroil	gaelicName	Eadar Dhà Fhadhail
Ardullie	gaelicName	Àird Ilidh
Ardross, Highland	gaelicName	Àird Rois
Bogniebrae	gaelicName	Bognach
Bogach	gaelicName	A' Bhogach
Borgie	gaelicName	Borghaidh
Borreraig	gaelicName	Boraraig
Bornesketaig	gaelicName	Borgh na Sgiotaig
Borrowston, Lewis	gaelicName	Borghastan
Bornish	gaelicName	Bornais
Borsham	gaelicName	Boirseam
Borve, Harris	gaelicName	Na Buirgh
Ascog	gaelicName	Àsgaig
Ashaig	gaelicName	Aiseag
Ashfield, Stirling	gaelicName	Achadh an Uinnsinn
Auchinairn	gaelicName	Achadh an Fheàrna
Auchenreoch	gaelicName	An t-Achadh Riabhach
Auchterderran	gaelicName	Uachdar Doirein
Aultmore	gaelicName	An t-Allt Mòr
Auratote	gaelicName	Oratobht
Badrallach	gaelicName	Am Bad Ràilleach
Ochtertyre	gaelicName	Uachdar Thìre
Ockle	gaelicName	Ocal
Old Blair	gaelicName	Seann Bhlàr
Baile an Truiseil	gaelicName	Baile an Truiseil
Balgarva	gaelicName	Baile Gharbhaidh
Bail' Iochdrach	gaelicName	Am Baile Ìochdrach
New Tolsta	gaelicName	Baile Ùr Tholastaidh
Baile Glas	gaelicName	Am Baile Glas
Nunton, Benbecula	gaelicName	Baile nan Cailleach
Cabharstadh	gaelicName	Cabharstaigh
Cabrach	gaelicName	A' Chabrach
Calbost	gaelicName	Calabost
Caldercruix	gaelicName	Cròcan Chaladair
Mealista	gaelicName	Mealasta
Bracadale	gaelicName	Bracadal
Portgordon	gaelicName	Port Ghòrdain
Slamannan	gaelicName	Sliabh Mhanainn
Sanna, Ardnamurchan	gaelicName	Sanna
Evelix	gaelicName	Èibhleag
Breaclete	gaelicName	Breacleit
Brenish	gaelicName	Brèinis
Breivig	gaelicName	Brèibhig
Brevig	gaelicName	Brèibhig
Gartmore	gaelicName	An Gart Mòr
Eddleston	gaelicName	Baile Ghille Mhoire
Inchnadamph	gaelicName	Innis nan Damh
Broomridge	gaelicName	Druim a' Bhealaidh
Birnam, Perth and Kinross	gaelicName	Braonan
Glendaruel	gaelicName	Gleann Dà Ruadhail
Redpoint	gaelicName	An Rubha Dearg
Kilmuir, Skye	gaelicName	Cille Mhoire
Wallacestone	gaelicName	Clach Uallais
Fanagmore	gaelicName	An Fheannag Mhòr
Amhuinnsuidhe	gaelicName	Abhainn Suidhe
Riccarton, Ayrshire	gaelicName	Baile Riocair
Inversnaid	gaelicName	Inbhir Snàthaid
Muirhead	gaelicName	Ceann a' Mhonaidh
Ulva Ferry	gaelicName	Caolas Ulbha
Ecclesmachan	gaelicName	Eaglais Mhachain
Farr, Sutherland	gaelicName	Fàrr
Arnprior, Stirling	gaelicName	Earrann a' Phriair
Redgorton	gaelicName	Ràth a' Ghoirtein
Laide	gaelicName	An Leathad
Lockerbie	gaelicName	Locarbaidh
Morefield	gaelicName	A Mhór-choille
Rhue, Scotland	gaelicName	An Rubha
Resipole	gaelicName	Rèiseapol
Torwood	gaelicName	Coille Tor
Contin	gaelicName	Cunndainn
Steinish	gaelicName	Steinnis
Plasterfield	gaelicName	Raon na Crèadha
Branahuie	gaelicName	Bràigh na h-Aoidhe
Parkend, Lewis	gaelicName	Ceann nam Buailtean
Laxdale	gaelicName	Lacasdal
Holm, Lewis	gaelicName	Tolm
North Tolsta	gaelicName	Tolastadh bho Thuath
Sandwick, Lewis	gaelicName	Sanndabhaig
Strathrusdale	gaelicName	Strath Rùsdail
Strathkanaird	gaelicName	Srath Chainneart
Croy, Highland	gaelicName	Crothaigh
Glen Village	gaelicName	Clachan a' Ghlinne
Stuartfield	gaelicName	Criochaidh
Kinloch, Perth and Kinross	gaelicName	Ceann Loch
Old Rayne	gaelicName	Raon
Barrhill, South Ayrshire	gaelicName	Am Barr
Whitefarland	gaelicName	An Aoirinn
Machrie	gaelicName	Am Machaire
Moffat	gaelicName	Am Magh Fada
Ballencrieff, West Lothian	gaelicName	Baile na Craoibhe
Stoer	gaelicName	An Stòr
Uigshader	gaelicName	Ùigseadar
Lochaline	gaelicName	Loch Àlainn
Borve, Skye	gaelicName	Borbh
Borve, Barra	gaelicName	Borgh
Borve, Lewis	gaelicName	Borgh
Roshven	gaelicName	Roisbheinn
Woodside, Aberdeen	gaelicName	Taobh na Coille
Salen, Mull	gaelicName	An t-Sàilean
Newtonferry	gaelicName	Port nan Long
Strathy, Ardross	gaelicName	An t-Srathaidh
Urray	gaelicName	Urrath
Achentoul	gaelicName	Achadh an t-Sabhail
Gorstan	gaelicName	An Goirtean
Rhelonie	gaelicName	Ruigh an Lòin
Kilmarie	gaelicName	Cill Ma Ruibhe
Fivepenny	gaelicName	Na Còig Peighinnean
Kiltarlity	gaelicName	Cill Targhlain
South Dell	gaelicName	Dail-bho-Dheas
North Dell	gaelicName	Dail bho Tuath
Cross, Lewis	gaelicName	Cros
Port of Ness	gaelicName	Port Nis
Swainbost	gaelicName	Suaineabost
Crossbost	gaelicName	Crosbost/Crosabost
Eoropie	gaelicName	Eòrapaidh
Eorodale	gaelicName	Eòrodal
Knockaird	gaelicName	An Cnoc Àrd
Cromore	gaelicName	Crò Mòr
Aird Uig	gaelicName	Àird Ùig
Cliff, Lewis	gaelicName	Cliobh
Kneep	gaelicName	Cnìp
Timsgarry	gaelicName	Tuimisgearraidh
Brue	gaelicName	Brù
Newmarket, Lewis	gaelicName	An Margaidh Ùr
Newvalley, Lewis	gaelicName	An Gleann Ùr
Marybank, Lewis	gaelicName	Bruach Màiri
Heaste	gaelicName	Heasta
Lower Breakish	gaelicName	Breacais Ìosal
Scone, Perth and Kinross	gaelicName	Sgàin
Blochairn	gaelicName	Baile a' Chàirn
Portnalong	gaelicName	Port nan Long
Oban	gaelicName	An t-Òban
Aviemore	gaelicName	An Aghaidh Mhòr
Dores	gaelicName	Duras
Kincraig	gaelicName	Ceann na Creige
Moy, Highland	gaelicName	A' Mhòigh
Delny	gaelicName	Deilgnidh
Achnahanat	gaelicName	Achadh na h-Annaid
Achnahannet, Strathspey	gaelicName	Achadh na h-Annaid
Achmore, Highland	gaelicName	Acha Mòr
Ankerville	gaelicName	Cinn Dèis Bhig
Ardclach	gaelicName	Àird Chlach
Auchentoul	gaelicName	Obar Àrdair
Achnasaul	gaelicName	Achadh nan Sabhal
Ardechive	gaelicName	Àird Eachbhaidh
Allanfearn	gaelicName	An t-Àilean Feàrna
Aigas	gaelicName	Àigeis
Anancaun	gaelicName	Àth nan Ceann
Achvarasdal	gaelicName	Achadh Bhàrrasdail
Camastianavaig	gaelicName	Camas Dìonabhaig
Avielochan	gaelicName	Aghaidh an Lochain
Caolas	gaelicName	An Caolas
Ferness	gaelicName	Feàrnais
Achateny	gaelicName	Ach an Teine
Ach' An Todhair	gaelicName	Achadh an Todhair
Elgol	gaelicName	Ealaghol
Achindrean	gaelicName	Achadh an Dreaghainn
Achinduich	gaelicName	Achadh an Dabhaich
Achluachrach	gaelicName	Ach na Luachrach
Aldourie	gaelicName	Allt Dobharaidh
Allt-na-h-Airbhe	gaelicName	Allt na h-Airbhe
Alvie	gaelicName	Albhaidh
Port of Menteith	gaelicName	Port Loch Innis Mo Cholmaig
Strathyre	gaelicName	An t-Iomaire Riabhach
Auchindrean	gaelicName	Achadh an Dreaghainn
Auchtertyre	gaelicName	Uachdar Thìre
Ardmore, Easter Ross	gaelicName	An Àird Mhòr
Annat, Highland	gaelicName	An Annaid
Balmacara	gaelicName	Baile MacRath
Bunloit	gaelicName	Bun Leothaid
Bunarkaig	gaelicName	Bun Airceig
Windhill	gaelicName	Cnoc na Gaoithe
Laga, Lochaber	gaelicName	Làga
Foyers	gaelicName	Foithir
Bunchrew	gaelicName	Bun Chraoibh
Balnabruich	gaelicName	Baile na Bruaich
Corpach	gaelicName	A' Chorpaich
Grandtully	gaelicName	Gar an Tulaich
Brogaig	gaelicName	Brògaig
Balnacoil	gaelicName	Baile na Coille
Bernisdale	gaelicName	Beàrnasdal
Balnapaling	gaelicName	Baile nam Pèiling
Balmacara Square	gaelicName	Ceàrnag Bhaile Mac Carra
Balmaclellan	gaelicName	Baile MhicIllFhaolain
Invershin	gaelicName	Inbhir Sin
Inverinate	gaelicName	Inbhir Ìonaid
Inchree	gaelicName	Innis an Ruighe
Insh	gaelicName	Am Baile Ùr
Kylestrome	gaelicName	Caol Sròim
Letterfearn	gaelicName	Leitir Fheàrna
Leckmelm	gaelicName	Leac Mailm
Syre, Scotland	gaelicName	Saghair
Luib, Skye	gaelicName	Lùib
Dunnichen	gaelicName	Dùn Neachdain
Glen Shiel	gaelicName	Gleann Seile
Strathtay	gaelicName	Srath Tatha
Gorthleck	gaelicName	Goirtlig
Linsidemore	gaelicName	Lianasaid Mhòr
Letters, Wester Ross	gaelicName	An Leitir
Leirinmore	gaelicName	An Leithrinn Mhòr
Lonemore, Wester Ross	gaelicName	An Lòn Mòr
Littleferry	gaelicName	Am Port Beag
Lonemore, Sutherland	gaelicName	An Lòn Mòr
Lealt, Skye	gaelicName	An Leathallt
Feorlig	gaelicName	Feòirlig
Fiskavaig	gaelicName	Fiosgabhaig
Drumbeg, Sutherland	gaelicName	An Druim Beag
Carbost, Loch Harport	gaelicName	Carabost
Carbost, Portree	gaelicName	Càrrabost
Ormiscaig	gaelicName	Ormasgaig
Ollach	gaelicName	An t-Olach
Mellon Charles	gaelicName	Meallan Theàrlaich
Foindle	gaelicName	An Fhionndail
Fodderty	gaelicName	Fodhraitidh
Opinan, Gairloch	gaelicName	Na h-Òbaidhnean
Port Henderson	gaelicName	Portaigil
Totaig	gaelicName	Totaig
Toulvaddie	gaelicName	Toll a' Mhadaidh
Londubh	gaelicName	An Lòn Dubh
Culduie	gaelicName	Cùil Duibh
Cullicudden	gaelicName	Cùl a' Chudainn
Teangue	gaelicName	An Teanga
Lionel, Lewis	gaelicName	Lìonal
Drynoch	gaelicName	An Droighneach
Skelpick	gaelicName	Sgeilpeach
Peinachorran	gaelicName	Peighinn a' Chorrain
Trantlebeg	gaelicName	Tranntail Beag
Camore	gaelicName	An Cadha Mòr
Elphin, Highland	gaelicName	Ailbhinn
Camuscross	gaelicName	Camus Croise
Camusteel	gaelicName	Camas Teile
Dunan, Skye	gaelicName	An Dùnan
Duisky	gaelicName	Dùsgadh
Fassfern	gaelicName	An Fasadh Feàrna
Duthil	gaelicName	Daothal
Keiss	gaelicName	Cèis
Coulags	gaelicName	Na Cùileagan
Claigan	gaelicName	An Claigeann
Clachtoll	gaelicName	Clach Toll
Dalreavoch	gaelicName	An Dail Riabhach
Fasach	gaelicName	Fàsach
Corran, Lochaber	gaelicName	An Corran
Leachkin	gaelicName	Leacainn
Stein, Skye	gaelicName	Steinn
Inverfarigaig	gaelicName	Inbhir Farragaig
Culkein	gaelicName	An Cùl-cinn
Camusnagaul	gaelicName	Camas nan Gall
Camusterrach	gaelicName	Camas Tearach
Strathcarron, Highland	gaelicName	Srath Carrann
Camas Luinie	gaelicName	Camas Luinge
Catlodge	gaelicName	Caitleag
Dundonnell	gaelicName	Achadh Dà Dhòmhnaill
Carronshore	gaelicName	Bruach Charrainn
Harlosh	gaelicName	Heàrrlois
Westerdale, Highland	gaelicName	An Dail Shuas
Knockfarrel	gaelicName	Cnoc Fhearghalaigh
Kilphedir	gaelicName	Cill Pheadair
Kensaleyre	gaelicName	Ceann Sàil Eighre
Kilmonivaig	gaelicName	Cill Mo Naomhaig
Kinlocheil	gaelicName	Ceann Loch Iall
Kilmorack	gaelicName	Cill Mhòraig
Kylesku	gaelicName	An Caolas Cumhang
Kinloch Laggan	gaelicName	Ceann Loch Lagain
Kincardine, Sutherland	gaelicName	Cinn Chàrdainn
Kilvaxter	gaelicName	Cille Bhacastair
Killilan	gaelicName	Cill Fhaolain
Jamestown, Easter Ross	gaelicName	Baile Sheumais
Eynort	gaelicName	Aoineart
Erbusaig	gaelicName	Earbarsaig
Errogie	gaelicName	Earaghaidh
Balchrick	gaelicName	Baile a' Chnuic
Flodigarry	gaelicName	Flòdaigearraidh
Nedd	gaelicName	An Nead
Dalchreichart	gaelicName	Dul Chreachaird
Iochdar	gaelicName	An t-Ìochdair
Sallachy	gaelicName	Salachaidh
Inveralligin	gaelicName	Inbhir Àiliginn
Sangobeg	gaelicName	Saingea Beag
Spinningdale	gaelicName	Spainnigeadal
California, Falkirk	gaelicName	Calafornaidh
Ballifeary	gaelicName	Baile na Faire
Raddery	gaelicName	Radharaidh
Garafad	gaelicName	An Garradh Fada
Druimarben	gaelicName	Druim Earbainn
Bualintur	gaelicName	Buaile an Todhair
Balchladich	gaelicName	Baile a' Chladaich
Trantlemore	gaelicName	Tranntail Mòr
Pittentrail	gaelicName	Bad an Tràill
Galltrigill	gaelicName	Galtraigil
Dalhalvaig	gaelicName	Dail Healabhaig
Croick	gaelicName	A'Chròic
Struy	gaelicName	An t-Srùigh
Pitcalnie	gaelicName	Baile Chailnidh or Cuilt Eararaidh
Balintraid	gaelicName	Baile na Tràghad
Upper Dallachy	gaelicName	Dalachaidh Uarach
Dalnabreck	gaelicName	Dail nam Breac
Carnach	gaelicName	Càrnach
Dochgarroch	gaelicName	Dabhach Gairbheach
Drumfearn	gaelicName	An Druim Fheàrna
Dounie	gaelicName	Dùnaidh
Druimindarroch	gaelicName	Druim nan Darach
Skerray	gaelicName	Sgeirea
Fersit	gaelicName	Fearsaid Mhòr
Armadale, Sutherland	gaelicName	Armadal
Roag	gaelicName	Ròdhag
Lenie, Scotland	gaelicName	Lèanaidh
Lochslin	gaelicName	Loch Slinn
Milovaig	gaelicName	Mìolabhaig
Nostie	gaelicName	Ceann na Mòna
Muirshearlich	gaelicName	Muir Sìorlaich
Polglass	gaelicName	Am Poll Glas
Halistra	gaelicName	Halastra
Glendale, Skye	gaelicName	Gleann Dail
Kingarth	gaelicName	Ceann a' Gharaidh
Airbles	gaelicName	Na h-Earbaill
Sand, Highland	gaelicName	Sannda
Suladale	gaelicName	Sùladal
Sconser	gaelicName	Sgonnsair
Staffin	gaelicName	Stafain
Gartymore	gaelicName	Gartaidh Mòr
Etteridge	gaelicName	Eadrais
Gedintailor	gaelicName	Gead an t-Sailleir
Mountgerald	gaelicName	An Claon
Muie	gaelicName	A' Mhuigh
Mellon Udrigle	gaelicName	Meallan Ùdraigil
Swordly	gaelicName	Suardailigh
Stronchreggan	gaelicName	Sròn a' Chritheagain
Trislaig	gaelicName	Trìoslaig
Saval	gaelicName	Sàbhal
Kirkhill, Highland	gaelicName	Cnoc Mhoire
Eyre, Skye	gaelicName	Eighre
Otternish	gaelicName	Otairnis
Ardtalla	gaelicName	Àird Talla
Dunachton	gaelicName	Dùn Neachdain
Monzievaird	gaelicName	Magh Bhàird
Ardoch, Perth and Kinross	gaelicName	Àrdach
Drumuillie	gaelicName	Druim Mùillidh
Crask	gaelicName	An Crasg / A' Chrasg
Cleadale, Eigg	gaelicName	Clèadail
Gruids	gaelicName	Na Grùidean
Inverchoran	gaelicName	Inbhir Chòmhrainn
Shiel Bridge	gaelicName	Drochaid Sheile
Balnakeil	gaelicName	Baile na Cill
Morvich, Highland	gaelicName	A’ Mhormhaich
Roybridge	gaelicName	Drochaid Ruaidh
Cowie, Stirling	gaelicName	Collaidh
Throsk	gaelicName	Badan Deathach
Limerigg	gaelicName	terra cigarro
Dunmore, Falkirk	gaelicName	An Dùn Mòr
Laurieston, Falkirk	gaelicName	Baile Labhrainn
Whitecross, Falkirk	gaelicName	Fionn-Chrois
Keig	gaelicName	Mon Chaoig
Balvraid	gaelicName	Baile a' Bhràghaid
Blairmore, Sutherland	gaelicName	Am Blàr Mòr
Droman, Sutherland	gaelicName	An Droman
Kentra	gaelicName	Obar Àrdair
Rhiconich	gaelicName	An Ruigh Còinnich
Oldshore Beg	gaelicName	Àisir Beag
Altnaharra	gaelicName	Allt na h-Eirbhe
Portnancon	gaelicName	Port nan Con
Laid, Sutherland	gaelicName	An Leathad
Craigie, Perth and Kinross	gaelicName	Creagaidh
Flashader	gaelicName	Flaiseader
Uachdar	gaelicName	An t-Uachdar
John o' Groats	gaelicName	Taigh Iain Ghròt
Cumbernauld	gaelicName	Comar nan Allt
Tomchrasky	gaelicName	Tom Chrasgaidh
Toscaig	gaelicName	Toghsgaig
Oldshoremore	gaelicName	Àisir Mòr
Lothbeg	gaelicName	Loth Beag
Westfield, Highland	gaelicName	an t-Achadh Siar
Portskerra	gaelicName	Port Sgeire
Lewiston, Highland	gaelicName	Blàr na Maigh
Drumbuie	gaelicName	An Druim Buidhe
Gairlochy	gaelicName	Geàrr Lòchaidh
Burnfoot, Scottish Borders	gaelicName	Bun na h-Aibhne
Badcall, Scourie	gaelicName	Bada Call
Lynchat	gaelicName	Lainn a' Chait
Lubcroy	gaelicName	An Lùb Chruaidh
Ellishadder	gaelicName	Ealaiseadar
Fearn, Highland	gaelicName	Manachainn Rois
Grudie	gaelicName	Grùididh
Skirza	gaelicName	Sgiorsa
Torrisdale, Sutherland	gaelicName	Tòrrasdal
Tomnacross	gaelicName	Tom na Croiche
Treaslane	gaelicName	Triaslann
Coll, Lewis	gaelicName	Col
Inverkirkaig	gaelicName	Inbhir Chirceig
Invernaver	gaelicName	Inbhir Nabhair
Diabaig	gaelicName	Dìobaig
Skeabost	gaelicName	Sgeitheabost
Culburnie, Highland	gaelicName	Cùil Braonaigh
Inverroy	gaelicName	Inbhir Ruaidh
Rosehall	gaelicName	Innis nan Lìon
Resaurie	gaelicName	Ruigh Samhraidh
Rhynd	gaelicName	Rinn Dealgros
Tote, Skye	gaelicName	Tobhta
Skye of Curr	gaelicName	Sgiath Churr
Balintore, Angus	gaelicName	Baile an Todhair
Talmine, Sutherland	gaelicName	Tealamainn
Melness	gaelicName	Taobh Mhealanais
Doune, Highland	gaelicName	An Dùn
Kirkton of Glenisla	gaelicName	Clachan Ghlinn Ìle
Strathan, Sutherland	gaelicName	Srathan
Ferindonald	gaelicName	Fearann Dòmhnaill
Dowally	gaelicName	Dubhailigh
Blairingone	gaelicName	Blàr nan Con
Carnbo	gaelicName	Càrn Bò
Caputh, Perth and Kinross	gaelicName	a' Cheapaich
Salen, Ardnamurchan	gaelicName	An t-Sàilean
Badcall, Rhiconich	gaelicName	Bada Call
Daviot, Highland	gaelicName	Deimhidh
Kilmore, Skye	gaelicName	A' Chille Mhór
Kilmuir, Black Isle	gaelicName	Cille Mhoire
Kingsburgh, Skye	gaelicName	Cinnseaborgh
Farr, Strathnairn	gaelicName	Fàrr
Doll, Highland	gaelicName	An Dail
Dalnavert, Highland	gaelicName	Dail nam Feart
Coylumbridge	gaelicName	Drochaid na Cuingleum
Canisbay	gaelicName	Canasbaidh
Inverdruie	gaelicName	Inbhir Dhrùidh
Tamfourhill	gaelicName	Tom a' Phùir
Clarkston, East Renfrewshire	gaelicName	Baile Chlarc
Renfrew	gaelicName	Rinn Friù
Achnahannet, Loch Ness	gaelicName	Achadh na h-Annaid
Talisker, Skye	gaelicName	Talasgair
Lochardil	gaelicName	Loch Àrdail
Dervaig	gaelicName	Dearbhaig
South Alloa	gaelicName	Allmhagh a Deas
Greenhill, Falkirk	gaelicName	An Cnoc Gorm
Carron, Falkirk	gaelicName	Carrann
Cambusbarron	gaelicName	Camas a' Bharrain
Kilbride, Skye	gaelicName	Cille Bhrìghde
Blanefield	gaelicName	Strath Bhlàthain
Ellenabeich	gaelicName	Eilean nam Beitheach
Bridge of Tilt	gaelicName	Drochaid Theilt
Balvicar	gaelicName	Baile a' Bhiocair
Lochend	gaelicName	Ceann Loch
Hillhead	gaelicName	Ceann a' Chnuic
Craigton	gaelicName	Baile Chreig
Govan	gaelicName	Baile a' Ghobhainn
Calton	gaelicName	A' Challtainn
Partick West	gaelicName	Pàrtaig an Iar
Scotstounhill	gaelicName	Gart Sgadan/Cnoc Scotstoun
City	gaelicName	Baile Aindrea/Cathair
Anniesland	gaelicName	Druim a' Chapaill/Fearann Anna
Kelvin	gaelicName	Cnoc Mhoire/Cealbhainn
Millmannoch	gaelicName	Kilmannoch
Haugh, East Ayrshire	gaelicName	An Lianan
Kilmaluag, Skye	gaelicName	Cill Moluaig
Cambus, Clackmannanshire	gaelicName	An Camas
Deskford	gaelicName	Deasgard
Mugeary	gaelicName	Mùigearraidh
Ardoch Burn	gaelicName	Àrdach
Scaniport	gaelicName	Sganaphort
Peinlich, Skye	gaelicName	Peinlea
Pennyghael	gaelicName	Peighinn nan Gàidheal
Cranachan, Lochaber	gaelicName	Creannachan
Shettleston	gaelicName	Baile Nighean Sheadna
Kinlochard	gaelicName	Ceann Loch na h-Airde
Gartness	gaelicName	Gart an Easa
Milton, Stirling	gaelicName	Baile a' Mhuilinn
Luskentyre	gaelicName	Losgaintir
Inverarnan	gaelicName	Inbhir Àirnein
Newton, South Lanarkshire	gaelicName	Am Baile Ùr
