Detroit Red Wings	generalManager	Ken Holland
Ottawa Senators	generalManager	Pierre Dorion
Montreal Canadiens	generalManager	Marc Bergevin
New Jersey Devils	generalManager	Ray Shero
New York Rangers	generalManager	Jeff Gorton
New York Islanders	generalManager	Garth Snow
Philadelphia Flyers	generalManager	Ron Hextall
Pittsburgh Penguins	generalManager	Jim Rutherford
Boston Bruins	generalManager	Don Sweeney
Buffalo Sabres	generalManager	Tim Murray
Toronto Maple Leafs	generalManager	Lou Lamoriello
Carolina Hurricanes	generalManager	Ron Francis
Florida Panthers	generalManager	Tom Rowe
Colorado Avalanche	generalManager	Joe Sakic
Tampa Bay Lightning	generalManager	Steve Yzerman
Washington Capitals	generalManager	Brian MacLellan
Columbus Blue Jackets	generalManager	Jarmo Kekäläinen
Chicago Blackhawks	generalManager	Stan Bowman
Minnesota Wild	generalManager	Chuck Fletcher
Edmonton Oilers	generalManager	Peter Chiarelli
Dallas Stars	generalManager	Jim Nill
Anaheim Ducks	generalManager	Bob Murray
Vancouver Canucks	generalManager	Jim Benning
Los Angeles Kings	generalManager	Dean Lombardi
Arizona Coyotes	generalManager	John Chayka
Nashville Predators	generalManager	David Poile
San Jose Sharks	generalManager	Doug Wilson
Memphis Mad Dogs	generalManager	Steve Erhart
Calgary Flames	generalManager	Brad Treliving
St. Louis Blues	generalManager	Doug Armstrong
Winnipeg Jets	generalManager	Kevin Cheveldayoff
Las Vegas NHL team	generalManager	George McPhee
