Windows on the World	headChef	Michael Lomonaco
Dromoland Castle	headChef	Jean Baptiste Molinari
The French Laundry	headChef	Thomas Keller
The Fat Duck	headChef	Jonny Lake
ElBulli	headChef	Ferran Adrià
Belmond Le Manoir aux Quat'Saisons	headChef	Raymond Blanc
The Waterside Inn	headChef	Fabrice Uhryn
Gaddi's	headChef	Rémi Van Peteghem
Cactus Club Cafe	headChef	Rob Feenie
Feenie's	headChef	Rob Feenie
Caprice	headChef	Fabrice Vulin
Amber	headChef	Richard Ekkebus
Arzak	headChef	Juan Mari Arzak
Alinea	headChef	Grant Achatz
Noma	headChef	René Redzepi
Chez Dominique	headChef	Hans Välimäki
Oud Sluis	headChef	Sergio Herman
Frog and the Peach	headChef	Bruce Lefebvre
El Celler de Can Roca	headChef	Joan Roca
Napa Rose	headChef	Andrew Sutton
Allegro	headChef	Andrea Accordi
Bagatelle restaurant	headChef	Eyvind Hellstrøm
De Librije	headChef	Jonnie Boer
Akelare	headChef	Pedro Subijana
Lung King Heen	headChef	Chan Yan-tak
Joël Robuchon	headChef	Joël Robuchon
The Kitchin	headChef	Tom Kitchin
Mint	headChef	Dylan McGrath
Restaurant Patrick Guilbaud	headChef	Guillaume Lebrun
L'Ecrivain	headChef	Derry Clarke
Thornton's Restaurant	headChef	Kevin Thornton
The Ritz-Carlton, Hong Kong	headChef	Pino Lavarra
Northcote	headChef	Lisa Allen
Deanes	headChef	Simon Toye
The Ledbury	headChef	Brett Graham
L'Atelier de Joël Robuchon	headChef	Xavier Boyer
L'Atelier de Joël Robuchon	headChef	Olivier Elzer
Father's Office	headChef	Sang Yoon
Schwa	headChef	Michael Carlson
Miya's	headChef	Bun Lai
Grossi Florentino	headChef	Guy Grossi, Chris Rodriguez
Uchi	headChef	Tyson Cole
Next	headChef	Grant Achatz
Ford's Filling Station	headChef	Benjamin Ford
Per Se	headChef	Thomas Keller
La Tante Claire	headChef	Pierre Koffmann
Armstrong's Barn	headChef	Peter Robinson
Armstrong's Barn	headChef	Paolo Tullio
The House	headChef	Martijn Kajuiter
Chapter One	headChef	Ross Lewis
Bon Appétit	headChef	Oliver Dunne
Peacock Alley	headChef	Conrad Gallagher
Shiro	headChef	Kei Pilz
Shanks Restaurant	headChef	Robbie Millar
Erriseask House	headChef	Stefan Matz
Arbutus Lodge	headChef	Declan and Michael Ryan
The Oriel	headChef	Barry Smyth
Restaurant Gordon Ramsay	headChef	Clare Smyth
Roscoff Restaurant	headChef	Paul Rankin
The Russell Hotel	headChef	Pierre Rolland, Jackie Needham
Cashel Palace Hotel	headChef	Ross Lewis
't Fornuis	headChef	Johan Segers
Beluga	headChef	Hans van Wolde
Restaurant Vermeer	headChef	Christopher Naylor
Sukiyabashi Jiro	headChef	Jiro Ono
Restaurant Apicius	headChef	Thorvald de Winter
La Rive	headChef	Roger Rassin
Boreas	headChef	Nico Boreas
Excelsior	headChef	Richard Van Oostenbrugge
Da Vinci	headChef	Margo Reuten
Kaatje bij de Sluis	headChef	Peter Postma
Château Neercanne	headChef	Hans Snijders
Eleven Madison Park	headChef	Daniel Humm
The Restaurant at Meadowood	headChef	Christopher Kostow
De Bokkedoorns	headChef	Menno Post
De Leuf	headChef	Paul van de Bunt
De Nederlanden	headChef	Wilco Berends
Ciel Bleu	headChef	Onno Kokmeijer
De Echoput	headChef	Peter Paul van den Breemen , Bjorn Massop
Ron Blaauw	headChef	Ron Blaauw
De Oude Rosmolen	headChef	Constant Fonk
De Zwethheul	headChef	Mario Ridder
't Brouwerskolkje	headChef	Moshik Roth
De Leest	headChef	Jacob-Jan Boerma
De Lindenhof	headChef	Martin Kruithof
Merlet	headChef	Jonathan Zandbergen
Toine Hermsen	headChef	Toine Hermsen
L'Auberge	headChef	Emmanuel Mertens
De Kromme Watergang	headChef	Edwin Vinke
Chapeau!	headChef	Jan Sobecky
8½ Otto e Mezzo Bombana	headChef	Umberto Bombana
Chalet Royal	headChef	Gerrit Greveling
Nolet Het Reymerswale	headChef	Danny Nolet
Au Coin des Bons Enfants	headChef	George Taselaar
De Hoefslag	headChef	Karl Van Baggem
De Vlindertuin	headChef	Jilt Cazemier
De Groene Lantaarn	headChef	Jarno Eggen
De Karpendonkse Hoeve	headChef	Peter Koehn
FLIP Burger Boutique	headChef	Richard Blais
Dinner by Heston Blumenthal	headChef	Ashley Palmer-Watts
Le Mérinos d'Or	headChef	Geerhard Slenema
Herberg Onder de Linden	headChef	Geerhard Slenema
Muller	headChef	Jean-Michel Hengge
Vreugd en Rust	headChef	Henk Savelberg
Savelberg	headChef	Henk Savelberg
't Misverstant	headChef	Alexander Koene
De Acht Zaligheden	headChef	Henk van Tuyl
De Brave Hendrik	headChef	Jan Klein
La Diligence	headChef	H.W.F. Smeets
De Kastanjehof	headChef	Bruno Vittali
Koriander	headChef	Jan Gaastra
De Stenen Tafel	headChef	Raymond Prinsen
De Bokkepruik	headChef	Jaap Istha
Les Quatre Saisons	headChef	Jos P. Boomgaardt
Pok Pok	headChef	Andy Ricker
De Wanne	headChef	Gerhard Müller
Tante Koosje	headChef	Roland Veldhuijzen
Hermitage	headChef	Jan Klein
Wollerich	headChef	Gerard Wollerich
De Lindehof	headChef	Soenil Bahadoer
Het Koetshuis	headChef	Wicher Lohr
De Zwaan	headChef	Carlo Chantrel
Restaurant ML	headChef	Mark Gratama
Lai Sin's	headChef	Kwong On Wong
Sonoy	headChef	Paul van Staveren
Hof van Sonoy	headChef	Paul van Staveren
't Ganzenest	headChef	Harry Visbeen
Amaryllis	headChef	David Dempsey
De Engel	headChef	Lars Litz
Le Sapiche	headChef	Sascha Cremers
Helianthushof	headChef	Jannis Brevet
Idylle	headChef	Joop Zwiep
Onder de Boompjes	headChef	René Brienen
Het Groot Paradijs	headChef	Ferdie Dolk
Mariënhof	headChef	Jon Sistermans
De Fuik	headChef	Marco Poldervaart
De Saffraan	headChef	Kars van Wechem
Schathoes Verhildersum	headChef	Dick Soek
Avant-Garde van Groeninge	headChef	Johan van Groeninge
Yamazato	headChef	Masanori Tomikawa
Frouckje State	headChef	Gilbert van der Heide
Amarone	headChef	Gert Blom
Aubergine	headChef	Paul Pollux
Basiliek	headChef	Rik Jansma
Cour du Nord	headChef	Pieter de Ronde
Aniar	headChef	JP McMahon
Harveys	headChef	Marco Pierre White
Aubergine	headChef	Gordon Ramsay
Aubergine	headChef	William Drabble
Aubergine	headChef	Christophe Renou
Brienen aan de Maas	headChef	René Brienen
Calla's	headChef	Marcel van der Kleijn
Niven	headChef	Niven Kunz
Manresa	headChef	David Kinch
Auberge	headChef	John Halvemaan
Cheval Blanc	headChef	Huub van der Velden
Picasso	headChef	Julian Serrano
De Treeswijkhoeve	headChef	Dick Middelweerd
&samhoud places	headChef	Moshik Roth
Aan de Poel	headChef	Stefan van Sprang
Lindenhorst	headChef	Ida Kleijnen
Fäviken	headChef	Magnus Nilsson
Cordial	headChef	Joost Verhoeven
Bij Jef	headChef	Jef Schuur
De Heer Kocken	headChef	John Kocken
De Gieser Wildeman	headChef	René Tichelaar
Paul van Waarden	headChef	Paul van Waarden
De Vrienden van Jacob	headChef	Alain Alders
Fred	headChef	Fred Mustert
Katseveer	headChef	Rutger van der Weel
Osteria Francescana	headChef	Massimo Bottura
Kasteel Heemstede	headChef	André van Doorn
FG	headChef	François Geurds
Mijn Keuken	headChef	Pieter Bosters
Lakes	headChef	Erik de Boer
Central Restaurante	headChef	Virgilio Martínez Véliz
Latour	headChef	Marcel van Lier
Le Marron	headChef	Ysbrandt Wermenbol
De Moerbei	headChef	Hans de Bont
De Molen	headChef	Wouter van Laarhoven
O Mundo	headChef	Dennis Richter Uitdenbogaardt
't Nonnetje	headChef	Michel van der Kroft
Le Restaurant	headChef	Graham Mee and Jan de Wit
Gordon Ramsay at Claridge's	headChef	Mark Sargeant
Gordon Ramsay at Claridge's	headChef	Steve Allen
Verre	headChef	Angela Hartnett
Verre	headChef	Jason Atherton
Verre	headChef	Jason Whitelock
Verre	headChef	Nick Alvis
Campagne	headChef	Gareth Byrne
Posthoorn	headChef	Jeroen Bavelaar
Lady Helen Restaurant	headChef	Cormac Rowe
't Schulten Hues	headChef	Peter Gast
Valuas	headChef	Eric Swaghoven
L'Atelier de Joël Robuchon	headChef	Olivier Limousin
Union Street Café	headChef	Davide Degiovanni
Bouchon	headChef	Thomas Keller
Vinkeles	headChef	Dennis Kuipers
Bretelli	headChef	Jan Marrees
Het Jachthuis Hoog Soeren	headChef	Peter-Paul van den Breemen
Chiltern Firehouse	headChef	Nuno Mendes
Wolfslaar Restaurant	headChef	Maarten Camps
Imko's	headChef	Imko Binnerts
Tout à Fait	headChef	Bart Ausems
Soigné	headChef	Dennis Jong
Schuddebeurs	headChef	Jaap Tanis
Rôtisserie Rue du Bois	headChef	Dick Wijker
Halvemaan	headChef	John Halvemaan
Lasan	headChef	Aktar Islam
De Boterbloem	headChef	Léon Winthaegen
Vossius	headChef	Rob Kranenborg
Chez Jacques	headChef	Jacques Zeguers
Gravenmolen	headChef	Cees Gravendaal
Librije's Zusje	headChef	Sidney Schutte
Imko Binnerts	headChef	Imko Binnerts
Sublimotion	headChef	Paco Roncero
Urasawa	headChef	Hiroyuki Urasawa
Sushi Nakazawa	headChef	Daisuke Nakazawa
Quintessence	headChef	Shuzo Kishida
't Vlasbloemeken	headChef	Eric van Bochoven
Porter House New York	headChef	Michael Lomonaco
Zahav	headChef	Michael Solomonov
Blok's Restaurant	headChef	Marco Blok
The Greenhouse	headChef	Mikael Viljanen
The Man Behind The Curtain	headChef	Michael O'Hare
Loam	headChef	Enda McEvoy
Restaurant James Sommerin	headChef	James Sommerin
The Walnut Tree	headChef	Shaun Hill
Eipic	headChef	Danni Barry
Ox	headChef	Stephen Toman and Alain Kerloc'h
Olivio	headChef	Wim Zwaart
Attica	headChef	Ben Shewry
The Restaurant Marco Pierre White	headChef	Éric Chavot
The Restaurant Marco Pierre White	headChef	Robert Reid
The Restaurant Marco Pierre White	headChef	Jeff Galvin
Heron and Grey	headChef	Damien Grey
