Yeshivas Ner Yisroel	headOfSchool	Rabbi Aharon Feldman
The Albany Academy	headOfSchool	Douglas M. North
Albany Academy for Girls	headOfSchool	Douglas M. North
St. John's Preparatory School	headOfSchool	Edward P. Hardiman
Montgomery Catholic Preparatory School	headOfSchool	Thomas John Rodi
St. Joseph's Boys School	headOfSchool	Brothers of St.Patrick
Minford High School	headOfSchool	Barb Dever, Superintendent
The Miller School of Albemarle	headOfSchool	Board of Trustees
Southern High School	headOfSchool	Tony Deem, Superintendent
Eastern High School	headOfSchool	Scot Gheen, Superintendent
Miller High School	headOfSchool	Greg Holbert, Superintendent
Waverly High School	headOfSchool	Ed Dickens, Superintendent
Glenwood High School	headOfSchool	Melinda Burnside, Superintendent
Green High School	headOfSchool	Jodi ArmstrongSuperintendent
Northwest High School	headOfSchool	Ed Crabtree, Superintendent
Portsmouth West High School	headOfSchool	Jeff Stricklett, Superintendent
Valley High School	headOfSchool	Carl McCrory, Superintendent
Wheelersburg High School	headOfSchool	Mark Knapp, Superintendent
South Webster High School	headOfSchool	Marc Kreischer, Superintendent
Waterford High School	headOfSchool	Doug Baldwin, Superintendent
Frontier High School	headOfSchool	Bruce Kidder, Superintendent
Belpre High School	headOfSchool	Tony Dunn, Superintendent
Eastern High School	headOfSchool	Mr. Neil Leist, Superintendent
St. Joseph Catholic High School	headOfSchool	Pastor of St. Joseph Catholic Church, Pine Bluff, AR.
Rubyville Elementary School	headOfSchool	Anthony Mantell, Superintendent
Kabataş Erkek Lisesi	headOfSchool	Fatih Güldal
Elizabeth Moir School	headOfSchool	Elizabeth Moir
Greenup County High School	headOfSchool	Sherry Horsley, Superintendent
Curtiss-Wright Technical Institute	headOfSchool	Major C. C. Moseley
Jumeirah English Speaking School	headOfSchool	Mr. Mark Steed
First Island Montessori School	headOfSchool	Peace Nwobudu Ideozu B.Ed
First Island School	headOfSchool	Hon. Peace Ideozu B.Ed, M.Sc
