Kareem Abdul-Jabbar	highschool	Power Memorial Academy
Katie Hnida	highschool	Chatfield Senior High School
Mark Madsen	highschool	San Ramon Valley High School
Patrick Ewing	highschool	Cambridge Rindge and Latin School
Jay Berwanger	highschool	Dubuque Senior High School
Rebecca Lobo	highschool	Southwick-Tolland Regional High School
Alonzo Mourning	highschool	Indian River High School
Kareem Rush	highschool	The Pembroke Hill School
Ben Gordon	highschool	Mount Vernon High School
Darryl Dawkins	highschool	Maynard Evans High School
Michael Bradley	highschool	Burncoat High School
Brent Barry	highschool	De La Salle
Stephon Marbury	highschool	Abraham Lincoln High School
Dwayne Schintzius	highschool	Brandon High School
Detlef Schrempf	highschool	Centralia
Romeo Miller	highschool	Beverly Hills High School
Jeff Hornacek	highschool	Lyons Township High School
John Thompson	highschool	Archbishop Carroll High School
Antoine Walker	highschool	Mount Carmel High School
Sam Cassell	highschool	Paul Laurence Dunbar High School
Sam Cassell	highschool	Maine Central Institute
Darius Miles	highschool	East St. Louis Senior High School
Latrell Sprewell	highschool	Washington High School
Glenn Robinson	highschool	Theodore Roosevelt High School
Damon Stoudamire	highschool	Woodrow Wilson High School
Felipe López	highschool	Rice
Pete Dawkins	highschool	Cranbrook Schools
Rudy Ruettiger	highschool	Joliet Catholic High School
Yuta Tabuse	highschool	Noshiro Technical High School
Maceo Baston	highschool	H. Grady Spruce
Luke Jackson	highschool	Creswell
Brian Cook	highschool	Lincoln Community High School
Moses Malone	highschool	Petersburg
Pervis Ellison	highschool	Savannah High School
Eddie Jones	highschool	Blanche Ely High School
Quin Snyder	highschool	Mercer Island High School
Dan Dickau	highschool	Prairie
Robert Horry	highschool	Andalusia
David Harrison	highschool	Brentwood Academy
Dan Majerle	highschool	Central High School
Morris Peterson	highschool	Flint Northwestern High School
Josh Childress	highschool	Mayfair
Daniel Ewing	highschool	Willowridge
Raja Bell	highschool	Miami Killian
Eddie Griffin	highschool	Roman Catholic High School for Boys
Michael Stewart	highschool	John F. Kennedy High School
John Edwards	highschool	Hudson
Lindsey Hunter	highschool	Murrah
Dick Groat	highschool	Swissvale
P. J. Carlesimo	highschool	Scranton Preparatory School
Paul Shirley	highschool	Jefferson West
Kevin Pittsnogle	highschool	Martinsburg High School
Rex Chapman	highschool	Apollo
Michael Sweetney	highschool	Oxon Hill
Rashad McCants	highschool	Erwin
Rashad McCants	highschool	New Hampton School
Robert Swift	highschool	*
Robert Swift	highschool	Garces Memorial High School
Robert Swift	highschool	*Bakersfield
Vinnie Johnson	highschool	Franklin Delano Roosevelt High School
Greg Ostertag	highschool	Duncanville
Justin Reed	highschool	Provine High School
Kara Wolters	highschool	Holliston High School
David Vanterpool	highschool	Montgomery Blair High School
Steve Jones	highschool	Franklin
Erik Daniels	highschool	Princeton High School, Sharonville, Ohio
Deron Williams	highschool	The Colony
Juan Mendez	highschool	Florida Air Academy
Gerald Green	highschool	Gulf Shores Academy
Loy Vaught	highschool	East Kentwood High School
Frank Williams	highschool	Manual High School
Robert Traylor	highschool	Murray-Wright High School
Joey Graham	highschool	Brandon
Julius Hodge	highschool	St. Raymond
Salim Stoudamire	highschool	Lincoln High School
Salim Stoudamire	highschool	Lake Oswego High School
Tamar Slay	highschool	Woodrow Wilson High School
Jeff Sheppard	highschool	McIntosh
DerMarr Johnson	highschool	Maine Central Institute
Hank Gathers	highschool	Murrell Dobbins Vocational School
Dwayne Washington	highschool	Boys and Girls High School
Shavlik Randolph	highschool	Needham B. Broughton High School
Walter McCarty	highschool	William Henry Harrison High School
Keith McLeod	highschool	Canton McKinley High School
Jack Sikma	highschool	Saint Anne
Darvin Ham	highschool	Saginaw High School
Jake Voskuhl	highschool	Strake Jesuit College Preparatory
Bo Outlaw	highschool	John Jay High School
Othella Harrington	highschool	Murrah High School
Shane Heal	highschool	Upper Yarra Secondary College
Mark Pope	highschool	Newport
Loren Woods	highschool	Cardinal Ritter College Prep High School
Chris Taft	highschool	Xaverian High School
Michael Ruffin	highschool	Cherry Creek High School
Calvin Booth	highschool	Groveport Madison High School
Erick Strickland	highschool	Bellevue West
Alex Acker	highschool	Eisenhower
Bob Sura	highschool	G. A. R. Memorial Junior Senior High School
Stromile Swift	highschool	Fair Park Medical Careers Magnet High School
Austin Croshere	highschool	Crossroads School
Scot Pollard	highschool	*Torrey Pines \n*Kamiakin
Jacque Vaughn	highschool	John Muir
Billy Thomas	highschool	Loyola College Prep
Melvin Ely	highschool	Thornton Township High School
Bernard Robinson	highschool	Dunbar High School
Brevin Knight	highschool	Seton Hall Preparatory School
Chris Mihm	highschool	Westlake
Linas Kleiza	highschool	Montrose Christian School
Dajuan Wagner	highschool	Camden High School
Jackie Butler	highschool	McComb High School
Jackie Butler	highschool	Laurinburg Institute
Jackie Butler	highschool	Coastal Christian Academy
Lee Nailon	highschool	Clay High School
Jackson Vroman	highschool	Viewmont
Casey Jacobsen	highschool	Glendora High School
P. J. Brown	highschool	Winnfield
Deng Gai	highschool	Milford Academy
Ha Seung-jin	highschool	Samil Commercial
Richie Frahm	highschool	Battle Ground High School
Ruben Patterson	highschool	John Hay High School
Mikki Moore	highschool	Blacksburg
Scott Padgett	highschool	St. Xavier High School
Michael Dickerson	highschool	Federal Way High School
Sandy Stephens	highschool	Uniontown Area High School
Trajan Langdon	highschool	East Anchorage High School
Tony Bobbitt	highschool	Mainland High School
Howard Eisley	highschool	Southwestern High School
Doc Blanchard	highschool	Saint Stanislaus College
Scott Sellers	highschool	Cinco Ranch High School
Dennis Scott	highschool	Flint Hill
Mitchell Butler	highschool	Oakwood School, Los Angeles
Mo Williams	highschool	Murrah High School
Tim James	highschool	Miami Northwestern High School
Dee Brown	highschool	Bolles School
Ralph Jackson	highschool	Inglewood
Shelden Williams	highschool	Midwest City High School
Hersey Hawkins	highschool	George Westinghouse College Prep
Jud Buechler	highschool	Poway
Larry Smith	highschool	Simmons
Heather Burge	highschool	Palos Verdes High School
Heidi Burge	highschool	Palos Verdes High School
Scott Brooks	highschool	East Union
Sharrod Ford	highschool	Gwynn Park High School
Sharrod Ford	highschool	Hargrave
James Thomas	highschool	Hargrave Military Academy
Devin Green	highschool	Beechcroft High School
Zendon Hamilton	highschool	Sewanhaka High School
Terence Morris	highschool	Governor Thomas Johnson High School
Awvee Storey	highschool	Proviso West
Gerard Phelan	highschool	Archbishop John Carroll High School
Roger Brown	highschool	George W. Wingate High School
Phil Ford	highschool	Rocky Mount Senior High School
Dick Kazmaier	highschool	Maumee High School
Clint Frank	highschool	Evanston Township High School
Jeff Trepagnier	highschool	Compton
Anthony Mason	highschool	Springfield Gardens High School
Wendell Ladner	highschool	Hancock North Central High School
Joe Cowan	highschool	St. John Bosco High School
Lanard Copeland	highschool	Washington High School
Morley Drury	highschool	Long Beach Polytechnic High School
Sean Dockery	highschool	Julian High School
Andrew Vlahov	highschool	Kent Street Senior High School
Andrew Vlahov	highschool	South Eugene
Alan Ogg	highschool	Gardendale
Carlos Alvarez	highschool	North Miami Senior High School
Elena Delle Donne	highschool	Ursuline Academy
Joe Roth	highschool	Granite Hills High School
Paul Davis	highschool	Rochester High School
Denham Brown	highschool	West Hill Collegiate Institute
Korleone Young	highschool	Wichita High School East
Korleone Young	highschool	Hargrave Military Academy
Armen Gilliam	highschool	Bethel Park High School
Sean Singletary	highschool	William Penn Charter School
Chris Smelley	highschool	American Christian Academy
Chris Smelley	highschool	Tuscaloosa, Alabama
Vincent Yarbrough	highschool	Cleveland High School
Michael Hawkins	highschool	Canton McKinley High School
Hassan Adams	highschool	Westchester
Mike Gansey	highschool	Olmsted Falls High School
Fernando Martín Espina	highschool	Estudiantes, Madrid, Spain
John MacLeod	highschool	Providence
Dillon Boucher	highschool	Papatoetoe
Jack Trice	highschool	East Technical High School
George Irvine	highschool	Ballard High School
Mike Wilks	highschool	Rufus King High School
Randy Ayers	highschool	North High School
Kirk Penney	highschool	Westlake Boys High School
Mike Novak	highschool	Tilden High School
Alando Tucker	highschool	Lockport Township High School
Scoonie Penn	highschool	Salem
Jonathan Wallace	highschool	Sparkman
Ronnie Price	highschool	Clear Brook High School
Anthony Roberson	highschool	Saginaw High School
Lorenzo Charles	highschool	Brooklyn Technical High School
Bob Netolicky	highschool	Washington
Sasha Kaun	highschool	Florida Air Academy
Richard Roby	highschool	Lawrence Academy at Groton
Darius Washington, Jr.	highschool	Edgewater
Curtis Stinson	highschool	Winchendon Prep
Ernie Grunfeld	highschool	Forest Hills
Jérôme Moïso	highschool	Milford Academy
Carlos Powell	highschool	Wilson High School
Noel Felix	highschool	Inglewood
Chris Owens	highschool	Duncanville
Dre Barnes	highschool	Irwin County High School
Mario Austin	highschool	Sumter County
Paul Harris	highschool	Niagara Falls High School
Paul Harris	highschool	Notre Dame Preparatory School
Jelani McCoy	highschool	St. Augustine High School
Tim Young	highschool	Harbor High School
Steve Burtt Sr.	highschool	Charles Evans Hughes High School
Antonio Lang	highschool	LeFlore
Joe Courtney	highschool	Callaway High School
Dick Snyder	highschool	Hoover High School
Keith Jennings	highschool	Culpeper County High School
Donatas Zavackas	highschool	St. Vincent – St. Mary High School
Keith Closs	highschool	Sierra Vista High School
Lance Thomas	highschool	Scotch Plains-Fanwood High School
Lance Thomas	highschool	Saint Benedict's Preparatory School
Michael Batiste	highschool	Wilson Classical High School
J. R. Sakuragi	highschool	East Bakersfield High School
Kenny Payne	highschool	Jones County School District
Avery Johnson	highschool	St. Augustine High School
Billy Knight	highschool	Braddock High School
Alvin Jones	highschool	Kathleen
Shawne Williams	highschool	Laurinburg Institute
Shawntinice Polk	highschool	Hanford High School
Ryan Stack	highschool	Cheatham County
David Noel	highschool	Southern High School
Will Solomon	highschool	East Hartford High School
Tito Horford	highschool	Marian Christian
Michael Ansley	highschool	Jackson-Olin High School
Conrad McRae	highschool	Brooklyn Technical High School
Kris Clack	highschool	Anderson High School
Barry Sumpter	highschool	Lovejoy
Jitim Young	highschool	Gordon Technical High School
Alton Lister	highschool	Woodrow Wilson High School
Alexander Johnson	highschool	Dougherty Comprehensive High School
Guillermo Diaz	highschool	Miami Christian
Mike Penberthy	highschool	Herbert Hoover High School
Michael Curry	highschool	Glenn Hills
Randy Allen	highschool	Milton High School
Monty Williams	highschool	Potomac
Keith Tower	highschool	Moon
Reggie Jordan	highschool	Proviso East High School
Ralph Mims	highschool	Brunswick
Jerome Beasley	highschool	Moreno Valley High School
C. J. Sanders	highschool	Notre Dame High School
Tyrone Prothro	highschool	Cleburne County High School
Tyrone Prothro	highschool	Heflin, Alabama
Romain Sato	highschool	Dayton Christian
Gene Banks	highschool	West Philadelphia High School
Ansu Sesay	highschool	Willowridge
Predrag Savović	highschool	Ivan Goran Kovacic
John Fitzgerald	highschool	Putnam City North High School
Bobby Grayson	highschool	Jefferson High School
Antonio Harvey	highschool	Pascagoula High School
Abe Mickal	highschool	McComb High School
Jac Weller	highschool	The Hun School
Rimantas Kaukėnas	highschool	Prattsburgh Central School
Joe Vogel	highschool	North Platte High School
Chris Rix	highschool	Santa Margarita Catholic High School
Vic Bartolome	highschool	Santa Barbara High School
Ron Settles	highschool	Banning High School
Geoff Price	highschool	Colleyville Heritage High School
Geoff Price	highschool	Colleyville, Texas
Ed Elisma	highschool	LaSalle
Charles Lee	highschool	Quince Orchard High School
Jay Guidinger	highschool	Dominican
Lari Ketner	highschool	Roman Catholic High School
Lorenzo Williams	highschool	Forest High School
Kyle Singler	highschool	South Medford High School
Roger Powell	highschool	Joliet West High School
Willie Farley	highschool	*Orr Academy \n*Farragut Academy
Gene Vance	highschool	Clinton High School
Blake Schilb	highschool	Brewster Academy
Brandon Cox	highschool	Hewitt-Trussville High School
Brandon Cox	highschool	Trussville, Alabama
Ronnie Fields	highschool	Farragut Academy
Nick Fazekas	highschool	Ralston Valley High School
Desmon Farmer	highschool	Flint Northwestern High School
Jason White	highschool	Tuttle High School
Leon Smith	highschool	Martin Luther King High School
Curly Neal	highschool	James B. Dudley High School
James Lang	highschool	Central Park Christian
Robby Stevenson	highschool	Manatee High School
Blake Hoffarber	highschool	Hopkins High School
Casey Dick	highschool	Allen High School
Casey Dick	highschool	Allen, Texas
Terry Davis	highschool	Halifax County High School
Dwayne Morton	highschool	Central High School
Alley Broussard	highschool	Acadiana High School
Steve Logan	highschool	St. Edward
Jimmy Hitchcock	highschool	Union Springs
Blake Ahearn	highschool	De Smet Jesuit High School
Grant Billmeier	highschool	St. Patrick High School
Grant Billmeier	highschool	Elizabeth, New Jersey
Yen Hsing-su	highschool	Private Nanshan Senior High School , Taipei County, Taiwan
Drew Neitzel	highschool	Wyoming Park
James Street	highschool	Longview High School
Jamelle Holieway	highschool	Phineas Banning High School
Jamelle Holieway	highschool	Wilmington, California
Marty Tadman	highschool	Mission Viejo High School
Marty Tadman	highschool	Mission Viejo, CA
Akin Akingbala	highschool	Brunswick School
Tony Smith	highschool	Wauwatosa East High School
Jeffrey Jordan	highschool	Loyola Academy
Jeffrey Jordan	highschool	Wilmette, Illinois
T. A. McLendon	highschool	Albemarle High School
T. A. McLendon	highschool	Albemarle, NC
Fred Roberts	highschool	Bingham
Justin Williams	highschool	Thornwood
Cassie Hager	highschool	Perry High School
Rick Mount	highschool	Lebanon Senior High School
Nate Driggers	highschool	Corliss High School
Sean Williams	highschool	Mansfield
Derrick Dial	highschool	Cass Technical High School
Harvey Marlatt	highschool	Alpena
Britton Johnsen	highschool	Murray
Jeremy Richardson	highschool	Zachary
Bob Ford	highschool	North High School
Eugene Parker	highschool	Concordia Lutheran High School
Folarin Campbell	highschool	Springbrook High School
Curtis Sumpter	highschool	Bishop Loughlin Memorial High School
Tora Harris	highschool	South Atlanta High School
Ryan Reynolds	highschool	Bishop Gorman High School
Lorinza Harrington	highschool	Scotland County
Mel McCants	highschool	Mt. Carmel High School
Jim Rowinski	highschool	Syosset
Joseph Jones	highschool	Normangee High School
Rob Pelinka	highschool	Lake Forest High School
Rob Pelinka	highschool	Lake Forest, Illinois
Mason Rocca	highschool	Evanston Township High School
Kyle Killion	highschool	Kingwood High School
Derrick Byars	highschool	Ridgeway High School
Bobby Parks	highschool	Middleton
Ron Lewis	highschool	Brookhaven
George King	highschool	Stonewall Jackson High School
Lodrick Stewart	highschool	Rainier Beach
John Dewberry	highschool	Milton High School
Jared Jordan	highschool	Kingswood-Oxford School
David Kool	highschool	South Christian High School
Russell Robinson	highschool	Rice
Jon Diebler	highschool	Upper Sandusky High School
Steve Hawes	highschool	Mercer Island High School
Spencer Nelson	highschool	Pocatello High School
Lusia Harris	highschool	Amanda Elzy
Jamaal Tatum	highschool	Helias High School
Herbert Hill	highschool	Kinston
Joe Crispin	highschool	Pitman High School
Damion James	highschool	Nacogdoches
Liz Heaston	highschool	Richland High School
Brandon Costner	highschool	Seton Hall Preparatory School
Matt Othick	highschool	Bishop Gorman
Skeeter Henry	highschool	South Grand Prairie High School
Sherron Collins	highschool	Crane High School
Adam Shada	highschool	Millard North High School
Adam Shada	highschool	Omaha, Nebraska
Brian Lynch	highschool	Christian Brothers Academy
Clifton McNeely	highschool	Slidell
Greivis Vásquez	highschool	Montrose Christian School
Rod Benson	highschool	Torrey Pines High School
Preston Knowles	highschool	George Rogers Clark High School
Mark Strickland	highschool	McNair High School
Nate Reinking	highschool	Galion
Corey Stokes	highschool	Saint Benedict's Preparatory School
Deron Washington	highschool	National Christian Academy
Gary Collier	highschool	Paul Laurence Dunbar High School
Jonathan Rodriguez	highschool	Calusa Preparatory
Jeremy McNeil	highschool	Sam Houston
Matt Gorman	highschool	Watertown
Terrence Roberts	highschool	St. Anthony
Darryl Watkins	highschool	Paterson Catholic High School
Kueth Duany	highschool	Bloomington High School North
Mert Shumpert	highschool	Fort Walton Beach High School
Ibrahim Jaaber	highschool	Elizabeth High School
Chase Pittman	highschool	Evangel Christian Academy
Alex Trlica	highschool	Friendswood High School
Allyssa DeHaan	highschool	Grandville High School
Brian Martin	highschool	Northwest
Mark Dickel	highschool	Logan Park
Tanoka Beard	highschool	Bonneville High School
Jimmy Foster	highschool	Hoboken
Beatrice Bofia	highschool	Naperville Central High School
Beatrice Bofia	highschool	Naperville, Illinois
Suzy Bofia	highschool	Naperville Central High School
Suzy Bofia	highschool	Naperville, Illinois, USA
Fly Williams	highschool	Glen Springs Academy
Brian Howard	highschool	North Forsyth High School
Mark Wade	highschool	Banning
Jeff Varem	highschool	Buffalo Traditional School
Ike Nwankwo	highschool	Cypress Creek High School
Larry Miller	highschool	Catasauqua High School
JamesOn Curry	highschool	Eastern Alamance High School
JaRon Rush	highschool	The Pembroke Hill School
Reyshawn Terry	highschool	Richard J. Reynolds High School
Marcus Slaughter	highschool	J. W. North
Tony Dawson	highschool	Kinston High School
Jack Crain	highschool	Nocona High School
Alex Stepheson	highschool	Harvard-Westlake School
Michael Henig	highschool	Jefferson Davis High School
Michael Henig	highschool	Montgomery, Alabama
Antonio Bass	highschool	Jackson High School
Antonio Bass	highschool	Jackson, Michigan
Seth Adams	highschool	Marshall Academy
Seth Adams	highschool	Holly Springs, Mississippi
Kostas Charissis	highschool	Bachiltzanaki, Piraeus, Greece
K'zell Wesson	highschool	Jefferson High School
Hunter Carpenter	highschool	Alleghany High School
Doc Fenton	highschool	Scranton High School
Buck Flowers	highschool	Sumter High School
Ed Hart	highschool	Phillips Exeter Academy
Kyle Hill	highschool	Argo
Dennis Nutt	highschool	Little Rock Central High School
Jason Sasser	highschool	Justin F. Kimball
Hunter Scarlett	highschool	Erie
Fred Sington	highschool	Birmingham City Schools
Randolph Mahaffey	highschool	LaGrange High School
Skip Thoren	highschool	Rockford East High School
Everett Strupper	highschool	Riverside Military Academy
Dale Van Sickel	highschool	Gainesville High School
John Kuester	highschool	Benedictine High School
Whitey Wistert	highschool	Schurz High School
Mike Klinkenborg	highschool	Central Lyon HS,
Mike Klinkenborg	highschool	Rock Rapids, Iowa
Mike Klinkenborg	highschool	Iowa
Tom Huiskens	highschool	Bay City Central High School
Jai Lucas	highschool	Bellaire High School
Larry Turner	highschool	Baldwin High School
Larry Turner	highschool	Bridgton Academy
Jeremiah Massey	highschool	Mackenzie High School
Heath Benedict	highschool	Peddie School
Heath Benedict	highschool	Hightstown, New Jersey
Roger Burkman	highschool	Franklin Central High School
Jermie Calhoun	highschool	Van High School
Jermie Calhoun	highschool	Van, Texas
Mo Charlo	highschool	Eureka High School
Earl Jones	highschool	Spingarn
Divya Singh	highschool	RMKBI, Varanasi
Andre Patterson	highschool	Washington Prep High School
Derrick Obasohan	highschool	Alief Elsik High School
Aaron Swinson	highschool	Brunswick High School
Shea Morenz	highschool	Central High School
Shea Morenz	highschool	San Angelo, Texas
Walter Hodge	highschool	Florida Air Academy
Sharaud Curry	highschool	Joseph Wheeler High School
George Lehmann	highschool	Camden Catholic High School
Kenny Gregory	highschool	Independence High School
Mario West	highschool	Douglas County High School
Parfait Bitee	highschool	Western
Marc Salyers	highschool	Apollo
Darren Phillip	highschool	South Shore
Valdas Vasylius	highschool	Norfolk Collegiate School
Choi Jin-soo	highschool	South Kent School
Choi Jin-soo	highschool	Montclair College Preparatory School
Thomas Gardner	highschool	Jefferson High School
T. J. Jordan	highschool	Woodrow Wilson High School
Idong Ibok	highschool	Montverde Academy
Ousmane Barro	highschool	Julian
Jimmy Rayl	highschool	Kokomo High School
Chris Hutchinson	highschool	Cypress Creek High School
Damion Fletcher	highschool	Biloxi High School
Damion Fletcher	highschool	Biloxi, Mississippi
Justin Anderson	highschool	Steinmetz High School
Mike Boren	highschool	Eastmoor Academy
Jai Miller	highschool	Selma High School
Ed Stefanski	highschool	Monsignor Bonner High School
Ajou Deng	highschool	St. Thomas More Prep
Terry Andrysiak	highschool	Cabrini High School, Allen Park
Terry Andrysiak	highschool	Allen Park, Michigan
Rick Slager	highschool	Upper Arlington High School
Mike Courey	highschool	Bishop Heelan Catholic High School
Trey Johnson	highschool	Murrah High School
Michael Muñoz	highschool	Moeller High School
Wayne Englestad	highschool	Don Bosco Technical Institute
Glenn Roberts	highschool	Pound
Jim Brady	highschool	Pocatello High School
Chris Summers	highschool	Hamilton Southeastern High School
Gary Forbes	highschool	Benjamin Banneker Academy
David Padgett	highschool	Reno High School
Juan Palacios	highschool	Our Saviour New American
Shawnta Rogers	highschool	Lake Clifton High School
Russell Carter	highschool	Paulsboro High School
Gene Harmon	highschool	Schuyler Central
Kevin Riley	highschool	Beaverton High School
Kevin Riley	highschool	Portland, Oregon
Brad Cochran	highschool	Brother Rice High School
Brad Cochran	highschool	Birmingham, MI
Amir Pinnix	highschool	Malcolm X Shabazz High School,Newark, New Jersey
Shan Foster	highschool	Bonnabel
Kevin Richardson	highschool	East Bladen High School
Stanfield Wells	highschool	Massillon Washington High School
Branden Ore	highschool	Indian River High School,Chesapeake, Virginia
Bill Cowden	highschool	Lowell High School
Carlos Morais	highschool	Community Christian School
Willis Ward	highschool	Northwestern High School
Da'Love Woods	highschool	St. Mary's Academy
Wesley Carroll	highschool	St. Thomas Aquinas High School
Wesley Carroll	highschool	Fort Lauderdale, Florida
Tommy Banks	highschool	West Monroe High School
Larry Abney	highschool	Nyack High School
Nolan Smith	highschool	Oak Hill Academy
Jermaine Anderson	highschool	Eastern Commerce Collegiate Institute
Marijonas Petravičius	highschool	New Hampton School
Derek Raivio	highschool	Mountain View High School
Chuck Eidson	highschool	Pinewood Preparatory School
Jahkeen Gilmore	highschool	Poly Prep Country Day School
Bret Stafford	highschool	Belton High School
Bret Stafford	highschool	Temple High School
Behdad Sami	highschool	Southridge High School
Adam Emmenecker	highschool	Arthur Hill High School
Daryll Hill	highschool	Benjamin N. Cardozo High School
Daryll Hill	highschool	Milford Academy
Lance Allred	highschool	East High School
Riley Dodge	highschool	Carroll High School
Riley Dodge	highschool	Southlake, Texas
Tom Sewell	highschool	Booker T. Washington High School
A. J. Abrams	highschool	McNeil
Kevin Magee	highschool	South Pike
Josh Carter	highschool	Lake Highlands High School
Dewarick Spencer	highschool	Baker
Charles Brewer	highschool	Lubbock High School
Joseph Blair	highschool	C.E. King
Rashard Griffith	highschool	King College Prep High School
Jemeil Rich	highschool	Theodore Roosevelt High School
Dan Werner	highschool	Christian Brothers Academy
Rahshon Turner	highschool	Passaic High School
Kasib Powell	highschool	Teaneck High School
Reggie Campbell	highschool	Lake Mary High School
Zabian Dowdell	highschool	Pahokee High School
Bobby Lackey	highschool	Weslaco High School
Mike Cotten	highschool	Austin High School
Johnny Genung	highschool	Wichita Falls High School
Duke Carlisle	highschool	Athens High School
Tomas Ress	highschool	Champagnat Catholic School
Jason Keep	highschool	Pullman High School
Jason Keep	highschool	Moscow
Mire Chatman	highschool	South Garland High School
Angie Bjorklund	highschool	University High School
Cole Aldrich	highschool	Bloomington Jefferson High School
Gene Cross	highschool	Rich Central
Osiris Eldridge	highschool	Wendell Phillips Academy High School
Peter Cornell	highschool	Piedmont High School
JaJuan Smith	highschool	McMinn County High School
Eshaunte Jones	highschool	North Side High School
Eshaunte Jones	highschool	Fort Wayne, IN
Buster Matheney	highschool	Bell High School
Ed Turner	highschool	East High School
Sean Tuohy	highschool	Isidore Newman School
Curtis Millage	highschool	Manual Arts High School
Rob Preston	highschool	Lynchburg-Clay
Mel Thomas	highschool	Mount Notre Dame High School
Mel Thomas	highschool	Cincinnati, Ohio
Eric Devendorf	highschool	Oak Hill Academy
Sitapha Savané	highschool	United Nations International School
Jim Mabry	highschool	Briarcrest Christian School
DeVon Hardin	highschool	Newark Memorial High School
Ed O'Bannon	highschool	Artesia
Walter Jordan	highschool	Northrop
Boban Savović	highschool	East Side
Ahmad Nivins	highschool	St. Anthony High School
Walter Sharpe	highschool	Parker
Derrick Jasper	highschool	Paso Robles High School
Derrick Jasper	highschool	Paso Robles, California
Alexis Wangmene	highschool	Central Catholic Marianist High School
Alexis Wangmene	highschool	Blair Academy
Brittney Griner	highschool	Nimitz High School
Tim Burroughs	highschool	Lower Richland High School
Ilian Evtimov	highschool	Bishop McGuinness Catholic High School
Joe Allison	highschool	American
Dwayne Mitchell	highschool	John F. Kennedy High School
Wesley Johnson	highschool	Corsicana High School
Gerald Tucker	highschool	Winfield
Craig Callahan	highschool	Cascade
Jamal Abu-Shamala	highschool	Shakopee High School
Bart Tanski	highschool	Mentor High School
Bart Tanski	highschool	Mentor, Ohio
Mookie Jones	highschool	Peekskill High School
Brandon Heath	highschool	Westchester High School
C. J. Giles	highschool	Rainier Beach High School
Chris Todd	highschool	Elizabethtown High School
Chris Todd	highschool	Elizabethtown, Kentucky
Al-Farouq Aminu	highschool	Norcross
Melvin Newbern	highschool	Scott High School
John Linehan	highschool	Chester High School
John Linehan	highschool	Winchendon
Cody Toppert	highschool	Albuquerque Academy
Dennis Mims	highschool	Freedom High School
Eddie Lucas	highschool	Redlands
Cameron Higgins	highschool	Saint Louis School
Steven Hill	highschool	Branson
Eric Obeysekere	highschool	Miramonte High School
Charles Judson Wallace	highschool	The Westminster Schools
John Faiman	highschool	Omaha South High School
Wayne Chism	highschool	Bolivar Central High School
Steve Francis	highschool	Montgomery Blair High School
Shea Ralph	highschool	Terry Sanford High School
David Logan	highschool	North Central High School
Markus Carr	highschool	Palmdale
Phill Jones	highschool	Inangahua College
Phill Jones	highschool	Nelson College
Rylan Reed	highschool	Crossett High School
Rylan Reed	highschool	Crossett, Arkansas
Graham Zug	highschool	Manheim Central
Graham Zug	highschool	Manheim, Pennsylvania
Brett Winkelman	highschool	Morris Area
Chuck Hartlieb	highschool	Marian Central Catholic High School
Chuck Hartlieb	highschool	Woodstock, Illinois
Eric Boateng	highschool	St. Andrew's School
DeShawn Sims	highschool	Pershing High School
Darrin Govens	highschool	Chester High School
Terrence Oglesby	highschool	Bradley Central High School
Pete Trgovich	highschool	Washington High School
Samardo Samuels	highschool	Saint Benedict's Preparatory School
Robert Vaden	highschool	Cathedral High School
Robert Vaden	highschool	Pike High School
Robert Vaden	highschool	Bridgton Academy
Will Thomas	highschool	Mount Saint Joseph High School
Robbie Hummel	highschool	Valparaiso High School
Shea Smith	highschool	Permian High School
Shea Smith	highschool	Odessa, Texas
Joevan Catron	highschool	Thornton Township
David Johnson	highschool	Southridge High School
David Johnson	highschool	Beaverton, Oregon
Kris Lang	highschool	Hunter Huss High School
Kristen Newlin	highschool	Riverton
Danny Oquendo	highschool	Hackensack High School
Danny Oquendo	highschool	Hackensack, NJ
Ronnie Tyler	highschool	Wagener Salley High School
Ronnie Tyler	highschool	Wagener, SC
Ronnie Tyler	highschool	Hargrave Military Academy
Ronnie Tyler	highschool	Chatham, VA
Mikell Simpson	highschool	Harrisburg High School
Chip Bowden	highschool	Durant High School
Chip Bowden	highschool	United States Military Academy Preparatory School
Jaime Mendez	highschool	Cardinal Mooney High School
Aaron Miles	highschool	Jefferson High School
Marcus Hall	highschool	Jersey Village High School
Morgan Green	highschool	Henry E. Lackey High School
Jimmy McNatt	highschool	Norman
Jermaine Bucknor	highschool	Ross Sheppard High School
Lawrence Westbrook	highschool	Chandler
Lawrence Westbrook	highschool	The Winchendon School
Dante Love	highschool	Withrow High School
Damian Johnson	highschool	Thibodaux High School
Larry Sanders	highschool	Port St. Lucie High School
Aleks Marić	highschool	Life Center Academy
Ryan Pettinella	highschool	McQuaid Jesuit High School
Maurice Acker	highschool	Hillcrest High School
Patrick Sanders	highschool	Orange
Willie Warren	highschool	North Crowley
Lance Stephenson	highschool	Abraham Lincoln High School
Craig Brackins	highschool	Brewster Academy
Evan Turner	highschool	St. Joseph
Jack McClinton	highschool	Calvert Hall College High School
Jack McClinton	highschool	South Kent School
James Eayrs	highschool	Roseville Area High School
Odell Hodge	highschool	Laurel Park
Xavier Henry	highschool	Putnam City High School
Jimmy Butler	highschool	Tomball
Jack Michael Martínez	highschool	Artesia
Sean Denison	highschool	L V Rogers Secondary School
Ed Davis	highschool	*Hanover \n*Benedictine
JaJuan Johnson	highschool	Franklin Central High School
Steve Smith	highschool	Grand Blanc Community High School
Jaraan Cornell	highschool	Clay High School
Jim Brandstatter	highschool	East Lansing, Michigan
Marc Egerson	highschool	Glasgow
Bob Warren	highschool	South Marshall
Josh Shipp	highschool	Fairfax High School
Lee Cummard	highschool	Mesa High School
Trinton Sturdivant	highschool	Anson High School
John Wall	highschool	Garner Magnet High School
John Wall	highschool	Word of God Christian Academy
Stacy Hansmeyer	highschool	Norman High School
Jeremy Boone	highschool	Mechanicsburg Area Senior High School
Jeremy Boone	highschool	Mechanicsburg, Pennsylvania
Abby Waner	highschool	ThunderRidge High School
C. J. Henry	highschool	Putnam City High School
Mack Supronowicz	highschool	Schenectady High School
Brandon Maye	highschool	Davidson High School
Brandon Knight	highschool	Pine Crest
Lauren Lueders	highschool	Saxony Lutheran,
Lauren Lueders	highschool	Jackson, Missouri
Harold White	highschool	DeWitt Clinton High School
Brett Benzio	highschool	Jensen Beach,
Brett Benzio	highschool	Palm City, Florida
Erika Valek	highschool	Coronado
Chris Marve	highschool	White Station High School
Chris Marve	highschool	Memphis, Tennessee
Harrison Barnes	highschool	Ames High School
Brandon Bryant	highschool	Rosa Fort High School
Tyshawn Taylor	highschool	St. Anthony
Joe Colone	highschool	Berwick Area Senior High School
Chris Hall	highschool	Irving High School
Chris Hall	highschool	Irving, Texas
Donold Lourie	highschool	LaSalle-Peru High School
Donold Lourie	highschool	Phillips Exeter Academy
Thomas Kelati	highschool	Walla Walla High School
Billy Shepherd	highschool	Carmel
Moran Roth	highschool	Kiryat Sharet Holon
Krista Phillips	highschool	Aden Bowman Collegiate
Seth Doliboa	highschool	Springboro High School
Trevor Booker	highschool	Union County
Skylar Diggins	highschool	Washington High School
Mychal Sisson	highschool	Duncanville High School
Mychal Sisson	highschool	Duncanville, Texas
Kerry Murphy	highschool	Hoover High School
Jonathan Rush	highschool	Killeen High School
Jonathan Rush	highschool	Killeen, Texas
Ian O'Boyle	highschool	Patrician Secondary School
Ian O'Boyle	highschool	Trinity-Pawling School
Jay Larrañaga	highschool	St. John's Jesuit High School and Academy
Ater Majok	highschool	American International School of Sydney
Michael Kidd-Gilchrist	highschool	St. Patrick
Jonathan Kale	highschool	St. Andrew's School
Patrick Bouli	highschool	Massanutten Military Academy
Charles Abouo	highschool	Logan High School
Charles Abouo	highschool	Brewster Academy
Perry Jones	highschool	Duncanville
Martín Osimani	highschool	Champagnat Catholic School
Gyno Pomare	highschool	El Camino High School
Tyler Kepkay	highschool	Handsworth Secondary School
Ángel Daniel Vassallo	highschool	Faith Christian Academy
Kevin Prince	highschool	Crespi Carmelite High School
John Jenkins	highschool	Station Camp
Durell Price	highschool	Sylmar High School
Simon Farine	highschool	Northern Secondary School
Kahlia Hogg	highschool	Merici College
Alvin Snow	highschool	Franklin
Umur Peten	highschool	Kalaba Anatolien High School
Umur Peten	highschool	Ankara, Turkey
Richard Brehaut	highschool	Los Osos High School
John Henson	highschool	Sickles
Michał Cieśla	highschool	ZSEM Prusa
Travis Peterson	highschool	Mountain Ridge High School
Jasper Howard	highschool	Miami Edison High School
Trey Gilder	highschool	DeSoto
Shaun Pruitt	highschool	West Aurora
Craig Austrie	highschool	Trinity Catholic
Irby Curry	highschool	Marlin High School
Robert Gimson	highschool	The Benjamin School
Jimmer Fredette	highschool	Glens Falls High School
Matt Miller	highschool	Mt. Carmel High School
Matt Miller	highschool	San Diego, California
Ricky Dobbs	highschool	Douglas County High School
Ricky Dobbs	highschool	Douglasville, Georgia
Casey Paus	highschool	Lincoln-Way Community High School District 210
Stan Weber	highschool	Goddard High School
Stan Weber	highschool	Goddard, Kansas
Allan Evridge	highschool	Papillion-La Vista Senior High School
Allan Evridge	highschool	Papillion, Nebraska
Allen Webb	highschool	Chatfield Senior High
Allen Webb	highschool	Littleton, Colorado
Major Wingate	highschool	North Gwinnett
Tre' Newton	highschool	Carroll Senior High School
Warren Norman	highschool	Chamblee High School
Tim Stratton	highschool	York Community High School
Gareth Dawson	highschool	Roncalli College
Gareth Dawson	highschool	Waitaki Boys' High School
J. T. Tiller	highschool	Joseph Wheeler High School
Lin Chih-chieh	highschool	National Keelung Senior Marine Vocational School
Chang Chih-feng	highschool	National Pingtung High School , Taiwan
Cesar Chavez Jacobo	highschool	Our Savior New American School
Donald Buckram	highschool	Copperas Cove Independent School District
Donald Buckram	highschool	Copperas Cove, Texas
Duane Klueh	highschool	State
Bill Montgomery	highschool	R. L. Turner High School
Trévon Hughes	highschool	St. John's Northwestern Military Academy
Jim Master	highschool	Paul Harding High School
Evric Gray	highschool	Bloomington High School
B. H. Born	highschool	Medicine Lodge
David Sills	highschool	Eastern Christian Academy
Gap Powell	highschool	Franklin High School
Hassan Whiteside	highschool	The Patterson School
Chen Hsin-an	highschool	Taipei Municipal Song-Shan Senior High School
Gilbert Brown	highschool	South Kent School
Kelly Faris	highschool	Heritage Christian School
Jared Sullinger	highschool	Northland High School
Michael Bauer	highschool	Hastings High School
Hamady N'Diaye	highschool	Stoneridge Preparatory School
Ali Farokhmanesh	highschool	Iowa City West High School
Omar Samhan	highschool	San Ramon Valley High School
Dominique Jones	highschool	Lake Wales High School
Larry Gordon	highschool	Montclair
Jerome Randle	highschool	Hales Franciscan High School
Mike Rose	highschool	Neuqua Valley High School
Juaquin Hawkins	highschool	Lynwood High School
Joah Tucker	highschool	Nicolet
Chris Hill	highschool	Lawrence North High School
Caroline Doty	highschool	Germantown Academy
Greg Stiemsma	highschool	Randolph High School
Erron Maxey	highschool	Temescal Canyon High School
Erron Maxey	highschool	Elsinore High School
Jamar Howard	highschool	Bishop Miege High School
Nedu Onyeuku	highschool	Creighton Preparatory School
Ben Habern	highschool	Argyle Liberty Christian School
Lowell Hamilton	highschool	Providence-St. Mel
Aaron Zagory	highschool	Yellow Springs High School
Aaron Zagory	highschool	Yellow Springs, Ohio
Luke Babbitt	highschool	Galena
Kevin Newsome	highschool	yes
Kevin Newsome	highschool	Hargrave Military Academy
Kevin Newsome	highschool	Chatham, Virginia
Kevin Newsome	highschool	Western Branch High School
Kevin Newsome	highschool	Chesapeake, Virginia
René Rougeau	highschool	Etiwanda High School
Dave Fisher	highschool	Fairmont High School
John Adams	highschool	Beebe
Paul Unruh	highschool	Toulon
Magnum Rolle	highschool	St. George’s
Magnum Rolle	highschool	Laurinburg Institute
Tiny Gallon	highschool	Oak Hill Academy
Terrico White	highschool	Craigmont High School
Armon Johnson	highschool	Hug
Stanley Robinson	highschool	Huffman High School
Dwayne Collins	highschool	Miami High School
Terrence Jones	highschool	Jefferson High School
Gus Broberg	highschool	Torrington
Bill Hapac	highschool	J. Sterling Morton High School East
Ralph Vaughn	highschool	Frankfort
Jack Harvey	highschool	Frankfort
Les Witte	highschool	Lincoln High School
Les Witte	highschool	Lincoln, Nebraska
Bobby Anet	highschool	Astoria
Kyrie Irving	highschool	Montclair Kimberley Academy
Kyrie Irving	highschool	St. Patrick
Wally Johansen	highschool	Astoria High School
Chris Babirad	highschool	Bentworth School District
A. J. Pagano	highschool	Knoch High School
Ahmad Ibrahim	highschool	The Patterson School
Ahmad Ibrahim	highschool	Christian Life Center Academy
Mario Wuysang	highschool	Bloomington North
Jules Bender	highschool	Boys
Jerry Newsom	highschool	Columbus North High School
Herschel Sims	highschool	Abilene High School
Ryan Wittman	highschool	Eden Prairie High School
Michael Schachtner	highschool	Somerset High School
Víctor Ávila	highschool	Cornerstone Christian
Scott Bacigalupo	highschool	St. Paul's School
Scott Bacigalupo	highschool	Brooklandville, Maryland
Stanley Burrell	highschool	Ben Davis
Grady Wallace	highschool	Betsy Layne
Art Quimby	highschool	Bulkeley
Charlie Slack	highschool	Pomeroy
Joe Jakubick	highschool	Madison
Mickell Gladness	highschool	Sylacauga
David McCarty	highschool	LaSalle Institute, Troy, New York
Darryl Stonum	highschool	Dulles High School
Darryl Stonum	highschool	Sugar Land, Texas
Sam Ranzino	highschool	Emerson School for Visual and Performing Arts
Don Burness	highschool	Lowell High School
Jim McIntyre	highschool	Patrick Henry High School
Blake Williams	highschool	Lawton
Robin Freeman	highschool	Hughes Center High School
Paul Girgash	highschool	St. Edward High School
Paul Girgash	highschool	Lakewood, Ohio
Andy Cannavino	highschool	Villa Angela-St. Joseph High School
Andy Cannavino	highschool	Cleveland, Ohio
Tiffany Gooden	highschool	R. Nelson Snider High School
Tiffany Gooden	highschool	Fort Wayne, IN
Marion Body	highschool	Kettering High School
Marion Body	highschool	Detroit, Michigan
Rushel Shell	highschool	Hopewell High School
Bob Doll	highschool	Chaffey
Bill Erickson	highschool	Rockford East High School
Bob Dille	highschool	Chesterton
Garret Siler	highschool	Academy of Richmond County
Al Seiden	highschool	Jamaica
Bob Mattick	highschool	North Park
Brett Salisbury	highschool	Orange Glen High School
Ted Kitchel	highschool	Lewis Cass
Joe Richey	highschool	St. Johns High School
Ed Nelson	highschool	St. Thomas Aquinas High School
Herb Wilkinson	highschool	East High School
Joe Reiff	highschool	Crane
Leo Byrd	highschool	Old Huntington High School
Gale McArthur	highschool	Mangum
Rod Fletcher	highschool	Champaign
J. L. Parks	highschool	Paoli
Ed Beisser	highschool	North High School
Darnell Lazare	highschool	Woodlawn High School
Forest Sale	highschool	Kavanaugh
Claire Cribbs	highschool	Jeannette
Kenneth Faried	highschool	Technology High School
Darron Brittman	highschool	Chicago Vocational Career Academy
Elwood Romney	highschool	Dixie
Geoff Crompton	highschool	Walter M. Williams High School
Jovan Leacock	highschool	Bayside High School
Josh Fisher	highschool	Mercer Island High School
Ronnie McCollum	highschool	Fayette County
Willie Jackson	highschool	Sibley High School
Willie Jackson	highschool	Sibley, Louisiana
Kevin Jones	highschool	Mount Vernon High School
Jeremy Hazell	highschool	The Patterson School
JaMychal Green	highschool	St. Jude Educational Institute
Maalik Wayns	highschool	Roman Catholic High School
Jewell Young	highschool	Jefferson
Jim Lacy	highschool	Loyola
Byron Larkin	highschool	Moeller High School
Greg Koubek	highschool	Shenendehowa High School
Greg Koubek	highschool	Clifton Park, New York
Tristan Thompson	highschool	Findlay Prep
Jason Bennett	highschool	Arlington Country Day School
Eugene Spates	highschool	Hillcrest High School
Gilmore Kinney	highschool	Phillips Academy
Ray Woods	highschool	Evanston
Jereme Richmond	highschool	Waukegan
Anthony Wilkerson	highschool	Tustin High School
Maurice Bailey	highschool	South Side High School
Joe Krabbenhoft	highschool	Roosevelt High School
Matt Barr	highschool	Belvidere High School
Matt Barr	highschool	Belvidere, Illinois
Ashton Gibbs	highschool	Seton Hall Preparatory School
Darius White	highschool	Paul Laurence Dunbar High School
Ángel García	highschool	Central
Tevin Elliot	highschool	Mount Pleasant High School
Tevin Elliot	highschool	Mount Pleasant, Texas
Cade Foster	highschool	Southlake Carroll High School
MarShon Brooks	highschool	Tucker
William Gradit	highschool	Laurinburg Institute
Randal Falker	highschool	Gateway High School
Greg Guy	highschool	Oak Park and River Forest High School
Brett Roberts	highschool	South Webster High School
Larry Owens	highschool	Westwood High School
Jeff Van Camp	highschool	Navarre High School
Bob McCurdy	highschool	Deer Park High School
Bob McCurdy	highschool	Long Island, New York
Kevin Houston	highschool	Pearl River High School
Terrance Bailey	highschool	Ewing
Andre Drummond	highschool	St. Thomas More
Jordan Williams	highschool	Torrington High School
Chris Johnson	highschool	Colonial Beach High School
Chris Johnson	highschool	Laurinburg Institute
Chris Marcus	highschool	Olympic
Robert Kessler	highschool	Anderson
Ralph Crosthwaite	highschool	Western Hills High School
Derrick Williams	highschool	La Mirada High School
Vern Corbin	highschool	Piedmont
Tom Churchill	highschool	Central
Grady Livingston	highschool	Bishop O'Dowd High School
Grady Livingston	highschool	Oakland, California
Adnan Hodžić	highschool	North Central
Justin Knox	highschool	Central High School
Jackson Emery	highschool	Lone Peak
Herbert Crook	highschool	Eastern High School
Adrian Oliver	highschool	Modesto Christian School
Dave Downey	highschool	Canton High School
Gary Wilkinson	highschool	Bingham
Andrew Nicholson	highschool	Father Michael Goetz Secondary School
Brian Sloan	highschool	McLeansboro High School
Jordan Taylor	highschool	Benilde-St. Margaret's
Lynn Shackelford	highschool	John Burroughs
Marcus Morris	highschool	Prep Charter
Marcus Morris	highschool	APEX Academy
Jordan Hamilton	highschool	*Susan Miller Dorsey
Jordan Hamilton	highschool	*Manuel Dominguez
Chris Hill	highschool	Whitney Young Magnet High School
Aurimas Kieža	highschool	Florida Air Academy
Kayla Pedersen	highschool	Red Mountain
Jessica Gaspar	highschool	Dartmouth High School
Jessica Gaspar	highschool	Dartmouth, Massachusetts
Bradley Beal	highschool	Chaminade College Preparatory School
Markieff Morris	highschool	Prep Charter
Markieff Morris	highschool	APEX Academy
Michael Rocco	highschool	Liberty Christian Academy
Michael Rocco	highschool	Lynchburg, VA
Bernie Fliegel	highschool	DeWitt Clinton
Ramone Moore	highschool	South Philadelphia High School
Abdul Shamsid-Deen	highschool	Tottenville High School
Jim Cunningham	highschool	Canisius High School
Will Sheridan	highschool	Sanford School
Boo Harvey	highschool	Andrew Jackson High School
Ron Slay	highschool	Oak Hill Academy
Terrell Stoglin	highschool	Santa Rita High School
Weldon Kern	highschool	Lawton High School
Gary Springer	highschool	Benjamin Franklin High School
Noble Jorgensen	highschool	Taylor Allderdice High School
Walt Lautenbach	highschool	Plymouth High School
Stan Patrick	highschool	Leo Catholic High School
Chips Sobek	highschool	Hammond
Gene Dyker	highschool	St. Patrick
Nate DeLong	highschool	Chippewa Falls High School
Bobby Watson	highschool	Owensboro
Patrick Eddie	highschool	Lynde & Harry Bradley Technology and Trade School
Granger Hall	highschool	Clayton
McKinley Singleton	highschool	Booker T. Washington High School
Bill Dinwiddie	highschool	Muncie Central High School
Charlie Paulk	highschool	Lester
George Patterson	highschool	Central Catholic High School
Norris Cole	highschool	Dunbar High School
Malcolm Lee	highschool	John W. North High School
DeAndre Liggins	highschool	Findlay Prep
Chukwudiebere Maduabum	highschool	Command Day Secondary School
Morgan Tuck	highschool	Bolingbrook
Hal Perry	highschool	Ukiah
Avery Atkins	highschool	Mainland High School
Tusten Ackerman	highschool	Lawrence
Jerry Mullen	highschool	St. Mary's College High School
Tom Davis	highschool	Willingboro High School
Tom Davis	highschool	Willingboro Township, New Jersey
Khris Middleton	highschool	Porter-Gaud School
A. L. Bennett	highschool	Holdenville
Dave Shinskie	highschool	Mount Carmel Area School District
Dave Shinskie	highschool	Kulpmont, Pennsylvania
Kyle Johnson	highschool	West Hill Collegiate Institute
James Lee	highschool	Henry Clay High School
David Butler	highschool	Calvin Coolidge High School
Ed Voss	highschool	University High School
Antwain Barbour	highschool	Elizabethtown High School
Jack Dana	highschool	Piedmont High School
Fred Linari	highschool	San Francisco Polytechnic High School
Andreas Schreiber	highschool	Brentwood School
Mike Phillips	highschool	Manchester
Casey Calvary	highschool	Bellarmine Preparatory School
Tom Kleinschmidt	highschool	Gordon Tech
Barrett Trotter	highschool	Briarwood Christian School
Dan Mavraides	highschool	Junípero Serra High School
Dan Mavraides	highschool	Phillips Exeter Academy
Dale Barnstable	highschool	Antioch Community High School
Max Shortell	highschool	Bishop Miege High School
Max Shortell	highschool	Roeland Park, Kansas
Gay Elmore	highschool	South Charleston High School
Bakari Hendrix	highschool	St. Patrick-St. Vincent High School
Ollie Johnson	highschool	Spingarn High School
Les Taylor	highschool	Carbondale Community High School
Jon Collins	highschool	Cahokia
Leon Williams	highschool	Cardinal Gibbons School
Gene Brown	highschool	George Washington High School
Harold Jensen	highschool	Trumbull
Asher Clark	highschool	Peachtree Ridge High School
Asher Clark	highschool	Suwanee, Georgia
John Hubert	highschool	Midway High School
David Ash	highschool	Belton High School
C. J. Brown	highschool	Seneca Valley Senior High School
Ricardo Greer	highschool	George Washington High School
Ricardo Greer	highschool	Cheshire Academy
Ryan Radcliff	highschool	Fairview High School
Ryan Radcliff	highschool	Sherwood, Defiance County, Ohio
Vincent Smith	highschool	Pahokee High School
Vincent Smith	highschool	Pahokee, Florida
Vic Rouse	highschool	Pearl
Ed Warner	highschool	DeWitt Clinton
Ed Roman	highschool	Taft
LaRoy Doss	highschool	Sacred Heart Cathedral Preparatory
Gary Winton	highschool	Albert P. Brewer High School
Chas Dodd	highschool	James F. Byrnes High School
Chas Dodd	highschool	Duncan, South Carolina
Tonya Butler	highschool	Riverdale High School
J. T. Floyd	highschool	J. L. Mann High School
Damian Lillard	highschool	St. Joseph Notre Dame High School
Damian Lillard	highschool	Oakland High School
Jerome Dyson	highschool	Proctor Academy
Sergio Kerusch	highschool	Overton High School
Jim Weir	highschool	Green River
Ricardo Marsh	highschool	Orange High School
Julyan Stone	highschool	Dos Pueblos
Carldell Johnson	highschool	Marion Abramson High School
Courtney Pigram	highschool	East High School
Stephen Weigh	highschool	UC Senior Secondary College Lake Ginninderra
Orlando Johnson	highschool	Palma
Sim Bhullar	highschool	The Kiski School
Sim Bhullar	highschool	Huntington Prep School
Kyle Weems	highschool	Highland Park High School
Barry J. Sanders	highschool	Heritage Hall School
Johnathan Gray	highschool	Aledo High School
Reginald Ho	highschool	Saint Louis School
Keith Wright	highschool	Princess Anne High School
Keith Wright	highschool	Norfolk Collegiate
Greg Cordivari	highschool	Bishop Shanahan High School
Earl Calloway	highschool	Westlake High School
Lee Seung-jun	highschool	Shorecrest
Charlie LaPradd	highschool	Ketterlinus High School
Joe Crawford	highschool	Renaissance High School
Marcus Denmon	highschool	Hogan Preparatory Academy
Alex Gynes	highschool	Nowra High School
Kim English	highschool	Randallstown High School
Kim English	highschool	Notre Dame Preparatory School
Gunner Kiel	highschool	Columbus East High School
Jorge Gutiérrez	highschool	Abraham Lincoln High School
Jorge Gutiérrez	highschool	Findlay Prep
Kyle O'Quinn	highschool	Campus Magnet High School
Steve Puidokas	highschool	St. Laurence
Mike Scott	highschool	Deep Creek High School
Mike Scott	highschool	Hargrave Military Academy
Maurice Creek	highschool	Hargrave Military Academy
Fab Melo	highschool	Sagemont
Paul Jones	highschool	Sto-Rox High School,
Paul Jones	highschool	Pittsburgh, PA
Terrence Ross	highschool	Jefferson High School
Terrence Ross	highschool	Montrose Christian School
Maurice Harkless	highschool	Forest Hills High School
Maurice Harkless	highschool	South Kent School
Makoto Hasegawa	highschool	Noshiro Technical High School
William Buford	highschool	Libbey
Hameen Ali	highschool	Dover High School
Stanley Pringle	highschool	Landstown High School
Steve Burtt Jr.	highschool	Rice High School
Donn Cabral	highschool	Glastonbury High School
Kenny Heitz	highschool	Ernest Righetti
Judd Davis	highschool	Forest High School
Bradley Buckman	highschool	Westlake
Nick Welch	highschool	United States Air Force Academy Preparatory School
Bob Lewis	highschool	East
Neil Reed	highschool	East Jefferson High School
Greg Brown	highschool	Albuquerque High School
Michelle Plouffe	highschool	Harry Ainlay High School
Tommy Curtis	highschool	Leon
Walter Hirsch	highschool	Northridge
Derwin Kitchen	highschool	Raines High School
Mark Payne	highschool	St. Mary's
Kyle Kalis	highschool	St. Edward High School
Andrew Rodriguez	highschool	Bishop Ireton High School
Micah Lancaster	highschool	Comstock Park
Will Hanley	highschool	New Canaan High School
Brett Nottingham	highschool	Monte Vista High School
Paris Horne	highschool	Bridgton Academy
Kyle Fogg	highschool	Brea Olinda High School
Charles García	highschool	Susan Miller Dorsey High School
Devin Searcy	highschool	Romulus Senior High School
Tyler Wilkerson	highschool	Lafayette High School
Manny Quezada	highschool	St. Albans School
Johnny Moates	highschool	Benedictine
Antonio Granger	highschool	Denby High School
Kenyan Weaks	highschool	Fork Union Military Academy
Noor Davis	highschool	Leesburg High School
Zach Banner	highschool	Lakes High School
DeQuan Jones	highschool	Wheeler
Drew Dileo	highschool	Parkview Baptist High School
Dennis Norfleet	highschool	Martin Luther King High School
Jarvis Giles	highschool	Gaither High School
Zach Zwinak	highschool	Linganore High School
Reggie Jackson	highschool	Baker High School
Jack Taylor	highschool	Black River Falls High School
Jack Taylor	highschool	Mercersburg Academy
J. J. Denman	highschool	Pennsbury High School
Takura Tela	highschool	Prince Edward High School
Booker Woodfox	highschool	Lewisville
Christen May Roper	highschool	Nordhoff High School
Jim Betts	highschool	Benedictine High School
Jim Betts	highschool	Cleveland
Jim Betts	highschool	Ohio
Philip Nelson	highschool	Mankato West High School
Larry Smith	highschool	Alton High School
Max Browne	highschool	Skyline High School
Jabrill Peppers	highschool	Paramus Catholic High School
Darius Hamilton	highschool	Don Bosco Preparatory High School
Steve Hayes	highschool	Aberdeen
Peter Westerhaus	highschool	Holy Family Catholic High School
Ondre Pipkins	highschool	Park Hill High School
Demetrious Nicholson	highschool	Kellam High School
Demetrious Nicholson	highschool	Virginia Beach, Virginia
Vlad Moldoveanu	highschool	St. John's College High School
Jim Bredar	highschool	Salem Community
Reuben Foster	highschool	Auburn High School Tigers football
Sidney Port	highschool	Lane Tech High School
Sidney Port	highschool	Chicago, Illinois
Jay Threatt	highschool	Highland Springs High School
Tim Winn	highschool	La Salle High School
Nate Green	highschool	Theodore Roosevelt High School
Todd Lehmann	highschool	Holy Cross High School
Anthony Manuel	highschool	Crane
Yvon Joseph	highschool	Collège Notre-Dame
Denzel Nkemdiche	highschool	Grayson High School
Jeremy Borseth	highschool	Pulaski High School
Tarise Bryson	highschool	Stephen Decatur High School
Shaler Halimon	highschool	Romulus
Matthew White	highschool	Choate
Phil Henderson	highschool	Crete-Monee
Nick Waisome	highschool	South Lake High School
Denzel Devall	highschool	Bastrop High School
Cyrus Hobbi	highschool	Saguaro High School
Hiva Lutui	highschool	Trinity High School
Da'Shawn Hand	highschool	Woodbridge High School
Lindsey Moore	highschool	Kentwood
Alan Gendreau	highschool	Orangewood Christian
Carla Chapman	highschool	St. Vincent – St. Mary High School
André Roberson	highschool	Wagner
Craig Shelton	highschool	Dunbar High School
Ron Ellis	highschool	Rayville
Olek Czyż	highschool	Reno
Siyani Chambers	highschool	Hopkins
Austin Kafentzis	highschool	Jordan High School
Quincy Davis	highschool	McGill-Toolen
Carrick Felix	highschool	Millennium
Ryan Kelly	highschool	Ravenscroft School
Erik Murphy	highschool	St. Mark's School
Grant Jerrett	highschool	Lutheran
Romero Osby	highschool	North Lauderdale
Len Kosmalski	highschool	Maple Heights High School
Dwight Buycks	highschool	Bay View High School
Clyde Bradshaw	highschool	East Orange Campus High School
C. J. Leslie	highschool	Word of God Christian Academy
Taysom Hill	highschool	Highland High School
Deividas Pukis	highschool	Christian Life Center Academy
Marlon Humphrey	highschool	Hoover High School
Elton Nesbitt	highschool	Deerfield Beach High School
Robert Day	highschool	Benson Polytechnic High School
Brendan Winters	highschool	Mullen High School
Brendan Winters	highschool	Worcester Academy
Michael Graham	highschool	Spingarn High School
Derrick Green	highschool	Hermitage High School
Trevor Knight	highschool	Ronald Reagan High School
Shane Morris	highschool	De La Salle Collegiate High School
Baker Mayfield	highschool	Lake Travis High School
Tayler Hill	highschool	South High School
Randall Cunningham II	highschool	Bishop Gorman High School
Curtis Kelly	highschool	Rice High School
Kelsey Bone	highschool	Dulles
Darius Theus	highschool	I. C. Norcom High School
Reggie Keely	highschool	Cleveland Heights High School
Ron Perry	highschool	Stafford
Ron Perry	highschool	Catholic Memorial School
Leonard Fournette	highschool	St. Augustine High School
John O'Korn	highschool	St. Thomas Aquinas High School
Tombi Bell	highschool	Norland
A. J. Johnson	highschool	Gainesville High School
Govoner Vaughn	highschool	Edwardsville High School
Ken Johnson	highschool	La Jolla
Voise Winters	highschool	Gage Park High School
Maty Mauk	highschool	Kenton High School
Ed Rains	highschool	Forest High School
Luke Sikma	highschool	Bellevue
George Campbell	highschool	East Lake High School
Alin Edouard	highschool	Hialeah High School
Jeremy Johnson	highschool	George Washington Carver High School
Will Hagerup	highschool	Whitefish Bay High School
Danny Etling	highschool	Terre Haute South Vigo High School
Andakara Prastawa	highschool	SMAN 03 Jakarta
Cooper Kupp	highschool	A.C. Davis High School
Andrew Brown	highschool	Oscar F. Smith High School
Raekwon McMillan	highschool	Liberty County High School
Mark Crow	highschool	Benedictine
Dick Grubar	highschool	Notre Dame-Bishop Gibbons High School
Tommie Green	highschool	McKinley Senior High School
Tom Hovasse	highschool	Widefield
Steve Previs	highschool	Bethel Park High School
Al Fleming	highschool	Michigan City High School
Guy Rucker	highschool	John Glenn
Jamal Robinson	highschool	Monsignor McClancy Memorial High School
Jarek Lancaster	highschool	Sandra Day O'Connor High School
Dave Fedor	highschool	Zephyrhills
Richard Walton	highschool	Bay City High School
Tony Brown	highschool	Clifton J. Ozen High School
Case McCoy	highschool	Graham High School, Graham, Texas
Djibril Kante	highschool	Bloomington High School North
Mark Murdock	highschool	Westwood High School
Larry Hollyfield	highschool	Compton
Fred Slaughter	highschool	Topeka
Jack Hirsch	highschool	Van Nuys
Rob Moerschell	highschool	Highland Park High School
Jordan Adams	highschool	Oak Hill Academy
Conner Mertens	highschool	Southridge
Donovan Forbes	highschool	Sterling High School
Joshua Smith	highschool	Kentwood
1965)	highschool	Rolling Hills High School
Cam Robinson	highschool	West Monroe High School
Randy McEachern	highschool	Dobie High School
Mario Little	highschool	George Washington High School
Moala Tautuaa	highschool	Claremont
Leonard George	highschool	Jesuit High School
Tim Kamczyc	highschool	Strongsville
Nathan Healy	highschool	New Bern High School
Nathan Healy	highschool	Blair Academy
Monta McGhee	highschool	Paul Robeson High School
Willie Deane	highschool	Schenectady High School
Jonte Flowers	highschool	La Follette
Raymond Cowels	highschool	Hopkins High School
Maurice Sutton	highschool	Largo High School
Mark Sanchez	highschool	Desert View High School
Chris Banchero	highschool	O'Dea High School
Sam Ansley	highschool	Cypress-Fairbanks High School
Mark McBath	highschool	Richard King High School
Chase Tapley	highschool	Sacramento Charter High School
Jon Kreft	highschool	Marjory Stoneman Douglas High School
Xavier Alexander	highschool	Midwest City High School
Elijah Hood	highschool	Charlotte Catholic High School
Demetrius Alexander	highschool	Hazelwood Central High School
Mike Cordaro	highschool	San Antonio Independent School District
Terrance Broadway	highschool	Capitol
Davis Webb	highschool	Prosper High School
Ted Constanzo	highschool	Winston Churchill High School
Bri Kulas	highschool	Shawnee Mission North High School
Jennifer Hamson	highschool	Pleasant Grove High School
Trenton Thompson	highschool	Westover Comprehensive High School
Kayla McBride	highschool	Villa Maria Academy
Shoni Schimmel	highschool	Hermiston High School
Shoni Schimmel	highschool	Franklin
Mack Crowder	highschool	Bristol Tennessee High School
Anthony Myles	highschool	Harper High School
Eddie Vanderdoes	highschool	Placer High School
Norman Powell	highschool	Lincoln High School
Marty Akins	highschool	Gregory-Portland High School
Matt Santangelo	highschool	Central Catholic High School
Davin White	highschool	North High School
Lemone Lampley	highschool	Chicago Vocational High School
Alex Renfroe	highschool	Hume-Fogg
Mike Presley	highschool	Grand Prairie High School
Chris McGuthrie	highschool	Springbrook
Len Matela	highschool	Andrean High School
Dion Dixon	highschool	Crane High School
Micah Shrewsberry	highschool	Cathedral
Alhaji Mohammed	highschool	Hillcrest
Cedric Lewis	highschool	Archbishop Carroll High School
Nikola Cvetinović	highschool	Virginia Episcopal School
Karim Shabazz	highschool	Lawrence Woodmere Academy
Donnie Wigginton	highschool	Spring Branch High School
Jobey Thomas	highschool	Independence
Thomas Tyner	highschool	Aloha High School
Rayan Hawili	highschool	Fordson High School
Eddie Phillips	highschool	Mesquite High School
Natalie Nakase	highschool	Marina High School
Lazeric Jones	highschool	Simeon Career Academy
Michael Roll	highschool	Aliso Niguel High School
Antoine Agudio	highschool	Walt Whitman High School, South Huntington
Ron King	highschool	Central High School
Kenny Hill	highschool	Carroll Senior High School
Oliver Kuhn	highschool	Montgomery Bell Academy
J. T. Barrett	highschool	S. H. Rider High School
Leonard Hilty	highschool	Peabody High School
Chelsea Gray	highschool	St. Mary's
Tyaunna Marshall	highschool	Elizabeth Seton High School
Tiffany Bias	highschool	Central
Inga Orekhova	highschool	The Bishop's School
Frederick Tibbott	highschool	Germantown Academy
Bill Webster	highschool	Shelton High School
Bill Webster	highschool	Hotchkiss School
Brad Kaaya	highschool	Chaminade College Preparatory School
Gerald Robinson	highschool	Martin Luther King Magnet at Pearl High School
Cassie Harberts	highschool	San Clemente High School
Anu Solomon	highschool	Bishop Gorman High School
Meighan Simmons	highschool	Byron P. Steele High School
Brent Wright	highschool	Miami Senior High School
Mike Anderson	highschool	Robert E. Lee High School
Kyle Pascual	highschool	Esperanza High School
Bob Rives	highschool	Hopkinsville High School
De'Veon Smith	highschool	Howland High School
Park Chan-hee	highschool	Kyungbock High School
Lee Jong-hyun	highschool	Kyungbock High School
Jimmy Steele	highschool	Hillsborough High School
Mason Cole	highschool	East Lake High School
Larry Dupree	highschool	Baker County High School
Isaac Fotu	highschool	Rangitoto College
Tyrone Swoopes	highschool	Whitewright High School
Goldy Goldstein	highschool	Duval High School
Wes Lunt	highschool	Rochester High School
Anthony Jennings	highschool	Marietta High School
Judy Harlan	highschool	Atlanta Public Schools
Andy White	highschool	Lee High School
Marvin Kristynik	highschool	Bay City High School
Devon Allen	highschool	Brophy College Preparatory
Herb Covington	highschool	Mayfield
Herb Covington	highschool	Castle Heights Military Academy
Don Goldstein	highschool	Tilden
Jameon Lewis	highschool	Tylertown High School
Alf Sharpe	highschool	Montgomery Bell Academy
Arnas Butkevičius	highschool	Hermanas Zudermanas' Gymnasium
Arnas Butkevičius	highschool	Klaipėda, Lithuania
James Conner	highschool	McDowell High School
Deshaun Watson	highschool	Gainesville High School
Pink Wade	highschool	Hume-Fogg High School
Michael Brewer	highschool	Lake Travis High School
Frank Godchaux	highschool	Woodberry Forest School
Forest K. Ferguson	highschool	Martin County High School
Brandon Harris	highschool	Parkway High School
David Paddock	highschool	Peddie School
Nigel Miguel	highschool	Notre Dame
Myles Garrett	highschool	Martin High School
Gennifer Brandon	highschool	Chatsworth
Rainey Cawthon	highschool	Leon High School
David Arseneault Jr.	highschool	Grinnell
Treon Harris	highschool	Booker T. Washington High School
James Florence	highschool	Joseph Wheeler High School
Akeel Lynch	highschool	Saint Francis High School
Geno Lewis	highschool	Wyoming Valley West Senior High School
Geno Lewis	highschool	Senior High School
DaeSean Hamilton	highschool	Mountain View High School
Corey Robinson	highschool	San Antonio Christian Schools
Butch Wade	highschool	Columbus North High School
Nick Chubb	highschool	Cedartown High School
Kyle Allen	highschool	Desert Mountain High School
Steve Malovic	highschool	Alhambra
D'Vontrey Richardson	highschool	Lee County High School
Austin Appleby	highschool	Hoover High School
Garland O'Shields	highschool	Spartanburg High School
Adam Breneman	highschool	Cedar Cliff High School
Samaje Perine	highschool	Hendrickson High School
Dalvin Cook	highschool	Miami Central High School
Jimmy Armistead	highschool	Hume-Fogg High School
Frank Peake	highschool	Hampton High School
Kevon Looney	highschool	Alexander Hamilton High School
Enoch Brown	highschool	Battle Ground Academy
Bob Miller	highschool	Central High School
Albert Staton	highschool	Henry W. Grady High School
Scott Secor	highschool	Lincoln-Way Central High School
Kevin Fant	highschool	Moss Point High School
George Morton	highschool	Episcopal
John Suther	highschool	Tuscaloosa High School
Brittany Chambers	highschool	Jordan
Bryce Alford	highschool	La Cueva High School
Milton Leathers	highschool	Clarke Central High School
Mike Dudek	highschool	Neuqua Valley High School
Amos Kent	highschool	Gulf Coast Military Academy
Kyler Murray	highschool	Allen High School
Joe Clements	highschool	Huntsville High School
Terry Snoddy	highschool	Owensboro High School
Tom Dutton	highschool	Minden High School
Malik Jefferson	highschool	Poteet High School
Jeronne Maymon	highschool	James Madison Memorial High School
Hub McCormick	highschool	Augusta Military Academy
Hargrove Van de Graaff	highschool	Tuscaloosa High School
Bronson Beri	highschool	Roncalli College
Bronson Beri	highschool	Nelson College
Kevin Burke	highschool	St. Edward High School
Owen Poole	highschool	Henry W. Grady High School
Louis Hasslock	highschool	Montgomery Bell Academy
Bunny Andrews	highschool	Woodrow Wilson High School
Charlie Thompson	highschool	Henry W. Grady High School
Willie Hillman	highschool	Minden High School
Rooster Andrews	highschool	Woodrow Wilson High School
Jay Dee Patton	highschool	Hume-Fogg High School
Carey Spicer	highschool	Lexington High School
James %22T%22 Jones	highschool	Childress High School
Sollie Cohen	highschool	Rolling Fork, MS
Glenn Lautzenhiser	highschool	Atlanta Public Schools
Adoree' Jackson	highschool	Junípero Serra High School
Malik Zaire	highschool	Archbishop Alter High School
Tarean Folston	highschool	Cocoa High School
Jakell Mitchell	highschool	Opelika High School
Martez Ivey	highschool	Apopka High School
Dan Page	highschool	Leverett's Chapel Independent School District
Ben Tompkins	highschool	Polytechnic High School
Paul Campbell	highschool	Breckenridge High School
Josh Rosen	highschool	St. John Bosco High School
Will Grier	highschool	Davidson Day School
Rafael Gaglianone	highschool	Baylor School
Harry P. Gamble	highschool	Warren Easton High School
Cooper Rush	highschool	Lansing Catholic High School
Angel Goodrich	highschool	Sequoyah
Quin Blanding	highschool	Bayside High School
Jack Halfpenny	highschool	Sunset High School
Aaron Holiday	highschool	Campbell Hall
D'Vauntes Smith-Rivera	highschool	North Central High School
D'Vauntes Smith-Rivera	highschool	Oak Hill Academy
Patrick Mahomes	highschool	Whitehouse High School
Kyle Fuller	highschool	Rancho Verde High School
Zeke Martin	highschool	Denton High School
Jacob Eason	highschool	Lake Stevens High School
Irving Holdash	highschool	Austintown-Fitch High School
Ralph Ellsworth	highschool	Alamo Heights High School
Georgie Ratterman	highschool	Spring Hill College
Joe Magliolo	highschool	Ball High School
C. J. Harris	highschool	Mount Tabor High School
Spot Collins	highschool	Breckenridge High School
Joe Young	highschool	Yates High School
Gary Payton II	highschool	Spring Valley High School
Gary Payton II	highschool	Westwind Prep
Schea Cotton	highschool	St. John Bosco High School
Schea Cotton	highschool	Mater Dei High School
Schea Cotton	highschool	St. Thomas More
Tony Parker	highschool	Miller Grove High School
Nicco Fertitta	highschool	Bishop Gorman High School
Alizé Jones	highschool	Bishop Gorman High School
Isaac Hamilton	highschool	Crenshaw High School
Isaac Hamilton	highschool	St. John Bosco
Chris Relf	highschool	George Washington Carver High School
Chris Relf	highschool	Montgomery, Alabama
Justin Anderson	highschool	Montrose Christian School
Trevor Lacey	highschool	Butler
J. P. Tokoto	highschool	Menomonee Falls High School
Kenny Booker	highschool	Long Beach Polytechnic High School
Karl Cochran	highschool	George Walton Comprehensive High School
Derrick Marks	highschool	Plainfield Central High School
Winston Shepard	highschool	Findlay Prep
Freddie Joe Steinmark	highschool	Wheat Ridge High School
Thomas Ryan	highschool	Sam Houston Math, Science, and Technology Center
Ike Joselove	highschool	Atlanta Public Schools
K. D. Cannon	highschool	Mount Pleasant High School
Corey Hawkins	highschool	Estrella Foothills High School
Tyson Lee	highschool	Columbus High School
Omarr Conner	highschool	Noxubee County High School
Jake Layman	highschool	King Philip Regional High School
Derek Barnett	highschool	Brentwood Academy
Walter Mayberry	highschool	Mainland High School
Terry Schofield	highschool	Saint Monica
Lawrence Alexander	highschool	Manual High School
Stefan Nastić	highschool	Thornhill Secondary School
Johndre Jefferson	highschool	Lake Marion High School & Technology Center
Kellen Dunham	highschool	Pendleton Heights High School
Brittany Boyd	highschool	Berkeley
Cheyenne Parker	highschool	Southwest Guilford High School
Victoria Macaulay	highschool	Curtis High School
Betnijah Laney	highschool	Smyrna
Dairese Gary	highschool	Concord High School
Austin MacGinnis	highschool	Prattville High School
JK Scott	highschool	Mullen High School
Evan Engram	highschool	Hillgrove High School
Joe Bolden	highschool	Colerain High School
Maverick Ahanmisi	highschool	Stoneridge Prep
Maverick Ahanmisi	highschool	Golden Valley High School
Rammy Ramsdell	highschool	Hillsborough High School
Elijah Johnson	highschool	Cheyenne
Thomas Welsh	highschool	Loyola High School
Jonah Bolden	highschool	*Homebush Boys
Jonah Bolden	highschool	*Findlay Prep
Jonah Bolden	highschool	*Brewster Academy
Bruce Bolden	highschool	Flint Northwestern High School
Laimonas Kisielius	highschool	The Miller School of Albemarle
DeNesha Stallworth	highschool	Pinole Valley
Theresa Plaisance	highschool	Vandebilt Catholic
Jerry Norman	highschool	Washington
Tora Suber	highschool	Downingtown High School
Tia Jackson	highschool	Mardela High School
Katrina Colleton	highschool	East Bay
Thérence Mayimba	highschool	Montrose Christian School
Thérence Mayimba	highschool	St. James School
Thérence Mayimba	highschool	Hagerstown, Maryland
Chris Silva	highschool	Roselle Catholic High School
Robert Reitsch	highschool	Rockford
Bill Sweek	highschool	Pasadena
John Ecker	highschool	University
Mitch Hyatt	highschool	North Gwinnett High School
Bill Austin	highschool	Scotch Plains-Fanwood High School
Rupert Colmore	highschool	Baylor School
Quinn McDowell	highschool	Moeller
Angela Hamblin	highschool	Lew Wallace High School
Adrienne Johnson	highschool	Butler Traditional High School
Tiffany Woosley	highschool	Shelbyville
Shalonda Enis	highschool	Celeste High School
Norbert Torres	highschool	Blessed Mother Teresa Catholic Secondary School
Chris Newsome	highschool	Rio Rancho High School
Glenn Khobuntin	highschool	Colegio de San Juan de Letran
Roi Sumang	highschool	Colegio de San Juan de Letran
Rome dela Rosa	highschool	Samuel Morse
Josh Sweat	highschool	Oscar F. Smith High School
Kostas Ezomo	highschool	Spartanburg Prep
Dan Feeney	highschool	Carl Sandburg High School
Tegray Scales	highschool	Colerain High School
Jake Browning	highschool	Folsom High School
Jalen Hurd	highschool	Beech Senior High School
Jake Butt	highschool	Pickerington High School North
DeShone Kizer	highschool	Central Catholic High School
Jerrod Heard	highschool	John H. Guyer High School
Chad Kelly	highschool	St. Joseph's Collegiate Institute
Tre'Davious White	highschool	Green Oaks High School
Cameron Sutton	highschool	Jonesboro High School
Tanner Mangum	highschool	Eagle High School
Luke Falk	highschool	Logan High School
Amir Celestin	highschool	Miami Norland Senior High School
Ty Isaac	highschool	Joliet Catholic Academy
Sean White	highschool	University School of Nova Southeastern University
Greyson Lambert	highschool	Wayne County High School
Tommy Armstrong Jr.	highschool	Byron P. Steele High School
Kevin Palmer	highschool	Parkville
Sampson Carter	highschool	Ridgeway
John Williamson	highschool	Marion-Franklin High School
Damon Lynn	highschool	Union Catholic Regional High School
Johnny Menville	highschool	Jesuit High School
Sean Mosley	highschool	St. Francis Academy
Kimikazu Suzuki	highschool	Noshiro Technical High School
Christian Kirk	highschool	Saguaro High School
Simon Enciso	highschool	Terra Nova
Dan Nwaelele	highschool	Inglemoor
Michael Holyfield	highschool	Manzano High School
Chuck Kyle	highschool	Highlands
Charles Rosenfelder	highschool	Humboldt HS
John DiBartolomeo	highschool	Staples
Calvin Ridley	highschool	Monarch High School
Fred Ross	highschool	John Tyler High School
Wayne Gallman	highschool	Grayson High School
Steve Gansey	highschool	Olmsted Falls High School
Christian McCaffrey	highschool	Valor Christian High School
Desmond King	highschool	East English Village Preparatory Academy
Jonathan Allen	highschool	Stone Bridge High School
Ron Hull	highschool	Woodrow Wilson HS, Los Angeles
Joe Mixon	highschool	Freedom High School
Broughton Williams	highschool	Henry B. Plant High School
Stanley Ocitti	highschool	Cambridge Rindge and Latin School
Mark Plansky	highschool	Wakefield Memorial High School
Reid Moseley	highschool	Huntsville High School
Reid Moseley	highschool	Castle Heights Military Academy
Jason Killeen	highschool	Middleburg Academy
Dave Hibbert	highschool	Phoenix Union High School
Lance McIlhenny	highschool	Highland Park High School
Brian Baima	highschool	North Hollywood High School
Casey Fitzgerald	highschool	Red Oak High School
Ken Hebert	highschool	Pampa High School
Brett Rypien	highschool	Shadle Park High School
Brett Rypien	highschool	Spokane, Washington
Wilton Speight	highschool	Collegiate
Mitch Leidner	highschool	Lakeville South High School
Norm Purucker	highschool	Boardman High School
Sal Olivas	highschool	Cathedral High School
Malachi Dupre	highschool	John Curtis Christian High School
Josh Wallwork	highschool	Tracy High School
Travis Rudolph	highschool	Cardinal Newman High School
Jarrett Stidham	highschool	Stephenville High School
Maurice Hurst Jr.	highschool	Xaverian Brothers High School
Harold Griffin	highschool	Hillsborough High School
Lee Nalley	highschool	Central High School
Kermit Whitfield	highschool	Jones High School
Tramaine Thompson	highschool	Jenks High School
Ryan Switzer	highschool	George Washington High School
Jourdan Lewis	highschool	Cass Technical High School
Alex Harden	highschool	Southeast
Saquon Barkley	highschool	Whitehall High School
Jehu Chesson	highschool	Ladue Horton Watkins High School
Jamal Adams	highschool	Hebron High School
Brian Hill	highschool	Belleville High School-West
Nick Mullens	highschool	Spain Park High School
Dane Evans	highschool	Sanger High School
Kim Jiwan	highschool	Songdo International Business District
Darius Victor	highschool	Northwestern High School
B. J. Dickey	highschool	Ottawa-Glandorf High School
Demetrius Brown	highschool	Miami Beach Senior High School
Mike Gillette	highschool	St. Joseph High School
Avery Scharer	highschool	Garfield High School
Chris Godwin	highschool	Middletown High School
Jason Perkins	highschool	Shakopee High School
Von Pessumal	highschool	Ateneo de Manila University
Jake Elliott	highschool	Lyons Township High School
De'Mornay Pierson-El	highschool	West Potomac High School
Jordan Canzeri	highschool	Troy High School
C. J. Beathard	highschool	Battle Ground Academy
Justin Jackson	highschool	Glenbard North High School
Jordan Westerkamp	highschool	Montini Catholic High School
William Likely	highschool	Glades Central High School
Griffin Oakes	highschool	Greenwood High School
Zach Maynard	highschool	Grimsley High School
Mike Olliver	highschool	Southern Wayne High School
Marcus Maye	highschool	Holy Trinity Episcopal Academy
Antonio Callaway	highschool	Booker T. Washington High School
Demarius Bolds	highschool	East St. Louis Senior High School
Malik McDowell	highschool	Southfield High School
Dakota Prukop	highschool	Vandegrift High School
Jordan Leggett	highschool	Navarre High School
Greg Ward Jr.	highschool	John Tyler High School
Terry Beckner	highschool	East St. Louis Senior High School
Shea Patterson	highschool	IMG Academy
Isaiah Ford	highschool	Trinity Christian Academy
Derwin James	highschool	Haines City High School
Brandon Reilly	highschool	Lincoln Southwest High School
Justin Yoon	highschool	Milton Academy
Demetrius Conger	highschool	Covenant Christian Academy
Brandon Young	highschool	Friendship Collegiate Academy Public Charter School
Tony Woods	highschool	Rome High School
Thomas Sperbeck	highschool	Jesuit High School
Thomas Sperbeck	highschool	Carmichael, California
Josh Adams	highschool	Central Bucks High School South
Seth Ryan	highschool	Summit High School
Monk Dorsett	highschool	Duval High School
T.J. Edwards	highschool	Lakes Community High School
Eddie Jackson	highschool	Boyd H. Anderson High School
Billy Chase	highschool	Lakeland Senior High School
Tommy Durrance	highschool	Mainland High School
Tim Williams	highschool	Louisiana State University Laboratory School
Speedy Walker	highschool	Hillsborough High School
Rashan Gary	highschool	Paramus Catholic High School
Quinn Nordin	highschool	Rockford High School
Devin Asiasi	highschool	De La Salle High School
Kareem Walker	highschool	DePaul Catholic High School
Brandon Peters	highschool	Avon High School
Brandon Brown	highschool	Sarah T. Reed High School
Max Fugler	highschool	Ferriday High School
Darrell Harris	highschool	East High School
Skyler Howard	highschool	Brewer High School
Mike King	highschool	Lake Clifton High School
Ruth Hamblin	highschool	Houston Christian School
Ben Bredeson	highschool	Arrowhead High School
Carlo Kemp	highschool	Fairview High School
Jalen Tabor	highschool	Friendship Collegiate Academy Public Charter School
Tiffany Mitchell	highschool	Providence Day
Ronald Nored	highschool	Homewood
Paul Jones	highschool	Kent-Meridian High School
Taylor Morton	highschool	Salesianum School
Bryan Chamberlain	highschool	Monroe Comprehensive High School
Chris Rubio	highschool	Charter Oak High School
Mack Hollins	highschool	Thomas Sprigg Wootton High School
Jamarr Johnson	highschool	* Schalick\n*
Dana Coin	highschool	Pontiac Northern High School
Jack Beynon	highschool	Rockford Central High School
Harry Szulborski	highschool	Pershing High School
Ike Owens	highschool	Theodore Roosevelt
Merritt Green	highschool	DeVilbiss
Conner Sullivan	highschool	Lutheran High School of Orange County
Eric Gutierrez	highschool	Sharyland High School
Bobby Lavin	highschool	Paris High School
Montell Cozart	highschool	Bishop Miege High School
Ryan Willis	highschool	Bishop Miege High School
Trey Griffey	highschool	Dr. Phillips High School
Chazz Anderson	highschool	Pickerington High School Central
Case Cookus	highschool	Thousand Oaks High School
Mykal Riley	highschool	Pine Bluff High School
Lamar Jackson	highschool	Boynton Beach High School
Nekeshia Henderson	highschool	South Oak Cliff High School
Bill Healy	highschool	Baylor School
Minkah Fitzpatrick	highschool	St. Peter's Preparatory School
Mike Tobey	highschool	Blair Academy
Kendall Sheffield	highschool	Thurgood Marshall High School
Tyler Tutt	highschool	Keller High School
Caleb Griffin	highschool	Keller High School
Roy Goree	highschool	Henry W. Grady High School
Deshawn Stephens	highschool	Chatsworth High School
Lorenzo Williams	highschool	Ellison
Deondre Francois	highschool	Olympia High School
Mitch Trubisky	highschool	Mentor High School
Scott Morrison	highschool	Argyle Secondary School
Myles Gaskin	highschool	O'Dea High School
Roderick Johnson	highschool	Hazelwood Central High School
Pat Elflein	highschool	Pickerington High School North
Luke Del Rio	highschool	Valor Christian High School
Daichi Taniguchi	highschool	Rakunan High School
Kenzo Maeda	highschool	Daisho Gakuen
Seiya Ando	highschool	Meisei High School
Shaq Roland	highschool	Lexington High School
Kenichi Takahashi	highschool	Akita Technical High School
Shigehiro Taguchi	highschool	Meio High School
Chris Evans	highschool	Ben Davis High School
Blake Barnett	highschool	Santiago High School
Jalen Hurts	highschool	Channelview High School
Damien Harris	highschool	Madison Southern High School
Noriyuki Sugasawa	highschool	Ishikawa High School
Curtis Samuel	highschool	Erasmus Hall High School
Ryosuke Mizumachi	highschool	Saganishi High School
Ryosuke Shirahama	highschool	Sagakita High School
Tatsunori Fujie	highschool	Fukuoka Daiichi High School
Charles Harris	highschool	Lincoln College Preparatory Academy
Kazuo Nakamura	highschool	Akita High School
Mike McCray	highschool	Trotwood-Madison
Kenny Allen	highschool	Fenton
Amara Darboh	highschool	Dowling Catholic
Nick Fitzgerald	highschool	Richmond Hill High School
Kyle York	highschool	Spring High School
Yerikho Christophor Tuasela	highschool	Santa Agnes High School
Chris Wormley	highschool	Whitmer
Derrius Guice	highschool	Catholic High School
Mike Weber	highschool	Cass Technical High School
Kristian Liem	highschool	Intan Permata Hati School
Dawuane Smoot	highschool	Groveport Madison High School
Bucky Hodges	highschool	Salem High School
Budda Baker	highschool	Bellevue High School
Mike McGlinchey	highschool	William Penn Charter School
Derrick Jones Jr.	highschool	Archbishop John Carroll High School
Cordrea Tankersley	highschool	Silver Bluff High School
Jerod Evans	highschool	Mansfield High School
Nathan Gerry	highschool	Washington High School
Drew Lock	highschool	Lee's Summit HighSchool
Sam Darnold	highschool	San Clemente High School
Markell Jones	highschool	Columbus East High School
Manny Wilkins	highschool	San Marin High School
Devine Redding	highschool	Glenville High School
Austin Allen	highschool	Fayetteville High School
Kenny Hall	highschool	Redan
Jeremy McNichols	highschool	Santa Margarita Catholic High School
David Haughton	highschool	The Woodlands High School
Alton Marsters	highschool	Arlington High School
John Ross	highschool	Jordan High School
Dede Westbrook	highschool	C.H. Yoe High School
James Washington	highschool	Stamford High School
Zach Cunningham	highschool	Pinson Valley High School
Jarrad Davis	highschool	Camden County High School
D'Onta Foreman	highschool	Texas City High School
DeMarcus Walker	highschool	Sandalwood High School
Sidney Jones	highschool	West Covina High School
Alvin Kamara	highschool	Norcross High School
Justin Brownlee	highschool	Chipola College
