Azores	highestRegion	Pico Island
Lisbon	highestRegion	Benfica
Madeira	highestRegion	Santana
Porto	highestRegion	Bonfim
Savage Islands	highestRegion	Funchal
Corvo Island	highestRegion	Vila do Corvo
Flores Island	highestRegion	Santa Cruz das Flores
Adirondack Park	highestRegion	Essex County, New York
Camarate	highestRegion	Camarate
Terceira Island	highestRegion	Santa Bárbara
Peneda-Gerês National Park	highestRegion	Outeiro
São Jorge Island	highestRegion	Norte Grande
Faial Island	highestRegion	Flamengos
Lagoa, Azores	highestRegion	Água de Pau
Água de Pau Massif	highestRegion	Ponta Delgada
Graciosa	highestRegion	Santa Cruz da Graciosa
Santa Maria Island	highestRegion	Santa Bárbara
Bragança District	highestRegion	França
Monte Brasil	highestRegion	Sé
Nature Park of Alvão	highestRegion	Vila Marim
Pessegueiro Island	highestRegion	Porto Covo
Nature Park of Arrábida	highestRegion	São Lourenço
Cabras Islets	highestRegion	Porto Judeu
Duke of Terceira Garden	highestRegion	Angra do Heroísmo
Monchique Islet	highestRegion	Lajes das Flores
Nature Park of Faial	highestRegion	Flamengos
Botanical Garden of Faial	highestRegion	Flamengos
West Doubtful Canyon	highestRegion	Cochise County, Arizona
Picos Volcanic Fissural System	highestRegion	Ponta Delgada
Recreational Forest Reserve of Pinhal da Paz	highestRegion	Pico da Pedra
Nature Park of Terceira	highestRegion	Serreta
Vila do Bispo	highestRegion	Vila do Bispo
Congro Volcanic Fissural System	highestRegion	Ponta Delgada
Sete Cidades Massif	highestRegion	Ponta Delgada
