Secretariat	horsename	Secretariat
Northern Dancer	horsename	Northern Dancer
Nijinsky	horsename	Nijinsky II
Starcraft	horsename	Starcraft
Phar Lap	horsename	Phar Lap
Shergar	horsename	Shergar
Nearco	horsename	Nearco
Dan Patch	horsename	Dan Patch
Greyhound	horsename	Greyhound
Ribot	horsename	Ribot
Seabiscuit	horsename	Seabiscuit
Matt's Scooter	horsename	Matt's Scooter
Strike Out	horsename	Strike Out
Bret Hanover	horsename	Bret Hanover
Abercrombie	horsename	Abercrombie
Precious Bunny	horsename	Precious Bunny
Albatross	horsename	Albatross
Cam Fella	horsename	Cam Fella
War Admiral	horsename	War Admiral
Rambling Willie	horsename	Rambling Willie
Niatross	horsename	Niatross
Funny Cide	horsename	Funny Cide
Mameluke	horsename	Mameluke
John Henry	horsename	John Henry
Man o' War	horsename	Man o' War
Mack Lobell	horsename	Mack Lobell
Cardigan Bay	horsename	Cardigan Bay
Risen Star	horsename	Risen Star
Canonero II	horsename	Cañonero II
The Huntsman	horsename	The Huntsman
Seattle Slew	horsename	Seattle Slew
Affirmed	horsename	Affirmed
Peintre Celebre	horsename	Peintre Celebre
Citation	horsename	Citation
Sir Barton	horsename	Sir Barton
Santa Claus	horsename	Santa Claus
Alydar	horsename	Alydar
All Along	horsename	All Along
Arkle	horsename	Arkle
Tom Rolfe	horsename	Tom Rolfe
Exceller	horsename	Exceller
Brigadier Gerard	horsename	Brigadier Gerard
Golden Miller	horsename	Golden Miller
Equipoise	horsename	Equipoise
Think Big	horsename	Think Big
Smarty Jones	horsename	Smarty Jones
Ruffian	horsename	Ruffian
Cigar	horsename	Cigar
The Minstrel	horsename	The Minstrel
Hyperno	horsename	Hyperno
Duke of Magenta	horsename	Duke of Magenta
Elusive Quality	horsename	Elusive Quality
Mr. Prospector	horsename	Mr. Prospector
Native Dancer	horsename	Native Dancer
Belle's Good Cide	horsename	Belle's Good Cide
Real Quiet	horsename	Real Quiet
Count Fleet	horsename	Count Fleet
Gallant Fox	horsename	Gallant Fox
Omaha	horsename	Omaha
Teenoso	horsename	Teenoso
Birdstone	horsename	Birdstone
Corrida	horsename	Corrida
Middleground	horsename	Middleground
Kincsem	horsename	Kincsem
Bold Forbes	horsename	Bold Forbes
Aristides	horsename	Aristides
Mill Reef	horsename	Mill Reef
Dano-Mast	horsename	Dano-Mast
Sinndar	horsename	Sinndar
Daylami	horsename	Daylami
Bore Head	horsename	Bore Head
Makybe Diva	horsename	Makybe Diva
Ghostzapper	horsename	Ghostzapper
Eclipse	horsename	Eclipse
Better Loosen Up	horsename	Better Loosen Up
I'll Get Along	horsename	I'll Get Along
Octagonal	horsename	Octagonal
Nashua	horsename	Nashua
Narita Brian	horsename	Narita Brian
Rock of Gibraltar	horsename	Rock of Gibraltar
Northerly	horsename	Northerly
Lonhro	horsename	Lonhro
Peter Simple	horsename	Peter Simple
Shinzan	horsename	Shinzan
Secreto	horsename	Secreto
Slip Anchor	horsename	Slip Anchor
Shahrastani	horsename	Shahrastani
Pretty Polly	horsename	Pretty Polly
Best Mate	horsename	Best Mate
Ouija Board	horsename	Ouija Board
Buzzards Bay	horsename	Buzzards Bay
Assault	horsename	Assault
Kingston Town	horsename	Kingston Town
Silent Witness	horsename	Silent Witness
Kelso	horsename	Kelso
Giacomo	horsename	Giacomo
Afleet Alex	horsename	Afleet Alex
Closing Argument	horsename	Closing Argument
Exterminator	horsename	Exterminator
Donerail	horsename	Donerail
Dancing Brave	horsename	Dancing Brave
Sea Bird	horsename	Sea-Bird
Dubai Millennium	horsename	Dubai Millennium
High Chaparral	horsename	High Chaparral
Hawk Wing	horsename	Hawk Wing
Galileo	horsename	Galileo
Lammtarra	horsename	Lammtarra
Deep Impact	horsename	Deep Impact
Whirlaway	horsename	Whirlaway
Hindoo	horsename	Hindoo
Vain	horsename	Vain
Carbine	horsename	Carbine
Hard Tack	horsename	Hard Tack
Foolish Pleasure	horsename	Foolish Pleasure
Tompion	horsename	Tompion
Unbridled	horsename	Unbridled
Might and Power	horsename	Might and Power
Kiwi	horsename	Kiwi
Alysheba	horsename	Alysheba
Sassafras	horsename	Sassafras
Arwon	horsename	Arwon
Manikato	horsename	Manikato
Savabeel	horsename	Savabeel
Dance Smartly	horsename	Dance Smartly
Good and Plenty	horsename	Good and Plenty
Go For Wand	horsename	Go For Wand
Colin	horsename	Colin
Neil Gow	horsename	Neil Gow
Ormonde	horsename	Ormonde
Artsplace	horsename	Artsplace
Windsong's Legacy	horsename	Windsong's Legacy
Rainbow Blue	horsename	Rainbow Blue
Beach Towel	horsename	Beach Towel
Potoooooooo	horsename	Potoooooooo
Spectacular Bid	horsename	Spectacular Bid
Spend A Buck	horsename	Spend A Buck
Twenty Grand	horsename	Twenty Grand
Rising Fast	horsename	Rising Fast
Red Rum	horsename	Red Rum
Domino	horsename	Domino
Flower Alley	horsename	Flower Alley
Sunline	horsename	Sunline
Orlando	horsename	Orlando
Dalakhani	horsename	Dalakhani
Tiznow	horsename	Tiznow
Sunday Silence	horsename	Sunday Silence
Bonecrusher	horsename	Bonecrusher
La Mer	horsename	LA MER
Musket	horsename	Musket*
Waverley Star	horsename	Waverley Star
Grey Way	horsename	Grey Way
Balmerino	horsename	Balmerino
Kindergarten	horsename	Kindergarten
Desert Gold	horsename	Desert Gold
Gloaming	horsename	Gloaming
Vintage Crop	horsename	Vintage Crop
Desert Orchid	horsename	Desert Orchid
Horlicks	horsename	Horlicks
Sir Tristram	horsename	Sir Tristram
High Caste	horsename	High Caste
Brew	horsename	Brew
My Babu	horsename	My Babu
Rain Lover	horsename	Rain Lover
Red Handed	horsename	Red Handed
Light Fingers	horsename	Light Fingers
Lost in the Fog	horsename	Lost in the Fog
Snow Bride	horsename	Snow Bride
Easy Goer	horsename	Easy Goer
Bernborough	horsename	Bernborough
Wakeful	horsename	Wakeful
Archer	horsename	Archer
Skip Away	horsename	Skip Away
Indigenous	horsename	Indigenous
Personal Ensign	horsename	Personal Ensign
The Barb	horsename	The Barb
Todman	horsename	Todman
Piping Lane	horsename	Piping Lane
Elvstroem	horsename	Elvstroem
Poseidon	horsename	Poseidon
Ajax II	horsename	Ajax
Heroic	horsename	Heroic
Tawrrific	horsename	Tawrrific
Spearmint	horsename	Spearmint
Bold Ruler	horsename	Bold Ruler
Kingston Rule	horsename	Kingston Rule
Commander in Chief	horsename	Commander in Chief
Rose of Kingston	horsename	Rose of Kingston
Pilsudski	horsename	Pilsudski
Sir Hercules	horsename	Sir Hercules
Birdcatcher	horsename	Birdcatcher
Faugh-a-Ballagh	horsename	Faugh-a-Ballagh
Leamington	horsename	Leamington
Precipitation	horsename	Precipitation
Show Gate	horsename	Show Gate
Great Sensation	horsename	Great Sensation
The Baron	horsename	The Baron
Good Lord	horsename	Good Lord
Stockwell	horsename	Stockwell
Tie the Knot	horsename	Tie the Knot
Hi Jinx	horsename	Hi Jinx
Apollo Eleven	horsename	Apollo Eleven
Vanguard	horsename	Vanguard
Desert King	horsename	Desert King
Roses In May	horsename	Roses In May
Doncaster	horsename	Doncaster
Pocahontas	horsename	Pocahontas
Glencoe I	horsename	Glencoe
Trampoline	horsename	Trampoline
Sultan	horsename	Sultan
Reel	horsename	Reel
Regret	horsename	Regret
Dark Star	horsename	Dark Star
Galilee	horsename	Galilee
Swale	horsename	Swale
Kayak II	horsename	Kayak II
Waygood	horsename	Waygood
Danehill	horsename	Danehill
Zev	horsename	Zev
Xcellent	horsename	Xcellent
Tonalist	horsename	Tonalist
Miesque	horsename	Miesque
Lady's Secret	horsename	Lady's Secret
Flockton Grey	horsename	Flockton Grey
Bed O' Roses	horsename	Bed o' Roses
The Trump	horsename	The Trump
Capot	horsename	Capot
Jeune	horsename	Jeune
Amberleigh House	horsename	Amberleigh House
Dream Well	horsename	Dream Well
Amiable	horsename	Amiable
Bago	horsename	Bago
Divine Proportions	horsename	Divine Proportions
Nightmarch	horsename	Nightmarch
Moifaa	horsename	Moifaa
St. Simon	horsename	St. Simon
Hurricane Run	horsename	Hurricane Run
A.P. Warrior	horsename	A.P. Warrior
Stevie Wonderboy	horsename	Stevie Wonderboy
Fastnet Rock	horsename	Fastnet Rock
Takeover Target	horsename	Takeover Target
Devon Loch	horsename	Devon Loch
Achilles of Troy	horsename	Achilles of Troy
Barbaro	horsename	Barbaro\n\n'''
Bluegrass Cat	horsename	Bluegrass Cat
Bob and John	horsename	Bob and John
Brother Derek	horsename	Brother Derek
Cause to Believe	horsename	Cause to Believe
Doctor Decherd	horsename	Doctor Decherd
First Samurai	horsename	First Samurai
Flashy Bull	horsename	Flashy Bull
Henny Hughes	horsename	Henny Hughes
Cape of Good Hope	horsename	Cape of Good Hope
Count Ricardo	horsename	Count Ricardo
Timely Writer	horsename	Timely Writer
Ferdinand	horsename	Ferdinand
Kicking King	horsename	Kicking King
Sea Pigeon	horsename	Sea Pigeon
Istabraq	horsename	Istabraq
Sadler's Wells	horsename	Sadler's Wells
Sindon	horsename	Sindon
Brantôme	horsename	Brantôme
Lexington	horsename	Lexington
Hanover	horsename	Hanover
Charismatic	horsename	Charismatic
War Emblem	horsename	War Emblem
Monarchos	horsename	Monarchos
Fusaichi Pegasus	horsename	Fusaichi Pegasus
Rooster Booster	horsename	Rooster Booster
Tim Tam	horsename	Tim Tam
Forego	horsename	Forego
Dr. Fager	horsename	Dr. Fager
Evening Attire	horsename	Evening Attire
Roamer	horsename	Roamer
Hedgehunter	horsename	Hedgehunter
Red Marauder	horsename	Red Marauder
Rock Hard Ten	horsename	Rock Hard Ten
Foinavon	horsename	Foinavon
Numbersixvalverde	horsename	Numbersixvalverde
Gimcrack	horsename	Gimcrack
Grindstone	horsename	Grindstone
Lawrin	horsename	Lawrin
Buckpasser	horsename	Buckpasser
Discreet Cat	horsename	Discreet Cat
Lawyer Ron	horsename	Lawyer Ron
Old Rosebud	horsename	Old Rosebud
Placid Ark	horsename	Placid Ark
Sinister Minister	horsename	Sinister Minister
Steppenwolfer	horsename	Steppenwolfer
Sweetnorthernsaint	horsename	Sweetnorthernsaint
Sharp Humor	horsename	Sharp Humor
Point Determined	horsename	Point Determined
Deputy Glitters	horsename	Sample
Jazil	horsename	Jazil
Seaside Retreat	horsename	Seasaide Retreat
With a City	horsename	With a City
Showing Up	horsename	Showing Up
Sunriver	horsename	Sunriver
Pensive	horsename	Pensive
Lethal Force	horsename	Lethal Force
Super Impose	horsename	Super Impose
Lemons Forever	horsename	Lemons Forever
Dynaformer	horsename	Dynaformer
Lava Man	horsename	Lava Man
Wild Again	horsename	Wild Again
Silver Charm	horsename	Silver Charm
Point Given	horsename	Point Given
Holy Bull	horsename	Holy Bull
Nasrullah	horsename	Nasrullah
Invasor	horsename	Invasor\n260px
Kitten's Joy	horsename	Kitten's Joy
Bernardini	horsename	Bernardini
A.P. Indy	horsename	A.P. Indy
Menifee	horsename	Menifee
Lemon Drop Kid	horsename	Lemon Drop Kid
Distorted Humor	horsename	Distorted Humor
Swaps	horsename	Swaps
Garrison Savannah	horsename	Garrison Savannah
Genuine Risk	horsename	Genuine Risk
Ben Brush	horsename	Ben Brush
Persian Punch	horsename	Persian Punch
Pan Zareta	horsename	Pan Zareta
Sir Percy	horsename	Sir Percy
Hyperion	horsename	Hyperion
Sky Beauty	horsename	Sky Beauty
Half Caste	horsename	Half Caste
Tantieme	horsename	Tantième
St Paddy	horsename	St. Paddy
Haru Urara	horsename	Haru Urara
Montjeu	horsename	Montjeu
Chief Bearhart	horsename	Chief Bearhart
Rock Sand	horsename	Rock Sand
Armed	horsename	Armed
Sysonby	horsename	Sysonby
Suave Dancer	horsename	Suave Dancer
Stymie	horsename	Stymie
Beeswing	horsename	Beeswing
Papillon	horsename	Papillon
Reveller	horsename	Reveller
Ten Broeck	horsename	Ten Broeck
Crusader	horsename	Crusader
Blue Larkspur	horsename	Blue Larkspur
Bayakoa	horsename	Bayakoa
Star Kingdom	horsename	Star Kingdom
Let's Elope	horsename	Let's Elope
Dust Commander	horsename	Dust Commander
Biscay	horsename	Biscay
Bletchingly	horsename	Bletchingly
Emancipation	horsename	Emancipation
Saintly	horsename	Saintly
Iron Liege	horsename	Iron Liege
Imp	horsename	Imp
Miss Woodford	horsename	Miss Woodford
Flight	horsename	Flight
Skyline	horsename	Skyline
Sky High	horsename	Sky High
Russia	horsename	Russia
Royal Gem	horsename	Royal Gem
Shannon	horsename	Shannon
Your Host	horsename	Your Host
Redcraze	horsename	Redcraze
George Washington	horsename	George Washington
Shareef Dancer	horsename	Shareef Dancer
Johannesburg	horsename	Johannesburg
One Cool Cat	horsename	One Cool Cat
Yeats	horsename	Yeats
Damascus	horsename	Damascus
Zabeel	horsename	Zabeel
L'Enjoleur	horsename	L'Enjoleur
Azeri	horsename	Azeri
Dawn Run	horsename	Dawn Run
Temperence Hill	horsename	Temperence Hill
Thunder Gulch	horsename	Thunder Gulch
Six Perfections	horsename	Six Perfections
The Tin Man	horsename	The Tin Man
Electrocutionist	horsename	Electrocutionist
Indian Queen	horsename	Orfevre
Saint Liam	horsename	Saint Liam
Alexandrova	horsename	Alexandrova
Gallorette	horsename	Gallorette
Boston	horsename	Boston
Lochsong	horsename	Lochsong
Slew o' Gold	horsename	Slew o' Gold
St Lite	horsename	St Lite
Lord	horsename	Lord
Zippy Chippy	horsename	Zippy Chippy
Storm Cat	horsename	Storm Cat
Forestry	horsename	Forestry
La Troienne	horsename	La Troienne
Mummify	horsename	Mummify
Maori's Idol	horsename	Maori’s Idol
Captain Steve	horsename	Captain Steve
Rubio	horsename	Rubio
Majestic Prince	horsename	Majestic Prince
Vert Amande	horsename	Vert Amande
Alderbrook	horsename	Alderbrook
Diomed	horsename	Diomed
First Landing	horsename	First Landing
Hill Prince	horsename	Hill Prince
Riva Ridge	horsename	Riva Ridge
Shirocco	horsename	Shirocco
Sky Classic	horsename	Sky Classic
Round Table	horsename	Round Table
Arazi	horsename	Arazi
Lil E. Tee	horsename	Lil E. Tee
Norcliffe	horsename	Norcliffe
New Providence	horsename	New Providence
Canebora	horsename	Canebora
With Approval	horsename	With Approval
Victoria Park	horsename	Victoria Park
Wando	horsename	Wando
Peteski	horsename	Peteski
Izvestia	horsename	Izvestia
Congaree	horsename	Congaree
Deputy Minister	horsename	Deputy Minister
Bay Ronald	horsename	Bay Ronald
Bayardo	horsename	Bayardo
Arcangues	horsename	Arcangues
Dark Ronald	horsename	Dark Ronald
Relko	horsename	Relko
Princequillo	horsename	Princequillo
Papyrus	horsename	Papyrus
Salvator	horsename	Salvator
Allez France	horsename	Allez France
La Prevoyante	horsename	La Prevoyante
Helissio	horsename	Helissio
Malicious	horsename	Malicious
Prince Palatine	horsename	Prince Palatine
T M Opera O	horsename	T M Opera O
Alleged	horsename	Alleged
Kauai King	horsename	Kauai King
Galopin	horsename	Galopin
Blenheim	horsename	Blenheim
Precisionist	horsename	Precisionist
Mill House	horsename	Mill House
El Gran Senor	horsename	El Gran Senor
Kayf Tara	horsename	Kayf Tara
Son-in-Law	horsename	Son-in-Law
Rail Link	horsename	Rail Link
Mandesha	horsename	Mandesha
Falbrav	horsename	Falbrav
Storm Bird	horsename	Storm Bird
Djebel	horsename	Djebel
Perfect Drift	horsename	Perfect Drift
Giant's Causeway	horsename	Giant's Causeway
Sea Hero	horsename	Sea Hero
Fantastic Light	horsename	Fantastic Light
Fair Play	horsename	Fair Play
Nearctic	horsename	Nearctic
West Australian	horsename	West Australian
Chief's Crown	horsename	Chief's Crown
Sir Ivor	horsename	Sir Ivor
Sunny's Halo	horsename	Sunny's Halo
Carry Back	horsename	Carry Back
Brokers Tip	horsename	Brokers Tip
Busher	horsename	Busher
Dahlia	horsename	Dahlia
Diatome	horsename	Diatome
Tobin Bronze	horsename	Tobin Bronze
Twilight Tear	horsename	Twilight Tear
Ack Ack	horsename	Ack Ack
Tudor Minstrel	horsename	Tudor Minstrel
Reigh Count	horsename	Reigh Count
Fanfreluche	horsename	Fanfreluche
Grey Lag	horsename	Grey Lag
Ashado	horsename	Ashado
Dancethruthedawn	horsename	Dancethruthedawn
Our Mims	horsename	Our Mims
Moscow Flyer	horsename	Moscow Flyer
Fort Marcy	horsename	Fort Marcy
Bunty Lawless	horsename	Bunty Lawless
Azertyuiop	horsename	Azertyuiop
Free House	horsename	Free House
Bushranger	horsename	Bushranger
Cool Ground	horsename	Cool Ground
Black Gold	horsename	Black Gold
Neji	horsename	Neji
Oedipus	horsename	Oedipus
The Fellow	horsename	The Fellow
See More Business	horsename	See More Business
Misty Morn	horsename	Misty Morn
Barton Bank	horsename	Barton Bank
Cool Reception	horsename	Cool Reception
Conquistador Cielo	horsename	Conquistador Cielo
Silky Sullivan	horsename	Silky Sullivan
Storm Flag Flying	horsename	Storm Flag Flying
Circular Quay	horsename	Circular Quay
Darci Brahma	horsename	Darci Brahma
Behaving Badly	horsename	Behaving Badly
My Flag	horsename	My Flag
Whisk Broom II	horsename	Whisk Broom II
Warm Spell	horsename	Warm Spell
Arravale	horsename	Arravale
Discovery	horsename	Discovery
Hill Rise	horsename	Hill Rise
T.V. Lark	horsename	T.V. Lark
Hatoof	horsename	Hatoof
Soviet Song	horsename	Soviet Song
Tomy Lee	horsename	Tomy Lee
Sword Dancer	horsename	Sword Dancer
Fields of Omagh	horsename	Fields Of Omagh
Marju	horsename	Marju
Needles	horsename	Needles
Challedon	horsename	Challedon
Desert Vixen	horsename	Desert Vixen
Dancer's Image	horsename	Dancer's Image
Forward Pass	horsename	Forward Pass
Beldame	horsename	Beldame
Bahram	horsename	Bahram
Bimelech	horsename	Bimelech
Best Pal	horsename	Best Pal
Media Puzzle	horsename	Media Puzzle
Noor	horsename	Noor
Gander	horsename	Gander
Delta Blues	horsename	Delta Blues
Pop Rock	horsename	Pop Rock
Dance in the Dark	horsename	Dance in the Dark
Davona Dale	horsename	Davona Dale
Subzero	horsename	Subzero
Big Philou	horsename	Big Philou
Doriemus	horsename	Doriemus
Vo Rogue	horsename	Vo Rogue
Shuvee	horsename	Shuvee
Ocean of Wisdom	horsename	Ocean of Wisdom
Shaftesbury Avenue	horsename	Shaftesbury Avenue
Sydeston	horsename	Sydeston
Firenze	horsename	Firenze
Moccasin	horsename	Moccasin
Round Pond	horsename	Round Pond
War Cloud	horsename	War Cloud
Mister Frisky	horsename	Mister Frisky
Battleship	horsename	Battleship
Halfbridled	horsename	Halfbridled
Nashwan	horsename	Nashwan
Mayano Top Gun	horsename	Mayano Top Gun
Arts and Letters	horsename	Arts and Letters
Johnstown	horsename	Johnstown
Criminal Type	horsename	Criminal Type
American Eclipse	horsename	American Eclipse
Pine Circle	horsename	Pine Circle
Da Hoss	horsename	Da Hoss
Sarazen	horsename	Sarazen
Holy Roller	horsename	Holy Roller
Rough Habit	horsename	Rough Habit
Dark Mirage	horsename	Dark Mirage
Fitz Herbert	horsename	Fitz Herbert
Mahubah	horsename	Mahubah
The Phantom	horsename	The Phantom
Ridan	horsename	Ridan
Princess Rooney	horsename	Princess Rooney
Danzig	horsename	Danzig
Pebbles	horsename	Pebbles
Graustark	horsename	Graustark
Royal Orbit	horsename	Royal Orbit
Shaamit	horsename	Shaamit
Gallant Man	horsename	Gallant Man
Royal Charger	horsename	Royal Charger
Henry of Navarre	horsename	Henry of Navarre
Idun	horsename	Idun
Flying Fox	horsename	Flying Fox
Kingston	horsename	Kingston
Chris Evert	horsename	Chris Evert
Commando	horsename	Commando
Vaguely Noble	horsename	Vaguely Noble
Glidemaster	horsename	Glidemaster
Gurner's Lane	horsename	Gurner's Lane
April Run	horsename	April Run
Coaltown	horsename	Coaltown
Theatrical	horsename	Theatrical
Silic	horsename	Silic
Winning Colors	horsename	Winning Colors
Perrault	horsename	Perrault
Match II	horsename	Match
Gay Crusader	horsename	Gay Crusader
Never Bend	horsename	Never Bend
Three Troikas	horsename	Three Troikas
Kennedy Road	horsename	Kennedy Road
Roberto	horsename	Roberto
Overskate	horsename	Overskate
Frizzante	horsename	Frizzante
Forbra	horsename	Forbra
Survivor	horsename	Survivor
Royal Anthem	horsename	Royal Anthem
Royal Academy	horsename	Royal Academy
Bullish Luck	horsename	Bullish Luck
Lure	horsename	Lure
Bertrando	horsename	Bertrando
Street Sense	horsename	Street Sense
Omnium II	horsename	Omnium II
San San	horsename	San San
Bald Eagle	horsename	Bald Eagle
Baracouda	horsename	Baracouda
Sagace	horsename	Sagace
Marsyas	horsename	Marsyas
Silver Knight	horsename	Silver Knight
Sir Gallahad	horsename	Sir Gallahad
High Quest	horsename	High Quest
Count Turf	horsename	Count Turf
Isinglass	horsename	Isinglass
Épinard	horsename	Épinard
Counterpoint	horsename	Counterpoint
Sun Beau	horsename	Sun Beau
Kauto Star	horsename	Kauto Star
Nobiz Like Shobiz	horsename	Nobiz Like Shobiz
Fly So Free	horsename	Fly So Free
Al Capone II	horsename	Al Capone II
Eight Carat	horsename	Eight Carat
Peter Pan	horsename	Peter Pan III
Alcibiades	horsename	Alcibiades
Awesome Again	horsename	Awesome Again
Horse Chestnut	horsename	Horse Chestnut
Gainsborough	horsename	Gainsborough
One Count	horsename	One Count
Strike the Gold	horsename	Strike The Gold
Ethereal	horsename	Ethereal
Alinghi	horsename	Alinghi
Lite Light	horsename	Lite Light
Hansel	horsename	Hansel
Gladiateur	horsename	Gladiateur
Leilani	horsename	Leilani
Gallahadion	horsename	Gallahadion
Shogun Lodge	horsename	Shogun Lodge
Rubiton	horsename	Rubiton
Casual Look	horsename	Casual Look
Redoute's Choice	horsename	Redoute's Choice
Alan-a-Dale	horsename	Alan-a-Dale
Motivator	horsename	Motivator
Eight Thirty	horsename	Eight Thirty
Cavalcade	horsename	Cavalcade
Plaudit	horsename	Plaudit
Crepello	horsename	Crepello
Prince Rose	horsename	Prince Rose
Bend Or	horsename	Bend Or
Exbury	horsename	Exbury
Double Trigger	horsename	Double Trigger
Jaipur	horsename	Jaipur
Tetratema	horsename	Tetratema
Mumtaz Mahal	horsename	Mumtaz Mahal
The Tetrarch	horsename	The Tetrarch
Ksar	horsename	Ksar
Comrade	horsename	Comrade
Sham	horsename	Sham
Ballymoss	horsename	Ballymoss
Gentlemen	horsename	Gentlemen
Indian Skimmer	horsename	Indian Skimmer
Blue Peter	horsename	Blue Peter
Pharis	horsename	Pharis
Manila	horsename	Manila
Lyphard	horsename	Lyphard
Spinning World	horsename	Spinning World
Nureyev	horsename	Nureyev
Zafonic	horsename	Zafonic
Tremont	horsename	Tremont
King's Swan	horsename	King's Swan
Rheingold	horsename	Rheingold
Gold River	horsename	Gold River
Ivanjica	horsename	Ivanjica
Swain	horsename	Swain
War Relic	horsename	War Relic
Notional	horsename	Notional
Mariah's Storm	horsename	Mariah's Storm
George Royal	horsename	George Royal
Abernant	horsename	Abernant
Jim and Tonic	horsename	Jim And Tonic
Pleasantly Perfect	horsename	Pleasantly Perfect
Fit to Fight	horsename	Fit to Fight
Flyingbolt	horsename	Flyingbolt
Leonnatus Anteas	horsename	Leonnatus Anteas
Vuelve Candy B.	horsename	Vuelve Candy B.
Acatenango	horsename	Acatenango
Generous	horsename	Generous
Golden Choice	horsename	Golden Choice
Jim French	horsename	Jim French
Eishin Preston	horsename	Eishin Preston
Jet Pilot	horsename	Jet Pilot
Meadow Court	horsename	Meadow Court
Ajax	horsename	Ajax
King Tom	horsename	King Tom
Runaway Groom	horsename	Runaway Groom
Bowl of Flowers	horsename	Bowl of Flowers
Sulamani	horsename	Sulamani
Pleasant Colony	horsename	Pleasant Colony
Stage Door Johnny	horsename	Stage Door Johnny
Kissin' George	horsename	Kissin' George
Go for Gin	horsename	Go for Gin
Earth Summit	horsename	Earth Summit
Motrico	horsename	Motrico
Alsab	horsename	Alsab
Scat Daddy	horsename	Scat Daddy
Maskette	horsename	Maskette
Admire Moon	horsename	Admire Moon
Golden Pheasant	horsename	Golden Pheasant
Crisp	horsename	Crisp
Colorado King	horsename	Colorado King
Granville	horsename	Granville
Silver Birch	horsename	Silver Birch
Gun Bow	horsename	Gun Bow
Victory Gallop	horsename	Victory Gallop
Somethingroyal	horsename	Somethingroyal
Great Hunter	horsename	Great Hunter
Curlin	horsename	Curlin
Chateaugay	horsename	Chateaugay
Hard Spun	horsename	Hard Spun
Willsford	horsename	Willsford
Morvich	horsename	Morvich
Fifinella	horsename	Fifinella
Any Given Saturday	horsename	Any Given Saturday
Spokane	horsename	Spokane
Three Bars	horsename	Three Bars
Ardan	horsename	Ardan
Horatio Nelson	horsename	Horatio Nelson
Flying Childers	horsename	Flying Childers
Refuse To Bend	horsename	Refuse To Bend
Warrsan	horsename	Warrsan
Holy Roman Emperor	horsename	Holy Roman Emperor
Little Current	horsename	Little Current
Go and Go	horsename	Go And Go
Danzig Connection	horsename	Danzig Connection
Baden-Baden	horsename	Baden-Baden
Volodyovski	horsename	Volodyovski
Gate Dancer	horsename	Gate Dancer
Castleshane	horsename	Castleshane
Cristobal	horsename	Cristobal
Deputy Commander	horsename	Deputy Commander
Jaklin Klugman	horsename	Jaklin Klugman
Haradasun	horsename	Haradasun
Flying Paster	horsename	Flying Paster
Scottish Chieftain	horsename	Scottish Chieftain
Alphabet Soup	horsename	Alphabet Soup
Pearl Cap	horsename	Pearl Cap
Smart Strike	horsename	Smart Strike
Rags to Riches	horsename	Rags to Riches
Gato Del Sol	horsename	Gato Del Sol
Cannonade	horsename	Cannonade
Belmar	horsename	Belmar
Vengeance of Rain	horsename	Vengeance of Rain
Burgoo King	horsename	Burgoo King
Action This Day	horsename	Action This Day
Proud Clarion	horsename	Proud Clarion
Favorite Trick	horsename	Favorite Trick
Tabasco Cat	horsename	Tabasco Cat
Brocco	horsename	Brocco
Dehere	horsename	Dehere
April the Fifth	horsename	April the Fifth
Danever	horsename	Danever
Tony Bin	horsename	Tony Bin
Northern Taste	horsename	Northern Taste
Touch Gold	horsename	Touch Gold
Real Shadai	horsename	Real Shadai
Blushing Groom	horsename	Blushing Groom
Depth Charge	horsename	Depth Charge
Top Deck	horsename	Top Deck
Rocket Bar	horsename	Rocket Bar
Northern Spur	horsename	Northern Spur
Ruthless	horsename	Ruthless
Little Polveir	horsename	Little Polveir
Silverbulletday	horsename	Silverbulletday
Lena's Bar	horsename	Lena's Bar
Nellie Morse	horsename	Nellie Morse
Rahy	horsename	Rahy
Cherry Lake	horsename	Cherry Lake
Halo	horsename	Halo
Mollie McCarty	horsename	Mollie McCarty
Redoute's Dancer	horsename	Redoute's Dancer
Wahid	horsename	Wahid
Cut the Cake	horsename	Cut The Cake
St Reims	horsename	St Reims
Leica Guv	horsename	Leica Guv
Hail	horsename	Hail
Hades	horsename	Hades
So Casual	horsename	So Casual
Great Command	horsename	Great Command
Zonda	horsename	Zonda
Roysyn	horsename	Roysyn
Look Who's Talking	horsename	Look Who's Talking
Popsy	horsename	Popsy
The Phantom Chance	horsename	The Phantom Chance
Cavallieri	horsename	Cavallieri
Surfers Paradise	horsename	Surfers Paradise
Assagai	horsename	Assagai
Glorious Song	horsename	Glorious Song
The Gentry	horsename	The Gentry
Castletown	horsename	Castletown
Satisfy	horsename	Satisfy
Tidal Light	horsename	Tidal Light
Mainbrace	horsename	Mainbrace
Authorized	horsename	Authorized
West Tip	horsename	West Tip
Agnes Tachyon	horsename	Agnes Tachyon
Sarena Special	horsename	Sarena Special
Raise a Native	horsename	Raise a Native
Agnes Flight	horsename	Agnes Flight
Forty Niner	horsename	Forty Niner
Troy	horsename	Troy
Workman	horsename	Workman
Haiseiko	horsename	Haiseiko
Silver Train	horsename	Silver Train
Le Pacha	horsename	Le Pacha
Sky Conqueror	horsename	Sky Conqueror
Salerno	horsename	Salerno
Polynesian	horsename	Polynesian
Peter Pan	horsename	Peter Pan I
Urban Sea	horsename	Urban Sea
Teddy	horsename	Teddy
My Typhoon	horsename	My Typhoon
Hula Dancer	horsename	Hula Dancer
Tanya	horsename	Tanya
Prairie Bayou	horsename	Prairie Bayou
Bull Lea	horsename	Bull Lea
Black Tie Affair	horsename	Black Tie Affair
Fourstardave	horsename	Fourstardave
Seeking The Gold	horsename	Seeking The Gold
Nashoba's Key	horsename	Nashoba's Key
A P Valentine	horsename	A P Valentine
Irish River	horsename	Irish River
Riverman	horsename	Riverman
Dylan Thomas	horsename	Dylan Thomas
Aquarelliste	horsename	Aquarelliste
Pawneese	horsename	Pawneese
Sakhee	horsename	Sakhee
East of the Moon	horsename	East of the Moon
Louis Quatorze	horsename	Louis Quatorze
Pleasant Tap	horsename	Pleasant Tap
Colonial Affair	horsename	Colonial Affair
Diesis	horsename	Diesis
Editor's Note	horsename	Editor's Note
Halling	horsename	Halling
Kris	horsename	Kris
Yahoo	horsename	Yahoo
Bet Twice	horsename	Bet Twice
American Flag	horsename	American Flag
The Flying Dutchman	horsename	The Flying Dutchman
Octave	horsename	Octave
Summer Squall	horsename	Summer Squall
Silver Swallow	horsename	Silver Swallow
Matchem	horsename	Matchem
Cade	horsename	Cade
Sarava	horsename	Sarava
Herod	horsename	Herod
Unbridled's Song	horsename	Unbridled's Song
Partner	horsename	Partner
Regulus	horsename	Regulus
Sir Peter Teazle	horsename	Sir Peter Teazle
Kingmambo	horsename	Kingmambo
Empire Maker	horsename	Empire Maker
North Light	horsename	North Light
Kris Kin	horsename	Kris Kin
Oath	horsename	Oath
High-Rise	horsename	High-Rise
Highflyer	horsename	Highflyer
Benny the Dip	horsename	Benny the Dip
Little Missouri	horsename	Little Missouri
Golden Act	horsename	Golden Act
Marske	horsename	Marske
Friar Rock	horsename	Friar Rock
Erhaab	horsename	Erhaab
Teuflesberg	horsename	Teuflesberg
Bay Middleton	horsename	Bay Middleton
Housebuster	horsename	Housebuster
Dr Devious	horsename	Dr Devious
Quest for Fame	horsename	Quest for Fame
Kahyasi	horsename	Kahyasi
Florizel	horsename	Florizel
Buck's Boy	horsename	Buck's Boy
Hastings	horsename	Hastings
Lalun	horsename	Lalun
Tiago	horsename	Tiago
Golden Fleece	horsename	Golden Fleece
Reference Point	horsename	Reference Point
Johren	horsename	Johren
Henbit	horsename	Henbit
Shirley Heights	horsename	Shirley Heights
Red Bullet	horsename	Red Bullet
Ajina	horsename	Ajina
Sir Bear	horsename	Sir Bear
Concern	horsename	Concern
Spendthrift	horsename	Spendthrift
De La Rose	horsename	De La Rose
Commendable	horsename	Commendable
Kona Gold	horsename	Kona Gold
Zamazaan	horsename	Zamazaan
Jambalaya	horsename	Jambalaya
Macho Uno	horsename	Macho Uno
Dreaming of Anna	horsename	Dreaming of Anna
Success Express	horsename	Success Express
Is It True	horsename	Is It True
Capote	horsename	Capote
Tasso	horsename	Tasso
Boston Harbor	horsename	Boston Harbor
Timber Country	horsename	Timber Country
The Green Monkey	horsename	The Green Monkey
Better Than Honour	horsename	Better Than Honour
Rhythm	horsename	Rhythm
Silver Patriarch	horsename	Silver Patriarch
Celtic Swing	horsename	Celtic Swing
Mineshaft	horsename	Mineshaft
Finsceal Beo	horsename	Finsceal Beo
Gulch	horsename	Gulch
Miss Finland	horsename	Miss Finland
Sweep	horsename	Sweep
Leroidesanimaux	horsename	Leroidesanimaux
Wilko	horsename	Wilko
Farma Way	horsename	Farma Way
Vindication	horsename	Vindication
Somebeachsomewhere	horsename	Somebeachsomewhere
Creme Fraiche	horsename	Creme Fraiche
Sunshine Forever	horsename	Sunshine Forever
Canadian Champ	horsename	Canadian Champ
Turkoman	horsename	Turkoman
Shamardal	horsename	Shamardal
Mad Hatter	horsename	Mad Hatter
Mad Play	horsename	Mad Play
Limehouse	horsename	Limehouse
Borrego	horsename	Borrego
Scorpion	horsename	Scorpion
Caveat	horsename	Caveat
Flocarline	horsename	Flocarline
Whimsical	horsename	Whimsical
Rhine Maiden	horsename	Rhine Maiden
Brass Hat	horsename	Brass Hat
Coastal	horsename	Coastal
Comely	horsename	Comely
Summing	horsename	Summing
Bubbling Over	horsename	Bubbling Over
Set Them Free	horsename	Set Them Free
English Channel	horsename	English Channel
Peeping Fawn	horsename	Peeping Fawn
Travelling Victor	horsename	Travelling Victor
Sky Jack	horsename	Sky Jack
Ancient Title	horsename	Ancient Title
Big Truck	horsename	Big Truck
Hail To Reason	horsename	Hail To Reason
Landseer	horsename	Landseer
Star Pilot	horsename	Star Pilot
Midnight Lute	horsename	Midnight Lute
Honest Pleasure	horsename	Honest Pleasure
Anees	horsename	Anees
Gilded Time	horsename	Gilded Time
Answer Lively	horsename	Answer Lively
Colstar	horsename	Colstar
Ipi Tombe	horsename	Ipi Tombe
Pulpit	horsename	Pulpit
Turn-To	horsename	Turn-To
Skywalker	horsename	Skywalker
Hail To All	horsename	Hail To All
Pine Island	horsename	Pine Island
Stop The Music	horsename	Stop The Music
Meadow Star	horsename	Meadow Star
Touchstone	horsename	Touchstone
Alluvial	horsename	Alluvial
Rakwool	horsename	Rakwool
Typecast	horsename	Typecast
Monsun	horsename	Monsun
Empire Rose	horsename	Empire Rose
Awesome Gem	horsename	Awesome Gem
Malua	horsename	Malua
Master O'Reilly	horsename	Master O'Reilly
Viva Pataca	horsename	Viva Pataca
Nownownow	horsename	Nownownow
Flying Dancer	horsename	Flying Dancer
Motivation	horsename	Motivation
The Hawk	horsename	The Hawk
Smoke Glacken	horsename	Smoke Glacken
Blue Peter	horsename	Blue Peter
Busanda	horsename	Busanda
Efficient	horsename	Efficient
Playful Act	horsename	Playful Act
Top Flight	horsename	Top Flight
Offlee Wild	horsename	Offlee Wild
El Segundo	horsename	El Segundo
Celtic Arms	horsename	Celtic Arms
Carotene	horsename	Carotene
Langfuhr	horsename	Langfuhr
Tikkanen	horsename	Tikkanen
Turgeon	horsename	Turgeon
Droll Role	horsename	Droll Role
Cicada	horsename	Cicada
Devil Diver	horsename	Devil Diver
Affectionately	horsename	Affectionately
Dante	horsename	Dante
Grundy	horsename	Grundy
Bustino	horsename	Bustino
Nimbus	horsename	Nimbus
Nimbus	horsename	Nimbus
Susan's Girl	horsename	Susan's Girl
Native Diver	horsename	Native Diver
Street Cry	horsename	Street Cry
Artful	horsename	Artful
Two Lea	horsename	Two Lea
Grand Slam	horsename	Grand Slam
Sagaro	horsename	Sagaro
Cynisca	horsename	Cynisca
War Pass	horsename	War Pass
Alydeed	horsename	Alydeed
Gallant Bloom	horsename	Gallant Bloom
Snow White	horsename	Snow White
Black Toney	horsename	Black Toney
Searching	horsename	Searching
Star Over The Bay	horsename	Star Over The Bay
Christian Cullen	horsename	Christian Cullen
Marienbard	horsename	Marienbard
Collier Hill	horsename	Collier Hill
Bewitch	horsename	Bewitch
Gamely	horsename	Gamely
Ta Wee	horsename	Ta Wee
Sirmione	horsename	Sirmione
Talkin Man	horsename	Talkin Man
Better Talk Now	horsename	Better Talk Now
Red Anchor	horsename	Red Anchor
Black Helen	horsename	Black Helen
Princess Doreen	horsename	Princess Doreen
Paseana	horsename	Paseana
Baulking Green	horsename	Baulking Green
Country Star	horsename	Country Star
Roseben	horsename	Roseben
Ace Marine	horsename	Ace Marine
Luke Blackburn	horsename	Luke Blackburn
Broomstick	horsename	Broomstick
Sir Archy	horsename	Sir Archy
Tippity Witchet	horsename	Tippity Witchet
Myrtlewood	horsename	Myrtlewood
Tosmah	horsename	Tosmah
Parole	horsename	Parole
Coretta	horsename	Coretta
Chatham	horsename	Chatham
Hamburg	horsename	Hamburg
Tank's Prospect	horsename	Tank's Prospect
Flaming Page	horsename	Flaming Page
Flawlessly	horsename	Flawless
Troytown	horsename	Troytown
Oh So Sharp	horsename	Oh So Sharp
Pappa Fourway	horsename	Pappa Fourway
Bella Paola	horsename	Bella Paola
Regal Intention	horsename	Regal Intention
Cottage Rake	horsename	Cottage Rake
Schillaci	horsename	Schillaci
Miss Andretti	horsename	Miss Andretti
Dayjur	horsename	Dayjur
Serena's Song	horsename	Serena’s Song
Never Say Die	horsename	Never Say Die
Monksfield	horsename	Monksfield
Mtoto	horsename	Mtoto
Vice Regent	horsename	Vice Regent
Badsworth Boy	horsename	Badsworth Boy
Ardross	horsename	Ardross
Colorado	horsename	Colorado
Ard Patrick	horsename	Ard Patrick
Park Top	horsename	Park Top
Landaluce	horsename	Landaluce
Sceptre	horsename	Sceptre
Coronado's Quest	horsename	Coronado's Quest
Emperor of Norfolk	horsename	Emperor of Norfolk
Kingarvie	horsename	Kingarvie
Lady Lightfoot	horsename	Lady Lightfoot
Exotic Dancer	horsename	Exotic Dancer
Diamond Jubilee	horsename	Diamond Jubilee
Persimmon	horsename	Persimmon
Yo Tambien	horsename	Yo Tambien
Pinza	horsename	Pinza
Alcide	horsename	Alcide
Alycidon	horsename	Alycidon
Captain Christy	horsename	Captain Christy
Wayward Lad	horsename	Wayward Lad
Stagehand	horsename	Stagehand
Sharpo	horsename	Sharpo
Triptych	horsename	Triptych
Peace Rules	horsename	Peace Rules
Quashed	horsename	Quashed
Sun Chariot	horsename	Sun Chariot
Petite Etoile	horsename	Petite Etoile
Cougar II	horsename	Cougar II
Right Boy	horsename	Right Boy
Meld	horsename	Meld
Levmoss	horsename	Levmoss
Manduro	horsename	Manduro
Mom's Command	horsename	Mom's Command
Effervescing	horsename	Effervescing
Hurry On	horsename	Hurry On
Sakhee's Secret	horsename	Sakhee's Secret
Tulyar	horsename	Tulyar
Palestine	horsename	Palestine
Ginger Punch	horsename	Ginger Punch
Inferno	horsename	Inferno
Silmaril	horsename	Silmaril
Hurley Burley	horsename	Hurley Burley
Master Derby	horsename	Master Derby
Chance Shot	horsename	Chance Shot
Iroquois	horsename	Iroquois
Play the King	horsename	Play the King
Eremein	horsename	Eremain
Soaring Free	horsename	Soaring Free
King's Bishop	horsename	King's Bishop
Bowling Brook	horsename	Bowling Brook
Chester	horsename	Chester
Bull Page	horsename	Bull Page
Tomcito	horsename	Tomcito
Sensitive Prince	horsename	Sensitive Prince
Habibti	horsename	Habibti
Bold 'n Determined	horsename	Bold 'n Determined
Great Communicator	horsename	Great Communicator
Alywow	horsename	Alywow
Pyro	horsename	Pyro
Indian Blessing	horsename	Indian Blessing
Pistols and Roses	horsename	Pistols and Roses
Real Delight	horsename	Real Delight
Zambezi Sun	horsename	Zambezi Sun
Bull Dog	horsename	Bull Dog
Jezabeel	horsename	Jezabeel
Arch Hall	horsename	Arch Hall
Son of Briartic	horsename	Son of Briartic
Sealy Hill	horsename	Sealy Hill
Weekend Hussler	horsename	Weekend Hussler
I'm Henry	horsename	I'm Henry
Jolly Jake	horsename	Jolly Jake
Our Flight	horsename	Our Flight
Isle of Man	horsename	Isle Of Man
Ring the Bell	horsename	Ring The Bell
Ruling Lad	horsename	Ruling Lad
Kaiser	horsename	Kaiser
Silver Lad	horsename	Silver Lad
Uncle Remus	horsename	Uncle Remus
General Assembly	horsename	General Assembly
Thor's Echo	horsename	Thor's Echo
C'est La Guerre	horsename	C'est La Guerre
La Lorgnette	horsename	La Lorgnette
Woodman	horsename	Woodman
Beduino	horsename	Beduino
Hector Protector	horsename	Hector Protector
Shady Well	horsename	Shady Well
Budpath	horsename	Budpath
Mike Fox	horsename	Mike Fox
Commentator	horsename	Commentator
Dixieland Band	horsename	Dixieland Band
Queen Mab	horsename	Queen Mab
Spark	horsename	Spark
Selima	horsename	Selima
Nonoalco	horsename	Nonoalco
Blushing John	horsename	Blushing John
Wonder Where	horsename	Wonder Where
Cherokee Run	horsename	Cherokee Run
Seachange	horsename	Seachange
Denman	horsename	Denman
Display	horsename	Display
Jalil	horsename	Jalil
Bold Ruritana	horsename	Bold Ruritana
Northernette	horsename	Northernette
Prize Lady	horsename	Prize Lady
Sweet Embrace	horsename	Sweet Embrace
Master Minded	horsename	Master Minded
Royal Chocolate	horsename	Royal Chocolate
Moon Ballad	horsename	Moon Ballad
Bobbyjo	horsename	Bobbyjo
Reviewer	horsename	Reviewer
Exclusive Native	horsename	Exclusive Native
Shenanigans	horsename	Shenanigans
Asiatic Boy	horsename	Asiatic Boy
Big Brown	horsename	Big Brown
Red Ransom	horsename	Red Ransom
Nijinsky's Secret	horsename	Nijinsky's Secret
Proud Truth	horsename	Proud Truth
Comply or Die	horsename	Comply or Die
Ginger Gold	horsename	Ginger Gold
McKelvey	horsename	McKelvey
Colonel John	horsename	Colonel John
Recapturetheglory	horsename	Recapturetheglory
Monty's Pass	horsename	Monty's Pass
Beau Genius	horsename	Beau Genius
Hill Gail	horsename	Hill Gail
Red God	horsename	Red God
Pretendre	horsename	Pretendre
Bindaree	horsename	Bindaree
Milwaukee Brew	horsename	Milwaukee Brew
Hillsdale	horsename	Hillsdale
Angle Light	horsename	Angle Light
Gayego	horsename	Gayego
Peppers Pride	horsename	Peppers Pride
Sebring	horsename	Sebring
Divine Madonna	horsename	Divine Madonna
Desert War	horsename	Desert War
Eight Belles	horsename	Eight Belles
Tale of Ekati	horsename	Tale of Ekati
Mairzy Doates	horsename	Mairzy Doates
Good Ba Ba	horsename	Good Ba Ba
Corbiere	horsename	Corbiere
Henrythenavigator	horsename	Henrythenavigator
Amounis	horsename	Amounis
Casino Drive	horsename	Casino Drive
Hermis	horsename	Hermis
Icabad Crane	horsename	Icabad Crane
Prized	horsename	Prized
Apache Cat	horsename	Apache Cat
Even Stevens	horsename	Even Stevens
Bold Personality	horsename	Bold Personality
Voy Por Ustedes	horsename	Voy Por Ustedes
Divine Park	horsename	Divine Park
Harlem Rocker	horsename	Harlem Rocker
Ragusa	horsename	Ragusa
Symboli Kris S	horsename	Symboli Kris S
Taiki Shuttle	horsename	Taiki Shuttle
Kane Hekili	horsename	Kane Hekili
Open Mind	horsename	Open Mind
Da' Tara	horsename	Da'Tara
New Approach	horsename	New Approach
Kip Deville	horsename	Kip Deville
Macho Again	horsename	Macho Again
Golden Cygnet	horsename	Golden Cygnet
Coventry	horsename	Coventry
Victorian	horsename	Victorian
Ace Admiral	horsename	Ace Admiral
Flying Ebony	horsename	Flying Ebony
Not Bourbon	horsename	Not Bourbon
Zarathustra	horsename	Zarathustra
Bally Ache	horsename	Bally Ache
Gallant Sir	horsename	Gallant Sir
Pompoon	horsename	Pompoon
Silence Suzuka	horsename	Silence Suzuka
Peace Chance	horsename	Peace Chance
El Condor Pasa	horsename	El Condor Pasa
Vodka	horsename	Vodka
Deep Sky	horsename	Deep Sky
Mobil	horsename	Mobil
True Metropolitan	horsename	True Metropolitan
Win City	horsename	Win City
Cudgel	horsename	Cudgel
Green Dancer	horsename	Green Dancer
Greinton	horsename	Greinton
Peaks and Valleys	horsename	Peaks and Valleys
Red Rocks	horsename	Red Rocks
Cacique	horsename	Cacique
Beat Hollow	horsename	Beat Hollow
Saumarez	horsename	Saumarez
Daiwa Scarlet	horsename	Daiwa Scarlet
Hystericalady	horsename	Hystericalady
Hourless	horsename	Hourless
Omar Khayyam	horsename	Omar Khayyam
Horometer	horsename	Horometer
Sovereign Dancer	horsename	Sovereign Dancer
Royal Palace	horsename	Royal Palace
Ribocco	horsename	Ribocco
Damrosch	horsename	Damrosch
Lucky Debonair	horsename	Lucky Debonair
Quiet Resolve	horsename	Quiet Resolve
Lashkari	horsename	Lashkari
Kalanisi	horsename	Kalanisi
Royal Heroine	horsename	Royal Heroine
Open Fire	horsename	Open Fire
Bounding Home	horsename	Bounding Home
Blue Man	horsename	Blue Man
Ildrim	horsename	Ildrim
Finasseur	horsename	Finasseur
Uttermost	horsename	Uttermost
Colonel Holloway	horsename	Colonel Holloway
Roving Boy	horsename	Roving Boy
Meisho Samson	horsename	Meisho Samson
Behrens	horsename	Behrens
Prospective Dolly	horsename	Prospective Dolly
Merger	horsename	Merger
Cafe Prince	horsename	Cafe Prince
Lucarno	horsename	Lucarno
Viceregal	horsename	Viceregal
Trempolino	horsename	Trempolino
Duke of Marmalade	horsename	Duke of Marmalade
Frozen Fire	horsename	Frozen Fire
Conniver	horsename	Conniver
Canadiana	horsename	Canadiana
Regal Classic	horsename	Regal Classic
Plugged Nickle	horsename	Plugged Nickle
L'Alezane	horsename	L'Alezane
Sacahuista	horsename	Sacahuista
A Bit O'Gold	horsename	A Bit O'Gold
Goldikova	horsename	Goldikova
Frisk Me Now	horsename	Frisk Me Now
McDynamo	horsename	McDynamo
Determine	horsename	Determine
La Voyageuse	horsename	La Voyageuse
Silver Spoon	horsename	Silver Spoon
Kris S.	horsename	Kris S.
Tin Cup Chalice	horsename	Tin Cup Chalice
Ridgewood Pearl	horsename	Ridgewood Pearl
Zenyatta	horsename	Zenyatta
Cozzene	horsename	Cozzene
Purchase	horsename	Purchase
Music Note	horsename	Music Note
Leonatus	horsename	Leonatus
Ponder	horsename	Ponder
Bold Venture	horsename	Bold Venture
Migoli	horsename	Migoli
King James	horsename	King James
Natalma	horsename	Natalma
Decidedly	horsename	Decidedly
Venetian Way	horsename	Venetian Way
Pine Bluff	horsename	Pine Bluff
Avatar	horsename	Avatar
Pillory	horsename	Pillory
Sunfire	horsename	Sunfire
Campfire	horsename	Campfire
Red Giant	horsename	Red Giant
Snow Chief	horsename	Snow Chief
Princess Coup	horsename	Princess Coup
Vision d'Etat	horsename	Vision d'Etat
Zarkava	horsename	Zarkava
Stylish Century	horsename	Stylish Century
Bessarabian	horsename	Bessarabian
Brave Raj	horsename	Brave Raj
All the Good	horsename	All the Good
Piet	horsename	Piet
Arise	horsename	Arise
Amberoid	horsename	Amberoid
Quill	horsename	Quill
Martial	horsename	Martial
Artie Schiller	horsename	Artie Schiller
Basqueian	horsename	Basqueian
Volponi	horsename	Volponi
Cat Thief	horsename	Cat Thief
Midshipman	horsename	Midshipman
Stardom Bound	horsename	Stardom Bound
Raven's Pass	horsename	Raven's Pass
Maintenon	horsename	Maintenon
Parth	horsename	Parth
Proctor Knott	horsename	Proctor Knott
Viewed	horsename	Viewed
Hoop Jr.	horsename	Hoop Jr.
Shut Out	horsename	Shut Out
Fatal Bullet	horsename	Fatal Bullet
Wilderness Song	horsename	Wilderness Song
Ice Water	horsename	Ice Water
Tom Ochiltree	horsename	Tom Ochiltree
Swoon's Son	horsename	Swoon's Son
Mark-Ye-Well	horsename	Mark-Ye-Well
Kentucky	horsename	Kentucky
Xtra Heat	horsename	Xtra Heat
Timoleon	horsename	Timoleon
Old Hat	horsename	Old Hat
Sailor II	horsename	Sailor
Career Boy	horsename	Career Boy
Stay Gold	horsename	Stay Gold
Denis of Cork	horsename	Denis of Cork
Dedicate	horsename	Dedicate
Roman Brother	horsename	Roman Brother
Dice	horsename	Dice
Fabius	horsename	Fabius
Triple Bend	horsename	Triple Bend
Fisherman	horsename	Fisherman
Banassa	horsename	Banassa
Declan's Moon	horsename	Declan's Moon
Mongo	horsename	Mongo
Precious Kitten	horsename	Precious Kitten
Lord Gyllene	horsename	Lord Gyllene
Honour and Glory	horsename	Honour and Glory
Nice Dancer	horsename	Nice Dancer
Porterhouse	horsename	Porterhouse
Disturbingthepeace	horsename	Disturbingthepeace
Ballingarry	horsename	Ballingarry
Subotica	horsename	Subotica
Lit de Justice	horsename	Lit de Justice
Night Raid	horsename	Night Raid
St Jovite	horsename	St Jovite
Solario	horsename	Solario
Tidal Bay	horsename	Tidal Bay
My Way de Solzen	horsename	My Way De Solzen
Cavan	horsename	Cavan
Miss Cavandish	horsename	Miss Cavandish
Florida Pearl	horsename	Florida Pearl
Well Chief	horsename	Well Chief
Hurry to Market	horsename	Hurry to Market
Hardy Eustace	horsename	Hardy Eustace
Inglis Drever	horsename	Inglis Drever
Flagship Uberalles	horsename	Flagship Uberalles
Tiutchev	horsename	Tiutchev
Viking Flagship	horsename	Viking Flagship
Itsallgreektome	horsename	Itsallgreektome
Priolo	horsename	Priolo
Samantha Miss	horsename	Samantha Miss
Bold Reason	horsename	Bold Reason
Meadow Skipper	horsename	Meadow Skipper
Azra	horsename	Azra
Key to the Mint	horsename	Key to the Mint
Blue Norther	horsename	Blue Norther
Harold	horsename	Harold
Imperial Choice	horsename	Imperial Choice
Kingfisher	horsename	Kingfisher
Dutch Oven	horsename	Dutch Oven
Square Eddie	horsename	Square Eddie
Old Fashioned	horsename	Old Fashioned
Veandercross	horsename	Veandercross
Chilukki	horsename	Chilukki
Candy Éclair	horsename	Candy Éclair
Quadrangle	horsename	Quadrangle
Squirtle Squirt	horsename	Squirtle Squirt
Bold Bidder	horsename	Bold Bidder
Bee Bee Bee	horsename	Bee Bee Bee
Eternal Search	horsename	Eternal Search
Tempted	horsename	Tempted
Rhinestone Cowboy	horsename	Rhinestone Cowboy
Cum Laude Laurie	horsename	Cum Laude Laurie
Fairy Chant	horsename	Fairy Chant
Mar-Kell	horsename	Mar-Kell
Noblesse	horsename	Noblesse
Blandford	horsename	Blandford
Trigo	horsename	Trigo
Conduit	horsename	Conduit
Iris's Gift	horsename	Iris's Gift
Aymond	horsename	Aymond
Willie the Kid	horsename	Willie the Kid
Sunstar	horsename	Sunstar
Plaisanterie	horsename	Plaisanterie
Estrapade	horsename	Estrapade
It's In The Air	horsename	It's In The Air
Faultless	horsename	Faultless
Run the Gantlet	horsename	Run the Gantlet
Commanche Run	horsename	Commanche Run
Track Robbery	horsename	Track Robbery
Sightseek	horsename	Sightseek
Life's Magic	horsename	Life's Magic
Escena	horsename	Escena
One Dreamer	horsename	One Dreamer
Spain	horsename	Spain
Relaxed Gesture	horsename	Relaxed Gesture
River Memories	horsename	River Memories
Inside Information	horsename	Inside Information
Smuggler	horsename	Smuggler
Candy Stripes	horsename	Candy Stripes
Eliza	horsename	Eliza
Affluent	horsename	Affluent
Strawberry Road	horsename	Strawberry Road
Fraise	horsename	Fraise
Cryptoclearance	horsename	Cryptoclearance
El Prado	horsename	El Prado
Menow	horsename	Menow
Rainbows for Life	horsename	Rainbows For Life
Mystery Giver	horsename	Mystery Giver
Mioland	horsename	Mioland
Lomond	horsename	Lomond
My Charmer	horsename	My Charmer
Got Koko	horsename	Got Koko
Lush Lashes	horsename	Lush Lashes
Soldier of Fortune	horsename	Soldier of Fortune
Waya	horsename	Waya
Mac Diarmida	horsename	Mac Diarmida
Minoru	horsename	Minoru
Manistique	horsename	Manistique
Nevele Pride	horsename	Nevele Pride
Four-and-Twenty	horsename	Four-and-Twenty
Pass Catcher	horsename	Pass Catcher
Merry Ruler	horsename	Merry Ruler
Coniston Bluebird	horsename	Coniston Bluebird
Cryptocloser	horsename	Cryptocloser
Dulcify	horsename	Dulcify
Triplicate	horsename	Triplicate
Tammany	horsename	Tammany
Anita Peabody	horsename	Anita Peabody
Dance Floor	horsename	Dance Floor
Dungannon	horsename	Dungannon
Detroit City	horsename	Detroit City
Friesan Fire	horsename	Friesan Fire
Oversight	horsename	Oversight
Halma	horsename	Halma
Sir Walter	horsename	Sir Walter
Sir Slick	horsename	Sir Slick
Quicken Tree	horsename	Quicken Tree
J. O. Tobin	horsename	J. O. Tobin
Terrang	horsename	Terrang
Native Upmanship	horsename	Native Upmanship
Rince Ri	horsename	Rince Ri
Khaled	horsename	Khaled
Beef or Salmon	horsename	Beef Or Salmon
Candy Ride	horsename	Candy Ride
Well Armed	horsename	Well Armed
Overdose	horsename	Overdose
Chinook Pass	horsename	Chinook Pass
Bel Sheba	horsename	Bel Sheba
Briseis	horsename	Briseis
Comedy of Errors	horsename	Comedy of Errors
Mane Minister	horsename	Mane Minister
Lamb Chop	horsename	Lamb Chop
Politely	horsename	Politely
Fappiano	horsename	Fappiano
Corinthian	horsename	Corinthian
Big Buck's	horsename	Big Buck's
Mon Mome	horsename	Mon Mome
Celtic Ash	horsename	Celtic Ash
Jack Horner	horsename	Jack Horner
Athens Wood	horsename	Athens Wood
Pioneerof the Nile	horsename	the Nile
Majesty's Prince	horsename	Majesty's Prince
Raintrap	horsename	Raintrap
Pommern	horsename	Pommern
Adam's Apple	horsename	Adam's Apple
Sly Fox	horsename	Sly Fox
Almutawakel	horsename	Almutawakel
Wichita Lineman	horsename	Wichita Lineman
Hear The Echo	horsename	Hear The Echo
Papa Clem	horsename	Papa Clem
Hiraji	horsename	Hiraji
Foxzami	horsename	Foxzami
Macdougal	horsename	Macdougal
Megahertz	horsename	Megahertz
Figonero	horsename	Figonero
Volksraad	horsename	Volksraad
Pharos	horsename	Pharos
Oil Capitol	horsename	Oil Capitol
Rogilla	horsename	Rogilla
Van der Hum	horsename	Van der Hum
Gold and Black	horsename	Gold and Black
Rogan Josh	horsename	Rogan Josh
Pasteurized	horsename	Pasteurized
Prove It	horsename	Prove It
Deputed Testamony	horsename	Deputed Testamony
Milkmaid	horsename	Milkmaid
Cure-All	horsename	Cure-All
Einstein	horsename	Einstein
Cox's Ridge	horsename	Cox's Ridge
Sailor's Guide	horsename	Sailor's Guide
I Want Revenge	horsename	I Want Revenge
Desert Wine	horsename	Desert wine
Next Move	horsename	Next Move
Mine That Bird	horsename	Mine That Bird
General Quarters	horsename	General Quarters
Apollo	horsename	Apollo
Rachel Alexandra	horsename	Rachel Alexandra
In Reality	horsename	In Reality
Intentionally	horsename	Intentionally
Relaunch	horsename	Relaunch
Vagrant	horsename	Vagrant
Onion	horsename	Onion
Day Star	horsename	Day Star
Classy 'n Smart	horsename	Classy 'n Smart
Fonso	horsename	Fonso
Riley	horsename	Riley
Macbeth II	horsename	Macbeth II
Kingman	horsename	Kingman
Lord Murphy	horsename	Lord Murphy
Joe Cotton	horsename	Joe Cotton
Buchanan	horsename	Buchanan
Pink Star	horsename	Pink Star
Personality	horsename	Personality
Ben Ali	horsename	Ben Ali
Behave Yourself	horsename	Behave Yourself
Jean Bereaud	horsename	Jean Bereaud
Fame and Glory	horsename	Fame and Glory
Cuddle	horsename	Cuddle
Africander	horsename	Africander
Brown Jack	horsename	Brown Jack
Prove Out	horsename	Prove Out
Furys Order	horsename	FURYS ORDER
Sea the Stars	horsename	Sea The Stars
Whiskery	horsename	Whiskery
Worth	horsename	Worth
Mathew	horsename	Mathew
Black Bear Island	horsename	Black Bear Island
Snow Knight	horsename	Snow Knight
Chandler	horsename	Chandler
Mining My Own	horsename	Mining My Own
Niche	horsename	Niche
Lady Pitt	horsename	Lady Pitt
Punjabi	horsename	Punjabi
Clyde Van Dusen	horsename	Clyde Van Dusen
Providential	horsename	Providential
Annihilate 'Em	horsename	Annihilate 'em
Tapit	horsename	Tapit
Broad Brush	horsename	Broad Brush
Codex	horsename	Codex
High Echelon	horsename	High Echelon
Kribensis	horsename	Kribensis
Slewacide	horsename	Slewacide
Bold Reasoning	horsename	Bold Reasoning
High Gun	horsename	High Gun
Dauber	horsename	Dauber
Noholme	horsename	Noholme
Virgil	horsename	Virgil
Nodouble	horsename	Nodouble
Lieut. Gibson	horsename	Lieut. Gibson
No Class	horsename	No Class
Silent Screen	horsename	Silent Screen
Ogygian	horsename	Ogygian
Sherluck	horsename	Sherluck
Cape Cross	horsename	Cape Cross
Faireno	horsename	Faireno
Summer Bird	horsename	Summer Bird
Golden Sword	horsename	Golden Sword
Sariska	horsename	Sariska
Hoist The Flag	horsename	Hoist The Flag
Tenerani	horsename	Tenerani
Dunkirk	horsename	Dunkirk
Sensational	horsename	Sensational
Scintillo	horsename	Scintillo
Wajima	horsename	Wajima
Hermit	horsename	Hermit
Researcher	horsename	Researcher
Hollywood Wildcat	horsename	Hollywood Wildcat
Typhoon II	horsename	Typhoon II
His Eminence	horsename	His Eminence
Montrose	horsename	Montrose
Dearly Precious	horsename	Dearly Precious
Chant	horsename	Chant
Agile	horsename	Agile
Winter's Tale	horsename	Winter's Tale
Jacola	horsename	Jacola
Phalanx	horsename	Phalanx
Milwaukee Appeal	horsename	Milwaukee Appeal
Eye of the Leopard	horsename	Eye of the Leopard
Eye of the Sphynx	horsename	Eye of the Sphynx
Dauphin Fabuleux	horsename	Dauphin Fabuleux
Luthier	horsename	Luthier
Michelozzo	horsename	Michelozzo
Elwood	horsename	Elwood
Kotashaan	horsename	Kotashaan
Opera House	horsename	Opera House
Symboli Rudolf	horsename	Symboli Rudolf
Came Home	horsename	Came Home
Lookout	horsename	Lookout
Manuel	horsename	Manuel
Elocutionist	horsename	Elocutionist
Sandford Prince	horsename	Sandford Prince
Blast of Storm	horsename	Blast of Storm
Judge Himes	horsename	Judge Himes
Tokai Teio	horsename	Tokai Teio
Sublimity	horsename	Sublimity
Cuan Na Grai	horsename	Cuan Na Grai
Aloma's Ruler	horsename	Aloma's Ruler
Katchit	horsename	Katchit
Mahmoud	horsename	Mahmoud
Mamool	horsename	Mamool
Commanche Court	horsename	Commanche Court
Dorans Pride	horsename	Dorans Pride
Vanlandingham	horsename	Vanlandingham
Sir Huon	horsename	Sir Huon
White Skies	horsename	White Skies
Indian Maid	horsename	Indian Maid
Market Wise	horsename	Market Wise
Panty Raid	horsename	Panty Raid
Primonetta	horsename	Primonetta
Payton d'Oro	horsename	Payton d'Oro
Vagrancy	horsename	Vagrancy
Miss Request	horsename	Miss Request
Office Queen	horsename	Office Queen
Mejiro McQueen	horsename	Mejiro McQueen
St. Bass	horsename	St. Bass
Watervale	horsename	Watervale
Blue Spec	horsename	Blue Spec
Grand Flaneur	horsename	Grand Flaneur
Quiet American	horsename	Quiet American
Royal Tourist	horsename	Royal Tourist
Meddler	horsename	Meddler
Greek Money	horsename	Greek Money
Tokino Minoru	horsename	Tokino Minoru
The Bard	horsename	The Bard
The Parader	horsename	The Parader
George Smith	horsename	George Smith
Candy Spots	horsename	Candy Spots
Elusive Wave	horsename	Elusive Wave
Stacelita	horsename	Stacelita
Devil's Bag	horsename	Devil's Bag
Stone Street	horsename	Stone Street
Wintergreen	horsename	Wintergreen
Easter Stockings	horsename	Easter Stockings
Pet Bully	horsename	Pet Bully
Big Drama	horsename	Big Drama
Paul Jones	horsename	Paul Jones
Tudor Queen	horsename	Tudor Queen
Blue Gown	horsename	Blue Gown
Nassipour	horsename	Nassipour
Marchand d'Or	horsename	Marchand d'Or
Artax	horsename	Artax
Southern Maid	horsename	Southern Maid
Quality Road	horsename	Quality Road
Barcaldine	horsename	Barcaldine
Opening Verse	horsename	Opening Verse
In Excess	horsename	Horse
Donau	horsename	Donau
Bold	horsename	Bold
Hasty Road	horsename	Hasty Road
Safely Kept	horsename	Safely Kept
Ladkin	horsename	Ladkin
The Finn	horsename	The Finn
Cool Dawn	horsename	Cool Dawn
Mr C B	horsename	Mr C B
Camarero	horsename	Camarero
Asteroid	horsename	Asteroid
Lido Palace	horsename	Lido Palace
Captain Bodgit	horsename	Captain Bodgit
Ambassador of Luck	horsename	Ambassador of Luck
Super Moment	horsename	Super Moment
One for Rose	horsename	One For Rose
Momigi	horsename	Momigi
Big Pebble	horsename	Big Pebble
Midway Road	horsename	Midway Road
Ballindaggin	horsename	Ballindaggin
Caro	horsename	Caro
Madelia	horsename	Madelia
Tejano Run	horsename	Tejano Run
Magic Weisner	horsename	Magic Weisner
Bois Roussel	horsename	Bois Roussel
Westerner	horsename	Westerner
Prince Royal	horsename	Prince Royal
Raceland	horsename	Raceland
Two Item Limit	horsename	Two Item Limit
Jostle	horsename	Jostle
In the Wings	horsename	In The Wings
Oliver's Twist	horsename	Oliver's Twist
Boldnesian	horsename	Boldnesian
Miss Alleged	horsename	Miss Alleged
Scrappy T	horsename	Scrappy T
Inish Glora	horsename	Inish Glora
Assert	horsename	Assert
Domedriver	horsename	Domedriver
Corporate Report	horsename	Corporate Report
Le Glorieux	horsename	Le Glorieux
Brian's Time	horsename	Brian's Time
Last Tycoon	horsename	Last Tycoon
Pentire	horsename	Pentire
Be My Guest	horsename	Be My Guest
Straw Bear	horsename	Straw Bear
Harchibald	horsename	Harchibald
Rip Van Winkle	horsename	Rip Van Winkle
Smarten	horsename	Smarten
Johar	horsename	Johar
Darshaan	horsename	Darshaan
Devil His Due	horsename	Devil His Due
Gone West	horsename	Gone West
Eddington	horsename	Eddington
Bold Lad	horsename	Bold Lad
Bold Lad	horsename	Bold Lad
Golden Missile	horsename	Golden Missile
Include	horsename	Include
Muscle Hill	horsename	Muscle Hill
Successor	horsename	Successor
Platter	horsename	Platter
Lord Avie	horsename	Lord Avie
Spun Sugar	horsename	Spun Sugar
Yearly Report	horsename	Yearly Report
Southern Image	horsename	Southern Image
What a Treat	horsename	What a Treat
Sicambre	horsename	Sicambre
Student Council	horsename	Student Council
Little Bold John	horsename	Little Bold John
Starspangledbanner	horsename	Starspangledbanner
Zensational	horsename	Zensational
Star Standard	horsename	Star Standard
Paradise Creek	horsename	Paradise Creek
My Dear III	horsename	My Dear
As Indicated	horsename	As Indicated
All Our Mob	horsename	All Our Mob
Private Terms	horsename	Private Terms
Hareeba	horsename	Hareeba
Subordination	horsename	Subordination
Lookin At Lucky	horsename	Lookin At Lucky
Signorinetta	horsename	Signorinetta
Saratoga Dew	horsename	Saratoga Dew
Nannina	horsename	Nanina
Ort Wells	horsename	Ort wells
Gio Ponti	horsename	Gio Ponti
Hot Dixie Chick	horsename	Hot Dixie Chick
Misremembered	horsename	Misremembered
Careless Jewel	horsename	Careless Jewel
Mushka	horsename	Mushka
Mastercraftsman	horsename	Mastercraftsman
Imperatrice	horsename	Imperatrice
Key to the Moon	horsename	Key to the Moon
Vieux Manoir	horsename	Vieux Manoir
Bob Black Jack	horsename	Bob Black Jack
Left Bank	horsename	Left Bank
Roar Emotion	horsename	Roar Emotion
Airmans Guide	horsename	Airmans Guide
Lemhi Gold	horsename	Lemhi Gold
Wistful	horsename	Wistful
Swift Temper	horsename	Swift Temper
Youmzain	horsename	Youmzain
Tentam	horsename	Tentam
So You Think	horsename	So You Think
Green Desert	horsename	Green Desert
Big Spruce	horsename	Big Spruce
Charlottown	horsename	Charlottown
Watling Street	horsename	Watling Street
Mutafaweq	horsename	Mutafaweq
Bowl Game	horsename	Bowl Game
Choisir	horsename	Choisir
Shocking	horsename	Shocking
Wilwyn	horsename	Wilwyn
Johnny D.	horsename	Johnny D.
Tourbillon	horsename	Tourbillon
Champs Elysees	horsename	Champs Elysees
Shepperton	horsename	Shepperton
Life Is Sweet	horsename	Life Is Sweet
He's A Smoothie	horsename	He's A Smoothie
Swynford	horsename	Swynford
Forward Gal	horsename	Forward Gal
Jack Ketch	horsename	Jack Ketch
Lauries Dancer	horsename	Lauries Dancer
Man of Iron	horsename	Man of Iron
She Be Wild	horsename	She Be Wild
Informed Decision	horsename	Informed Decision
Jumpin Joseph	horsename	Jumpin Joseph
Katie Lee	horsename	Katie Lee
Double Jay	horsename	Double Jay
Manitoba	horsename	Manitoba
Banks Hill	horsename	Banks Hill
Hasili	horsename	Horse
Starine	horsename	Starine
Intercontinental	horsename	Intercontinental
Forever Together	horsename	Forever Together
Archers Bay	horsename	Archers Bay
Glad Rags	horsename	Horse
Enstone Spark	horsename	Enstone Spark
Aragorn	horsename	Aragorn
Pavot	horsename	Pavot
Vineyard Haven	horsename	Vineyard Haven
Troubadour	horsename	Troubadour
Kodiak Kowboy	horsename	Kodiak Kowboy
Sacred Kingdom	horsename	Sacred Kingdom
Val Royal	horsename	Val Royal
Go Native	horsename	Go Native
Hurryoff	horsename	Hurryoff
Dunguib	horsename	Dunguib
Eole	horsename	Eole
Take Control	horsename	Take Control
Scenic Blast	horsename	Scenic Blast
Cloudy's Knight	horsename	Cloudy's Knight
Rosemont	horsename	Rosemont
Thornfield	horsename	Thornfield
Steady Power	horsename	Steady Power
Steady Growth	horsename	Steady Growth
Azamour	horsename	Azamour
Night Nurse	horsename	Night Nurse
Seattle Dancer	horsename	Seattle Dancer
Canadian Bound	horsename	Canadian Bound
Snaafi Dancer	horsename	Snaafi Dancer
Bien Bien	horsename	Bien Bien
Star Shoot	horsename	Star Shoot
Fairy King	horsename	Fairy King
Empery	horsename	Empery
Roman Line	horsename	Roman Line
Youth	horsename	Youth
Buddy's Saint	horsename	Buddy's Saint
Regal Embrace	horsename	Regal Embrace
Erins Isle	horsename	Erins Isle
Titled Hero	horsename	Titled Hero
Trillion	horsename	Trillion
Vale of York	horsename	Vale of York
Homeboykris	horsename	Homeboykris
Noble's Promise	horsename	Noble's Promise
Dancing in Silks	horsename	Dancing in Silks
Furthest Land	horsename	Furthest Land
Pounced	horsename	Pounced
California Flag	horsename	California Flag
Tapitsfly	horsename	Tapitsfly
Midday	horsename	Midday
Noverre	horsename	Noverre
Himyar	horsename	Himyar
Flashing	horsename	Flashing
Rodrigo de Triano	horsename	Rodrigo de Triano
Del Mar Dennis	horsename	Del Mar Dennis
Ruhlmann	horsename	Ruhlmann
Intikhab	horsename	Intikhab
Seattle Smooth	horsename	Seattle Smooth
Seventh Street	horsename	Seventh Street
User Friendly	horsename	User Friendly
Haynesfield	horsename	Haynesfield
Rainbow Quest	horsename	Rainbow Quest
Herbager	horsename	Herbager
Star Appeal	horsename	Star Appeal
Rayon d'Or	horsename	Rayon d'Or
Spanish Moon	horsename	Spanish Moon
Caerleon	horsename	Caerleon
Meridian	horsename	Meridian
Floyd	horsename	Floyd
Galcador	horsename	Galcador
Ambiorix	horsename	Ambiorix
High Voltage	horsename	High Voltage
Twin Sparks	horsename	Twin Sparks
Imbros	horsename	Imbros
Presious Passion	horsename	Presious Passion
Jamestown	horsename	Jamestown
Mate	horsename	Mate
Honor Glide	horsename	Honor Glide
Flower Bowl	horsename	Flower Bowl
His Majesty	horsename	His Majesty
Twice Over	horsename	Twice Over
Blind Luck	horsename	Blind Luck
Regal Discovery	horsename	Regal Discovery
Kiridashi	horsename	Kiridashi
Northern Queen	horsename	Northern Queen
Windfields	horsename	Windfields
Gold Strike	horsename	Gold Strike
Uptowncharlybrown	horsename	Uptowncharlybrown
Marshua	horsename	Marshua
Maryfield	horsename	Maryfield
Secrettame	horsename	Secrettame
Lyford Cay	horsename	Lyford Cay
Ventura	horsename	Ventura
Chop Chop	horsename	Chop Chop
Sir Martin	horsename	Sir Martin
Flares	horsename	Flares
Comic Court	horsename	Comic Court
Jammed Lovely	horsename	Jammed Lovely
Hidden Treasure	horsename	Hidden Treasure
Synergy	horsename	Synergy
Saoirse	horsename	Saoirse
Fiddle Dancer Boy	horsename	Fiddle Dancer Boy
Rule	horsename	Rule
Wild Desert	horsename	Wild Desert
Chain Reaction	horsename	Chain Reaction
Blue Light	horsename	Blue Light
Plucky Liege	horsename	Plucky Liege
Eskendereya	horsename	Eskendereya
Železník	horsename	Železník
Discreetly Mine	horsename	Discreetly Mine
D' Funnybone	horsename	D' Funnybone
Conveyance	horsename	Conveyance
Belle Mahone	horsename	Belle Mahone
Kennaquhair	horsename	Kennaquhair
Square Angel	horsename	Square Angel
Vallée Enchantée	horsename	Vallée Enchantée
Military Move	horsename	Military Move
Caracortado	horsename	Caracortado
Backtalk	horsename	Backtalk
Percy Hope	horsename	Percy Hope
Dixie Commander	horsename	Dixie Commander
Gold Heels	horsename	Gold Heels
Sidney's Candy	horsename	Sidney's Candy
Vertigineux	horsename	Vertigineux
Binocular	horsename	Binocular
Tenacious	horsename	Tenacious
Banshee Breeze	horsename	Banshee Breeze
Winslow Homer	horsename	Winslow Homer
Fleet Indian	horsename	Fleet Indian
Daryakana	horsename	Daryakana
Imperial Commander	horsename	Imperial Commander
Devil May Care	horsename	Devil May Care
Miss Oceana	horsename	Miss Oceana
Star of Cozzene	horsename	Star of Cozzene
Turkish Trousers	horsename	Turkish Trousers
Ice Box	horsename	Ice Box
Unrivaled Belle	horsename	Unrivaled Belle
Dar Re Mi	horsename	Dar Re Mi
Musir	horsename	Musir
Burrough Hill Lad	horsename	Burrough Hill Lad
Chance Play	horsename	Chance Play
Pot O'Luck	horsename	Pot O'Luck
Aces Four	horsename	Aces Four
Irish Lad	horsename	Irish Lad
Kinsale King	horsename	Kinsale King
Epigram	horsename	Epigram
Ballot	horsename	Ballot
Borgia	horsename	Borgia
L'Escargot	horsename	L'Escargot
Don't Push It	horsename	Don't Push It
Olambala	horsename	Olambala
Bersan	horsename	Bersan
Stately Victor	horsename	Stately Victor
Crucifix	horsename	Crucifix
Sharp Cat	horsename	Sharp Cat
Grey Dawn II	horsename	Grey Dawn
Fluvanna	horsename	Fluvanna
Sayajirao	horsename	Sayajirao
Christmas Past	horsename	Christmas Past
Palace Music	horsename	Palace Music
Naturalism	horsename	Naturalism
Prince John	horsename	Prince John
Exhi	horsename	Exhi
Doubledogdare	horsename	Doubledogdare
Ogden	horsename	Ogden
Blessbull	horsename	Blessbull
Burnt Cork	horsename	Burnt Cork
Parlo	horsename	Parlo
Berlo	horsename	Berlo
Blue Swords	horsename	Blue Swords
The French Furze	horsename	The French Furze
Waquoit	horsename	Waquoit
Slide Rule	horsename	Slide Rule
Evening Jewel	horsename	Evening Jewel
Golan	horsename	Golan
War of Attrition	horsename	War Of Attrition
Vincentive	horsename	Vincentive
Super Saver	horsename	Super Saver
Neptune Collonges	horsename	Neptune Collonges
Mona de Momma	horsename	Mona de Momma
St Nicholas Abbey	horsename	St Nicholas Abbey
Arcalis	horsename	Arcalis
Makfi	horsename	Makfi
Court Martial	horsename	Court Martial
Wilkes	horsename	Wilkes
Fair Trial	horsename	Fair Trial
Sandpit	horsename	Sandpit
Cravat	horsename	Cravat
Polymelus	horsename	Polymelus
Phalaris	horsename	Phalaris
Cosmic Bomb	horsename	Horse
Alexander Goldrun	horsename	Alexander Goldrun
Al Eile	horsename	Al Eile
Typhoon Tracy	horsename	Typhoon Tracy
Almahmoud	horsename	Almahmoud
Solwhit	horsename	Solwhit
Dotties Pick	horsename	Dotties Pick
Eillo	horsename	Eillo
Weapon's Amnesty	horsename	Weapon’s Amnesty
Mr Tiz	horsename	Mr Tiz
Scapa Flow	horsename	Scapa Flow
Java Gold	horsename	Java Gold
Deceit Dancer	horsename	Deceit Dancer
Grey Classic	horsename	Grey Classic
Dixie Brass	horsename	Dixie Brass
Try My Best	horsename	Try My Best
Heavenly Cause	horsename	Heavenly Cause
Bateau	horsename	Bateau
Master Charlie	horsename	Master Charlie
Canford Cliffs	horsename	Canford Cliffs
Quack	horsename	Quack
American Lion	horsename	American Lion
Frost King	horsename	Frost King
Pride	horsename	Pride
The Pamplemousse	horsename	The Pamplemousse
Prime Defender	horsename	Prime Defender
Hampton	horsename	Hampton
Cairngorm	horsename	Cairngorm
Jorrocks	horsename	Jorrocks
Drosselmeyer	horsename	Drosselmeyer
Vosne Romanee	horsename	Vosne Romanee
Allied Powers	horsename	Allied Powers
Malek	horsename	Malek
Eurythmic	horsename	Eurythmic
Vigil II	horsename	Vigil
Vigil	horsename	Vigil
Before Dawn	horsename	Horse
Tinners Way	horsename	Tinners Way
Tarrare	horsename	Tarrare
Clem	horsename	Clem
No Robbery	horsename	No Robbery
Captain's Gig	horsename	Captain's Gig
Speak John	horsename	Speak John
Capades	horsename	Capades
Thunder Rumble	horsename	Thunder Rumble
My Juliet	horsename	My Juliet
Maram	horsename	Maram
Oguri Cap	horsename	Oguri Cap
Obeah	horsename	Obeah
Dance Spell	horsename	Dance Spell
Big Red Mike	horsename	Big Red Mike
Tranquil Star	horsename	Tranquil Star
Delhi	horsename	Delhi
Blame	horsename	Blame
Chelokee	horsename	Chelokee
Unusual Heat	horsename	Unusual Heat
Masterman	horsename	Masterman
Hambletonian	horsename	Hambletonian
Paddy O'Prado	horsename	Paddy O'Prado
Mark of Esteem	horsename	Mark of Esteem
Better Than Ever	horsename	Better Than Ever
King's Best	horsename	King's Best
Cockney Rebel	horsename	Cockney Rebel
Tartan Bearer	horsename	Tartan Bearer
Nereide	horsename	Nereide
Oasis Dream	horsename	Oasis Dream
Arctic Cosmos	horsename	Arctic Cosmos
Debussy	horsename	Debussy
Frankel	horsename	Frankel
Paco Boy	horsename	Paco Boy
Kurifuji	horsename	Kurifuji
Roi Dagobert	horsename	Roi Dagobert
Abary	horsename	Abary
Americain	horsename	Americain
Edredon Bleu	horsename	Edredon Bleu
Looks Like Trouble	horsename	Looks Like Trouble
Zipping	horsename	Zipping
Northern Trick	horsename	Northern Trick
Surround	horsename	Surround
One Man	horsename	One Man
Endurance by Right	horsename	Endurance by Right
Old Trieste	horsename	Old Trieste
Toussaud	horsename	Toussaud
Chester House	horsename	Chester House
Personal Flag	horsename	Personal Flag
Dream Alliance	horsename	Dream Alliance
Perdita II	horsename	Perdita II
Whobegotyou	horsename	Whobegotyou
Advance	horsename	Advance
Cape Blanco	horsename	Cape Blanco
Drumtop	horsename	Drumtop
Royal Athlete	horsename	Royal Athlete
Snow Fairy	horsename	Snow Fairy
Topsider	horsename	Topsider
North Sider	horsename	North Sider
Blue Girl	horsename	Blue Girl
Sir Gaylord	horsename	Sir Gaylord
Pia Star	horsename	Pia Star
Beau Purple	horsename	Beau Purple
Long Run	horsename	Long Run
Dark Secret	horsename	Dark Secret
Bardstown	horsename	Bardstown
Sette Bello	horsename	Sette Bello
Sting	horsename	Sting
Spur	horsename	Spur
Yagli	horsename	Yagli
Questionnaire	horsename	Questionnaire
Traffic Judge	horsename	Traffic Judge
Mr. Consistency	horsename	Mr. Consistency
Alibhai	horsename	Alibhai
Honeymoon	horsename	Honeymoon
Tulloch	horsename	Tulloch
Tom Fool	horsename	Tom Fool
Uncle Mo	horsename	Uncle Mo
Cajun Beat	horsename	Cajun Beat
Summer Tan	horsename	Summer Tan
Black Caviar	horsename	Black Caviar
Miinnehoma	horsename	Miinnehoma
Crimson Satan	horsename	Crimson Satan
Jimmy Choux	horsename	Jimmy Choux
Soldat	horsename	Soldat
Hurricane Fly	horsename	Hurricane Fly
Brave Inca	horsename	Brave Inca
Top Row	horsename	Top Row
Popkins	horsename	Popkins
Awesome Feather	horsename	Awesome Feather
Crafty Lace	horsename	Crafty Lace
Nellie Flag	horsename	Nellie Flag
Nellie L.	horsename	Nellie L.
Ballabriggs	horsename	Ballabriggs
Hors La Loi III	horsename	Hors La Loi III
Shorelint	horsename	Shorelint
Tempera	horsename	Tempera
Dr. Freeland	horsename	Dr. Freeland
E.S.B.	horsename	E.S.B.
Paradisical	horsename	Paradisical
Vulcan's Forge	horsename	Vulcan's Forge
Royal Glint	horsename	Royal Glint
Maria's Mon	horsename	Maria's Mon
Eri-Aaroni	horsename	Eri-Aaroni 3423 Valio
Rockhill Native	horsename	Rockhill Native
Irish Linnet	horsename	Irish Linnet
Summerly	horsename	Summerly
Organisedconfusion	horsename	Organisedconfusion
Party Politics	horsename	Party Politics
Dotted Swiss	horsename	Dotted Swiss
Prince Blessed	horsename	Prince Blessed
Nasturtium	horsename	Nasturtium
Sainfoin	horsename	Sainfoin
Animal Kingdom	horsename	Animal Kingdom
Yankee Affair	horsename	Yankee Affair
Indian Charlie	horsename	Indian Charlie
Seattle Song	horsename	Seattle Song
Spread Eagle	horsename	Spread Eagle
Jewel Princess	horsename	Jewel Princess
Royal Delta	horsename	Royal Delta
Acting Happy	horsename	Acting Hapy
Shackleford	horsename	Shackleford
First Dude	horsename	First Dude
Take Wing	horsename	Take Wing
Rainbow View	horsename	Rainbow View
Lahan	horsename	Lahan
Rahy's Attorney	horsename	Rahy's Attorney
Algerine	horsename	Algerine
Jackson Bend	horsename	Jackson Bend
Sweet Vendetta	horsename	Sweet Vendetta
Crystal Music	horsename	Crystal Music
Ryafan	horsename	Ryafan
Mashaallah	horsename	Mashaallah
Flemensfirth	horsename	Flemensfirth
Zoffany	horsename	Zoffany
Shantou	horsename	Shantou
Observatory	horsename	Observatory
Bates Motel	horsename	Bates Hotel
Muhtarram	horsename	Muhtarram
Sulk	horsename	Sulk
Malhub	horsename	Malhub
Head Play	horsename	Head Play
Mucho Macho Man	horsename	Mucho Macho Man
Strike a Deal	horsename	Strike A Deal
The Very One	horsename	The Very One
Parading	horsename	Parading
Pour Moi	horsename	Pour Moi
Bostonian	horsename	Bostonian
Broomspun	horsename	Broomspun
High Time	horsename	High Time
Ruler on Ice	horsename	Ruler on Ice
What A Summer	horsename	What A Summer
Wide Country	horsename	Wide Country
Regal Engagement	horsename	Regal Engagement
Chamrousse	horsename	Chamrousse
Aztec Hill	horsename	Aztec Hill
Kalitan	horsename	Kalitan
Silver Deputy	horsename	Silver Deputy
Revidere	horsename	Revidere
Black Maria	horsename	Black Maria
Added Gold	horsename	Added Gold
More Than Real	horsename	More Than Real
Salt It	horsename	Salt It
Winter Memories	horsename	Winter Memories
Sarah's Secret	horsename	Sarah's Secret
Process Shot	horsename	Process Shot
Holiday	horsename	Holiday
But Why Not	horsename	But Why Not
Treasure Beach	horsename	Treasure Beach
Maid at Arms	horsename	Maid At Arms
Pucker Up	horsename	Pucker Up
Happy Issue	horsename	Happy Issue
Alanesian	horsename	Alanesian
Princessnesian	horsename	Princessnesian
Mesabi Maiden	horsename	Mesabi Maiden
Wenona Girl	horsename	Wenona Girl
Unfuwain	horsename	Unfuwain
Bosra Sham	horsename	Bosra Sham
Stamina	horsename	Stamina
Calipha	horsename	Calipha
Cleopatra	horsename	Cleopatra
Linita	horsename	Linita
Sickle	horsename	Sickle
Jack Hare Jr.	horsename	Jack Hare Jr.
Miss Legality	horsename	Miss Legality
Ruken	horsename	Ruken
Kiss Me Kate	horsename	Kiss Me Kate
Pharamond II	horsename	Pharamond II
Springfield	horsename	Springfield
Sweetmeat	horsename	Sweetmeat
Grecian Queen	horsename	Grecian Queen
Heliopolis	horsename	Heliopolis
Olympia	horsename	Olympia
Decathlon	horsename	Decathlon
It's Tricky	horsename	It's Tricky
Blue Bunting	horsename	Blue Bunting
Dapper Dan	horsename	Dapper Dan
Rewilding	horsename	Rewilding
Convenience	horsename	Convenience
Nathaniel	horsename	Nathaniel
Play On	horsename	Play On
Raja Baba	horsename	Raja Baba
Malibu Pier	horsename	Malibu Pier
Ladysman	horsename	Ladysman
Lincoln Road	horsename	Lincoln Road
Olden Times	horsename	Olden Times
Just a Game	horsename	Just A Game
Stan	horsename	Stan
Miche	horsename	Miche
Alamshar	horsename	Alamshar
Smart Deb	horsename	Smart Deb
On Trust	horsename	On Trust
King's Theatre	horsename	King's Theatre
Belmez	horsename	Belmez
Time Charter	horsename	Time Charter
Mata Hari	horsename	Mata Hari
Haafhd	horsename	Haafhd
Rakti	horsename	Rakti
Nayef	horsename	Nayef
Grandera	horsename	Grandera
Further Flight	horsename	Further Flight
Millenary	horsename	Millenary
Barathea	horsename	Barathea
Russian Rhythm	horsename	Russian Rhythm
Make A Stand	horsename	Make A Stand
David Junior	horsename	David Junior
Balanchine	horsename	Balanchine
Kazzia	horsename	Kazzia
Sun Briar	horsename	Sun Briar
Stay Thirsty	horsename	Stay Thirsty
Mr Brooks	horsename	Mr Brooks
Teofilo	horsename	Teofilo
Hold That Tiger	horsename	Hold That Tiger
Pearl Necklace	horsename	Pearl Necklace
Numbered Account	horsename	Numbered Account
Vigors	horsename	Vigors
Outstandingly	horsename	Outstandingly
Macs Joy	horsename	Macs Joy
Havre de Grace	horsename	Havre de Grace
Dubawi	horsename	Dubawi
Queen's Logic	horsename	Queen's Logic
Pompey	horsename	Pompey
Grand Lodge	horsename	Grand Lodge
Perfect Sting	horsename	Perfect Sting
Footstepsinthesand	horsename	Footstepsinthesand
Proud Birdie	horsename	Proud Birdie
Pilaster	horsename	Pilaster
Terimon	horsename	Terimon
Sheikh Albadou	horsename	Sheikh Albadou
Fasliyev	horsename	Fasliyev
Vinnie Roe	horsename	Vinnie Roe
Rite of Passage	horsename	Rite of Passage
Lakeville Miss	horsename	Lakeville Miss
Bint Allayl	horsename	Bint Allayl
Wayward Lass	horsename	Wayward Lass
Hever Golf Rose	horsename	Hever Golf Rose
Embassy	horsename	Embassy
Noble Nashua	horsename	Noble Nashua
Groovy	horsename	Groovy
Torgau	horsename	Torgau
Rumplestiltskin	horsename	Rumplestiltskin
Very Subtle	horsename	Very Subtle
Superstar Leo	horsename	Superstar Leo
Lemon Souffle	horsename	Lemon Souffle
Culture Vulture	horsename	Culture Vulture
Blue Duster	horsename	Blue Duster
Lyric Fantasy	horsename	Lyric Fantasy
Gay Gallanta	horsename	Gay Gallanta
Alhaarth	horsename	Alhaarth
Hawkster	horsename	Hawkster
Now What	horsename	Now What
Danedream	horsename	Danedream
Elusive Kate	horsename	Elusive Kate
Orientate	horsename	Orientate
Telly's Pop	horsename	Telly's Pop
The Wicked North	horsename	The Wicked North
Monet's Garden	horsename	Monet's Garden
Sheilas Reward	horsename	Sheilas Reward
Morston	horsename	Morston
Tobougg	horsename	Tobougg
First Trump	horsename	First Trump
Bahamian Bounty	horsename	Bahamian Bounty
Revoque	horsename	Revoque
Aljabr	horsename	Aljabr
Petrushka	horsename	Petrushka
Ramruma	horsename	Ramruma
Cape Verdi	horsename	Cape Verdi
Drum Taps	horsename	Drum Taps
Moonax	horsename	Moonax
Celeric	horsename	Celeric
Royal Applause	horsename	Royal Applause
Continent	horsename	Continent
Somnus	horsename	Somnus
Reverence	horsename	Reverence
Avonbridge	horsename	Avonbridge
Red Clubs	horsename	Red Clubs
Tamarisk	horsename	Tamarisk
Fleeting Spirit	horsename	Fleeting Spirit
Highland Blade	horsename	Highland Blade
Kooyonga	horsename	Kooyonga
Mozart	horsename	Mozart
Stravinsky	horsename	Stravinsky
Nononito	horsename	Nononito
Kostroma	horsename	Kostroma
Anabaa	horsename	Anabaa
Windsor Lad	horsename	Windsor Lad
Dunaden	horsename	Dunaden
Fairway	horsename	Fairway
Wishing Well	horsename	Wishing Well
Lakeway	horsename	Lakeway
Stuka	horsename	Stuka
Coronach	horsename	Coronach
Captain Cuttle	horsename	Captain Cuttle
Humorist	horsename	Humorist
Durbar	horsename	Durbar
Lemberg	horsename	Lemberg
Cameronian	horsename	Cameronian
Tagalie	horsename	Tagalie
Cicero	horsename	Cicero
Blakeney	horsename	Blakeney
Larkspur	horsename	Larkspur
At Talaq	horsename	At Talaq
Beldale Ball	horsename	Beldale Ball
Phil Drake	horsename	Phil Drake
Game On Dude	horsename	Game On Dude
Hard Ridden	horsename	Hard Ridden
Arctic Prince	horsename	Arctic Prince
Psidium	horsename	Psidium
Lavandin	horsename	Lavandin
Parthia	horsename	Parthia
Call Boy	horsename	Call Boy
Grand Parade	horsename	Grand Parade
Manna	horsename	Manna
Relaxing	horsename	Relaxing
Levee	horsename	Levee
Prospectors Delite	horsename	Prospectors Delite
Sansovino	horsename	Sansovino
Amato	horsename	Amato
Spion Kop	horsename	Spion Kop
Cara Rafaela	horsename	Cara Rafaela
Cyllene	horsename	Cyllene
A Gleam	horsename	A Gleam
Felstead	horsename	Felstead
Mid-day Sun	horsename	Mid-day Sun
Glenelg	horsename	Glenelg
Airborne	horsename	Airborne
Orby	horsename	Orby
Saint Ballado	horsename	Saint Ballado
Terlingua	horsename	Terlingua
Copenhagen	horsename	Copenhagen
My Love	horsename	My Love
St. Vincent	horsename	St. Vincent
Pearl Diver	horsename	Pearl Diver
Pont l'Eveque	horsename	Pont l’Eveque
Ocean Swell	horsename	Ocean Swell
Straight Deal	horsename	Straight Deal
Owen Tudor	horsename	Owen Tudor
St. Amant	horsename	St. Amant
Aboyeur	horsename	Aboyeur
Jeddah	horsename	Jeddah
Galtee More	horsename	Galtee More
Common	horsename	Common
Sir Visto	horsename	Sir Visto
Ladas	horsename	Ladas
Sir Hugo	horsename	Sir Hugo
Hawaii	horsename	Hawaii
Donovan	horsename	Donovan
Merry Hampton	horsename	Merry Hampton
Ayrshire	horsename	Ayrshire
Harvester	horsename	Harvester
Miswaki	horsename	Miswaki
Melton	horsename	Melton
Shotover	horsename	Shotover
St. Blaise	horsename	St. Blaise
St. Gatien	horsename	St. Gatien
Sir Bevys	horsename	Sir Bevys
Caractacus	horsename	Caractacus
Sefton	horsename	Sefton
Isonomy	horsename	Isonomy
Robert the Devil	horsename	Robert the Devil
La Fleche	horsename	La Fleche
Minting	horsename	Minting
Foxhall	horsename	Foxhall
Lord Lyon	horsename	Lord Lyon
Romántico	horsename	Romantico
Miesque's Approval	horsename	Miesque's Approval
War Chant	horsename	War Chant
Overturn	horsename	Overturn
Rough'n Tumble	horsename	Rough'n Tumble
My Dear Girl	horsename	My Dear Girl
Beautiful Pleasure	horsename	Beautiful Pleasure
Silvio	horsename	Silvio
Beaugay	horsename	Beaugay
Perfect Shirl	horsename	Perfect Shirl
Golden Attraction	horsename	Golden Attraction
Kisber	horsename	Kisber
George Frederick	horsename	George Frederick
Cremorne	horsename	Cremorne
Favonius	horsename	Favonius
Blair Athol	horsename	Blair Athol
Kettledrum	horsename	Kettledrum
Macaroni	horsename	Macaroni
Orfevre	horsename	Orfevre
Baghdad Note	horsename	Baghdad Note
Ming Dynasty	horsename	Ming Dynasty
Just a Dash	horsename	Just A Dash
Sailor	horsename	Sailor
Kensei	horsename	Kensei
Middleton	horsename	Middleton
Great Nephew	horsename	Great Nephew
Deacon Blues	horsename	Deacon Blues
Southern Halo	horsename	Southern Halo
Eleanor	horsename	Eleanor
Musjid	horsename	Musjid
Voltigeur	horsename	Voltigeur
Kingcraft	horsename	Kingcraft
Pretender	horsename	Pretender
Rapid Redux	horsename	Rapid Redux
Thormanby	horsename	Thormanby
Beadsman	horsename	Beadsman
The Merry Monarch	horsename	The Merry Monarch
Prince Leopold	horsename	Prince Leopold
Blink Bonny	horsename	Blink Bonny
Ellington	horsename	Ellington
Wild Dayrell	horsename	Wild Dayrell
Waxy	horsename	Waxy
Andover	horsename	Andover
Daniel O'Rourke	horsename	Daniel O'Rourke
Teddington	horsename	Teddington
Ahonoora	horsename	Ahonoora
Surplice	horsename	Surplice
Cossack	horsename	Cossack
Pyrrhus The First	horsename	Pyrrhus The First
Whalebone	horsename	Whalebone
Cotherstone	horsename	Cotherstone
Attila	horsename	Attila
Dancing Rain	horsename	Dancing Rain
Coronation	horsename	Coronation
Hansen	horsename	Hansen
Little Wonder	horsename	Little Wonder
Natchez	horsename	Natchez
Creole Maid	horsename	Creole Maid
Bloomsbury	horsename	Bloomsbury
Mundig	horsename	Mundig
Phosphorus	horsename	Phosphorus
Plenipotentiary	horsename	Plenipotentiary
Go Marching	horsename	Go Marching
Leallah	horsename	Leallah
Dangerous	horsename	Dangerous
St. Giles	horsename	St. Giles
Spaniel	horsename	Spaniel
Priam	horsename	Priam
Mameluke	horsename	Mameluke
Smolensko	horsename	Smolensko
Emilius	horsename	Emilius
Young Eclipse	horsename	Young Eclipse
Frederick	horsename	Frederick
Cadland	horsename	Cadland
Lap-dog	horsename	Lap-dog
Moses	horsename	Moses
Archworth	horsename	Archworth
Cedric	horsename	Cedric
Phantom	horsename	Phantom
Mahan	horsename	Mahan
Cardinal Beaufort	horsename	Cardinal Beaufort
Blucher	horsename	Blucher
Tiresias	horsename	Tiresias
Azor	horsename	Azor
Octavius	horsename	Octavius
Hannibal	horsename	Hannibal
Pan	horsename	Pan
Sam	horsename	Sam
Assassin	horsename	Assassin
Paris	horsename	Paris
Election	horsename	Election
Rhadamanthus	horsename	Rhadamanthus
Daedalus	horsename	Daedalus
Champion	horsename	Champion
Ditto	horsename	Ditto
True North III	horsename	True North
True North I	horsename	True North
Private Account	horsename	Private Account
Dance Number	horsename	Dance Number
Skyscraper	horsename	Skyscraper
Tyrant	horsename	Tyrant
Archduke	horsename	Archduke
Sir Harry	horsename	Sir Harry
Eager	horsename	Eager
Gustavus	horsename	Gustavus
Whisker	horsename	Whisker
Colt by Fidget	horsename	Colt by Fidget
John Bull	horsename	John Bull
Didelot	horsename	Didelot
Sir Thomas	horsename	Sir Thomas
Aimwell	horsename	Aimwell
Serjeant	horsename	Serjeant
Noble	horsename	Noble
First Flight	horsename	First Flight
Saltram	horsename	Saltram
Pope	horsename	Pope
Vander Pool	horsename	Vander Pool
Flying Heels	horsename	Flying Heels
Love Sign	horsename	Love Sign
Regal Gleam	horsename	Regal Gleam
Astra	horsename	Astra
Tristan	horsename	Tristan
Egyptian Ra	horsename	Egyptian Ra
Collection	horsename	Collection
Able One	horsename	Able One
Beauty Flash	horsename	Beauty Flash
Brave Kid	horsename	Brave Kid
Virago	horsename	Virago
Super Satin	horsename	Super Satin
Captain Sweet	horsename	Captain Sweet
Flying Blue	horsename	Flying Blue
California Memory	horsename	California Memory
King Al Akbar	horsename	King Al Akbar
Ambitious Dragon	horsename	Ambitious Dragon
Irian	horsename	Irian
Mighty High	horsename	Mighty High
Lucky Nine	horsename	Lucky Nine
Xtension	horsename	Xtension
Wheel of Fortune	horsename	Wheel of Fortune
Busted	horsename	Busted
Silent Achiever	horsename	Silent Achiever
Achievement	horsename	Achievement
Parisot	horsename	Parisot
Island Sands	horsename	Island Sands
King of Kings	horsename	King of Kings
Entrepreneur	horsename	Entrepreneur
Shadeed	horsename	Shadeed
Pennekamp	horsename	Pennekamp
Mister Baileys	horsename	Mister Baileys
Mystiko	horsename	Mystiko
Tirol	horsename	Tirol
Wollow	horsename	Wollow
Right Tack	horsename	Right Tack
Only for Life	horsename	Only for Life
Nebbiolo	horsename	Nebbiolo
Our Babu	horsename	Our Babu
Big Game	horsename	Big Game
Orwell	horsename	Orwell
Colombo	horsename	Colombo
The Panther	horsename	The Panther
St. Frusquin	horsename	St. Frusquin
Paradox	horsename	Paradox
Synchronised	horsename	Synchronised
Slieve Gallion	horsename	Slieve Gallion
Rock On Ruby	horsename	Rock On Ruby
Danoli	horsename	Danoli
Pussy	horsename	Pussy
Grey Momus	horsename	Grey Momus
Sir Tatton Sykes	horsename	Sir Tatton Sykes
Atlantic	horsename	Atlantic
Cirrus des Aigles	horsename	Cirrus des Aigles
Monterosso	horsename	Monterosso
Ramonti	horsename	Ramonti
Dabirsim	horsename	Dabirsim
Petoski	horsename	Petoski
L'Abbesse de Jouarre	horsename	L'Abbesse de Jouarre
Kalaglow	horsename	Kalaglow
Cherimoya	horsename	Cherimoya
Castle Forbes	horsename	Castle Forbes
Our Boots	horsename	Our Boots
Jewel's Reward	horsename	Jewel's Reward
Rejected	horsename	Rejected
Nicolaus Silver	horsename	Nicolaus Silver
Mr. What	horsename	Mr. What
Ela-Mana-Mou	horsename	Ela-Mana-Mou
Gay Trip	horsename	Gay Trip
Bodemeister	horsename	Bodemeister
Dangerous Midge	horsename	Dangerous Midge
Vito	horsename	Horse
Deceit	horsename	Deceit
Buena Vista	horsename	Buena Vista
B. Thoughtful	horsename	B. Thoughtful
More Joyous	horsename	More Joyous
Sprinter Sacre	horsename	Sprinter Sacre
Mastery	horsename	Mastery
Bruni	horsename	Bruni
Dixie Union	horsename	Dixie Union
Union Rags	horsename	Union Rags
Phone Chatter	horsename	Horse
Gang Forward	horsename	Gang Forward
Forever Yours	horsename	Forever Yours
Maybe	horsename	Maybe
Sixties Icon	horsename	Sixties Icon
Homecoming Queen	horsename	Homecoming Queen
Rule of Law	horsename	Rule of Law
Brian Boru	horsename	Brian Boru
Bollin Eric	horsename	Bollin Eric
Arch	horsename	Arch
Alcohol	horsename	Alcohol
Milan	horsename	Milan
Known Fact	horsename	Known Fact
Nedawi	horsename	Nedawi
Smile	horsename	Smile
Classic Cliche	horsename	Classic Cliche
Bob's Return	horsename	Bob's Return
Toulon	horsename	Toulon
Bold Ego	horsename	Bold Ego
Snurge	horsename	Snurge
Minster Son	horsename	Minster Son
In Lingerie	horsename	In Lingerie
Moon Madness	horsename	Moon Madness
Power	horsename	Power
Golden Lilac	horsename	Golden Lilac
Challenger	horsename	Challenger II
Challenge Me	horsename	Challenge Me
Nadir	horsename	Nadir
Bayou	horsename	Bayou
Sun Princess	horsename	Sun Princess
Was	horsename	Was
Ile de Bourbon	horsename	Ile de Bourbon
R. Thomas	horsename	R. Thomas
On-and-On	horsename	On-and-On
Birds Nest	horsename	Birds Nest
Dullahan	horsename	Dullahan
Dunfermline	horsename	Dunfermline
Boucher	horsename	Boucher
Caixa Eletronica	horsename	Caixa Eletronica
Intermezzo	horsename	Intermezzo
Aunt Edith	horsename	Aunt Edith
Right Royal	horsename	Right Royal
Nasram	horsename	Nasram
Aggressor	horsename	Aggressor
Ribero	horsename	Ribero
Premonition	horsename	Premonition
Provoke	horsename	Provoke
Indiana	horsename	Indiana
Cantelo	horsename	Cantelo
Natagora	horsename	Natagora
Formosa	horsename	Formosa
Special Duty	horsename	Special Duty
Misty for Me	horsename	Misty for Me
Gamos	horsename	Gamos
Aureole	horsename	Aureole
Lonesome Glory	horsename	Lonesome Glory
Morley Street	horsename	Morley Street
Danehill Dancer	horsename	Danehill Dancer
Fortria	horsename	Fortria
Sea Moon	horsename	Sea Moon
Collier Bay	horsename	Collier Bay
Flakey Dove	horsename	Flakey Dove
Mr Mulligan	horsename	Mr Mulligan
Imperial Call	horsename	Imperial Call
Master Oats	horsename	Master Oats
Jodami	horsename	Jodami
Altesse Royale	horsename	Altesse Royale
Orme	horsename	Orme
Mysterious	horsename	Mysterious
Highclere	horsename	Highclere
The Bard	horsename	The Bard
Sweet Solera	horsename	Sweet Solera
Bona Vista	horsename	Bona Vista
Never Too Late	horsename	Never Too Late
Carrozza	horsename	Carrozza
Lupe	horsename	Lupe
Humble Duty	horsename	Humble Duty
Caergwrle	horsename	Caergwrle
Flying Water	horsename	Flying Water
Ghanaati	horsename	Ghanaati
Speciosa	horsename	Speciosa
Kendal	horsename	Kendal
Kind	horsename	Kind
Virginia Waters	horsename	Virginia Waters
Unbreakable	horsename	Unbreakable
Ameerat	horsename	Ameerat
Friar's Balsam	horsename	Friar's Balsam
Wince	horsename	Wince
Old Vic	horsename	Old Vic
Sleepytime	horsename	Sleepytime
Most Improved	horsename	Most Improved
Harayir	horsename	Harayir
Las Meninas	horsename	Las Meninas
Lily Agnes	horsename	Lily Agnes
Sayyedati	horsename	Sayyedati
Shadayid	horsename	Sayyedati
Salsabil	horsename	Salsabil
Look Here	horsename	Look Here
Light Shift	horsename	Light Shift
Eswarah	horsename	Eswarah
Bobs Worth	horsename	Bobs Worth
Imagine	horsename	Imagine
Love Divine	horsename	Love Divine
Excelebration	horsename	Excelebration
Shahtoush	horsename	Shahtoush
Reams of Verse	horsename	Reams of Verse
Apology	horsename	Apology
Lady Carla	horsename	Lady Carla
Moonshell	horsename	Moonshell
Intrepidity	horsename	Intepidity
Jet Ski Lady	horsename	Jet Ski Lady
Festoon	horsename	Festoon
Roderic O'Connor	horsename	Roderic O'Connor
Great Heavens	horsename	Great Heavens
Tracery	horsename	Tracery
Ortensia	horsename	Ortensia
Black Tarquin	horsename	Black Tarquin
Oxo	horsename	Oxo
Rockfel	horsename	Rockfel
Ossory	horsename	Ossory
Godiva	horsename	Godiva
Galatea	horsename	Galatea
Snap	horsename	Snap
Charlie Boy	horsename	Charlie Boy
Exhibitionnist	horsename	Exhibitionnist
Musidora	horsename	Musidora
Saucy Sue	horsename	Saucy Sue
Sun Stream	horsename	Sun Stream
Izzi Top	horsename	Izzi Top
The Fugue	horsename	The Fugue
Herringbone	horsename	Herringbone
Jest	horsename	Jest
Frontier	horsename	Frontier
Witch Elm	horsename	Witch Elm
Black Jester	horsename	Black Jester
Royal Oath	horsename	Royal Oath
Your Majesty	horsename	Your Majesty
Tiffin	horsename	Tiffin
Chief Singer	horsename	Chief Singer
Daddy Long Legs	horsename	Daddy Long Legs
Reliance	horsename	Reliance
Orbit	horsename	Orbit
Montaval	horsename	Montaval
Zurella	horsename	Zurella
Vimy	horsename	Vimy
Supreme Court	horsename	Supreme Court
Petrarch	horsename	Petrarch
Encke	horsename	Encke
Chamant	horsename	Chamant
Miss Jummy	horsename	Miss Jummy
Busybody	horsename	Busybody
Cherry Lass	horsename	Cherry Lass
Society Rock	horsename	Society Rock
Jannette	horsename	Jannette
Black Knight	horsename	Black Knight
What A Nuisance	horsename	What A Nuisance
Nocturnal Spree	horsename	Nocturnal Spree
Midway Lady	horsename	Midway Lady
Musical Bliss	horsename	Musical Bliss
Abermaid	horsename	Abermaid
Fleet	horsename	Fleet
Bendigo	horsename	Bendigo
Pourparler	horsename	Pourparler
Belle of All	horsename	Belle of All
Solemia	horsename	Solemia
Dundeel	horsename	It's a Dundeel
Dansili	horsename	Dansili
Wise Dan	horsename	Wise Dan
Garden Path	horsename	Garden Path
Certify	horsename	Certify
Questing	horsename	Questing
Dawn Approach	horsename	Dawn Approach
Moonlight Cloud	horsename	Moonlight Cloud
Reckless Abandon	horsename	Reckless Abandon
Sagamix	horsename	Sagamix
Lily of the Valley	horsename	Lily of the Valley
Valyra	horsename	Valyra
Mayson	horsename	Mayson
Neva	horsename	Neva
Bartlett's Childers	horsename	Bartlett's Childers
Corinne	horsename	Corinne
Zinc	horsename	Zinc
Luskin Star	horsename	Luskin Star
Zeal	horsename	Zeal
Arab	horsename	Arab
Catgut	horsename	Catgut
Rowena	horsename	Rowena
Whizgig	horsename	Whizgig
Goldfinder	horsename	Goldfinder
Tontine	horsename	Tontine
Problem	horsename	Problem
Kingsbarns	horsename	Kingsbarns
Music	horsename	Music
Bay Bolton	horsename	Bay Bolton
Minuet	horsename	Minuet
Ocean Park	horsename	Ocean Park
Miss Potential	horsename	Miss Potential
Pastille	horsename	Pastille
Bucephalus	horsename	Bucephalus
Oxygen	horsename	Oxygen
Turquoise	horsename	Turquoise
Zenda	horsename	Zenda
Bel Bolide	horsename	Bel Bolide
Charlotte	horsename	Charlotte
Filly by Selim	horsename	Filly by Selim
Green Moon	horsename	Green Moon
Rhoda	horsename	Rhoda
Young Mouse	horsename	Young Mouse
Charlotte West	horsename	Charlotte West
Galantine	horsename	Galantine
Galata	horsename	Galata
Winkipop	horsename	Winkipop
Camarine	horsename	Camarine
May-day	horsename	May-day
Firebrand	horsename	Firebrand
Allabaculia	horsename	Allabaculia
Tarantella	horsename	Tarantella
Zoe	horsename	Zoe
Cobweb	horsename	Cobweb
Chapeau d'Espagne	horsename	Chapeau d'Espagne
Doctor Syntax	horsename	Doctor Syntax
Preserve	horsename	Preserve
Destiny	horsename	Destiny
Barcarolle	horsename	Barcarolle
Cara	horsename	Cara
Velocipede	horsename	Velocipede
King Fergus	horsename	King Fergus
Gentildonna	horsename	Gentildonna
Orville	horsename	Orville
Pelisse	horsename	Pelisse
Meteora	horsename	Meteora
Bronze	horsename	Bronze
Quintessence	horsename	Quintessence
Briseis	horsename	Briseis
Morel	horsename	Morel
Maid of Orleans	horsename	Maid of Orleans
Gohanna	horsename	Gohanna
Oriana	horsename	Oriana
Sorcery	horsename	Sorcery
Manuella	horsename	Manuella
Bald Galloway	horsename	Bald Galloway
Medora	horsename	Medora
Kelly Kip	horsename	Kelly Kip
Blank	horsename	Blank
Benny the Bull	horsename	Benny the Bull
Landscape	horsename	Landscape
Fort Larned	horsename	Fort Larned
Vedette	horsename	Vedette
Shanghai Bobby	horsename	Shanghai Bobby
Val d'Or	horsename	Val d'Or
Secret Circle	horsename	Secret Circle
Heart's Cry	horsename	Heart's Cry
Blacklock	horsename	Blacklock
Crab	horsename	Crab
Zenno Rob Roy	horsename	Zenno Rob Roy
Gold Ship	horsename	Gold Ship
Victoire Pisa	horsename	Victoire Pisa
Wizard	horsename	Wizard
Meteor	horsename	Meteor
Selim	horsename	Selim
Battle Heights	horsename	Battle Heights
Neo Universe	horsename	Neo Universe
Hydrogen	horsename	Hydrogen
Dalray	horsename	Dalray
Daiwa Major	horsename	Daiwa Major
Prunella	horsename	Prunella
Moorestyle	horsename	Moorestyle
Evening Peal	horsename	Evening Peal
Gala Supreme	horsename	Gala Supreme
Polo Prince	horsename	Polo Prince
Bloody Buttocks	horsename	Bloody Buttocks
Gatum Gatum	horsename	Gatum Gatum
Rainbird	horsename	Rainbird
Delta	horsename	Delta
Ma Biche	horsename	Ma Biche
Rubens	horsename	Rubens
Spilletta	horsename	Spilletta
Vespa	horsename	Vespa
Alexander mare	horsename	Alexander mare
Habitat	horsename	Habitat
Rubens mare	horsename	Rubens mare
Provideo	horsename	Provideo
Bolkonski	horsename	Bolkonski
Sweetbriar	horsename	Sweetbriar
Variation	horsename	Variation
Alipes	horsename	Alipes
William the Third	horsename	William the Third
Petingo	horsename	Petingo
Apalachee	horsename	Apalachee
Zilzal	horsename	Zilzal
Thatch	horsename	Thatch
The Bug	horsename	The Bug
Snip	horsename	Snip
Floribunda	horsename	Floribunda
Finian's Rainbow	horsename	Finian's Rainbow
Donor	horsename	Donor
Windy City	horsename	Windy City
Thrush	horsename	Thrush
La Tendresse	horsename	La Tendresse
Caracalla	horsename	Caracalla
Bachelor's Double	horsename	Bachelor's Double
Arbar	horsename	Arbar
Coronation	horsename	Coronation
Time Supply	horsename	Time Supply
Souverain	horsename	Souverain
Chanteur	horsename	Chanteur
Molvedo	horsename	Molvedo
Pope Joan	horsename	Pope Joan
Warning	horsename	Warning
Voltaire	horsename	Voltaire
Charlottesville	horsename	Charlottesville
Never So Bold	horsename	Never So Bold
Le Moss	horsename	Le Moss
Hafiz	horsename	Hafiz
Bering	horsename	Bering
Princely Gift	horsename	Princely Gift
High Top	horsename	High Top
Doyoun	horsename	Doyoun
Darius	horsename	Darius
Nearula	horsename	Nearula
Rockavon	horsename	Rockavon
Kashmir	horsename	Kashmir
Pall Mall	horsename	Pall Mall
Niksar	horsename	Niksar
Baldric	horsename	Baldric
Taboun	horsename	Taboun
Pasch	horsename	Pasch
Xaar	horsename	Xaar
Jack Spigot	horsename	Jack Spigot
Filho da Puta	horsename	Filho da Puta
Pas de Reponse	horsename	Pas de Reponse
Social Outcast	horsename	Social Outcast
Nuclear Debate	horsename	Nuclear Debate
Rowton	horsename	Rowton
The Colonel	horsename	The Colonel
Matilda	horsename	Matilda
Penelope	horsename	Penelope
Margrave	horsename	Margrave
Camel	horsename	Camel
Birmingham	horsename	Birmingham
Sorcerer	horsename	Sorcerer
Chorister	horsename	Chorister
Halloween	horsename	Halloween
Rockingham	horsename	Rockingham
Manifesto	horsename	Manifesto
Sizing Europe	horsename	Sizing Europe
Memnon	horsename	Memnon
Habibi	horsename	Habibi
Jerry	horsename	Jerry
Barefoot	horsename	Barefoot
Theodore	horsename	Theodore
Ebor	horsename	Ebor
Young Giantess	horsename	Young Giantess
Soothsayer	horsename	Soothsayer
Silviniaco Conti	horsename	Silviniaco Conti
Zarkandar	horsename	Zarkandar
Sir Des Champs	horsename	Sir Des Champs
Altisidora	horsename	Altisidora
National Spirit	horsename	National Spirit
Quevega	horsename	Quevega
Otterington	horsename	Otterington
Al Ferof	horsename	Al Ferof
William	horsename	William
Twist Magic	horsename	Twist Magic
Octavian	horsename	Octavian
Ashton	horsename	Ashton
Simonsig	horsename	Simonsig
Hollandoise	horsename	Hollandoise
Petronius	horsename	Petronius
Bourbon	horsename	Bourbon
Paulina	horsename	Paulina
Fyldener	horsename	Fyldener
Staveley	horsename	Staveley
Persian War	horsename	Persian War
Sancho	horsename	Sancho
Remembrancer	horsename	Remembrancer
Bula	horsename	Bula
Omphale	horsename	Omphale
Quiz	horsename	Quiz
Diadem	horsename	Diadem
Cockfighter	horsename	Cockfighter
Symmetry	horsename	Symmetry
Lounger	horsename	Lounger
The Duchess	horsename	The Duchess
Parasol	horsename	Parasol
Pindarrie	horsename	Pindarrie
Antonio	horsename	Antonio
St Patrick	horsename	St Patrick
Ambrosio	horsename	Ambrosio
Beningbrough	horsename	Beningbrough
Ninety-three	horsename	Ninety-three
Sterling	horsename	Sterling
Young Traveller	horsename	Young Traveller
Forpadydeplasterer	horsename	Forpadydeplasterer
Auroras Encore	horsename	Auroras Encore
Tartar	horsename	Tartar
Tag	horsename	Tag
Red Alligator	horsename	Red Alligator
Ambidexter	horsename	Ambidexter
Pewett	horsename	Pewett
Queen of Trumps	horsename	Queen of Trumps
Wings	horsename	Wings
Elis	horsename	Elis
Cue Card	horsename	Cue Card
Blackstairmountain	horsename	Blackstairmountain
Pilgrimage	horsename	Pilgrimage
Mango	horsename	Mango
Certain	horsename	Certain
Don John	horsename	Don John
Jealousy	horsename	Jealousy
Charles the Twelfth	horsename	Charles the Twelfth
Launch a Pegasus	horsename	Launch a Pegasus
Launcelot	horsename	Launcelot
Hephestion	horsename	Hephestion
Trophonius	horsename	Trophonius
Seabreeze	horsename	Seabreeze
Riddlesworth	horsename	Riddlesworth
Lath	horsename	Lath
Bay Malton	horsename	Bay Malton
Squirrel	horsename	Squirrel
Toronado	horsename	Toronado
Cwrw	horsename	Cwrw
Afternoon Deelites	horsename	Afternoon Deelites
Orb	horsename	Orb
Sky Lantern	horsename	Sky Lantern
Hot Snap	horsename	Hot Snap
Storm Song	horsename	Storm Song
Bridget	horsename	Bridget
Ruler	horsename	Ruler
Hannah	horsename	Hannah
Farhh	horsename	Farhh
Pivotal	horsename	Pivotal
Oxbow	horsename	Oxbow
Crow	horsename	Crow
Peleid	horsename	Peleid
Ally Sloper	horsename	Ally Sloper
Sodium	horsename	Sodium
Hethersett	horsename	Hethersett
Aurelius	horsename	Aurelius
Touching Wood	horsename	Touching Wood
Itsmyluckyday	horsename	Itsmyluckyday
Waterloo	horsename	Waterloo
Amphion	horsename	Amphion
Full Dress	horsename	Full Dress
Scottish Union	horsename	Scottish Union
Fiftyshadesofhay	horsename	Fiftyshadesofhay
Ridge Wood	horsename	Ridge Wood
Talent	horsename	Talent
Buskin	horsename	Buskin
Jay Trump	horsename	Jay Trump\n\n'''
Ruler of the World	horsename	Ruler of the World
Effendi	horsename	Effendi
Layminster	horsename	Layminster
Circus Plume	horsename	Circus Plume
Don Enrique	horsename	Don Enrique
Bryn Mawr	horsename	Bryn Mawr
Night Off	horsename	Night Off
Zabara	horsename	Zabara
Happy Laughter	horsename	Happy Laughter
Palace Malice	horsename	Palace Malice
Desmond	horsename	Desmond
Neasham Belle	horsename	Neasham Belle
Steinlen	horsename	Steinlen
Charlebelle	horsename	Charlebelle
Twilight Ridge	horsename	Twilight Ridge
Flanders	horsename	Flanders
Newminster	horsename	Newminster
Old England	horsename	Old England
Magician	horsename	Magician
Carnegie	horsename	Carnegie
Lord Clifden	horsename	Lord Clifden
Mon Fils	horsename	Mon Fils
Ravinella	horsename	Ravinella
Linkage	horsename	Linkage
Sole Power	horsename	Sole Power
Al Kazeem	horsename	Al Kazeem
In the Groove	horsename	In the Groove
Estimate	horsename	Estimate
Marling	horsename	Marling
Ebaziya	horsename	Ebaziya
Islington	horsename	Islington
Enzeli	horsename	Enzeli
Walton	horsename	Walton
Sahpresa	horsename	Sahpresa
Harlan's Holiday	horsename	Harlan's Holiday
Alborada	horsename	Alborada
Königsstuhl	horsename	Königsstuhl
Crafty Admiral	horsename	Crafty Admiral
Edabiya	horsename	Edabiya
Bahri	horsename	Bahri
No Le Hace	horsename	No Le Hace
Surumu	horsename	Surumu
Paynter	horsename	Paynter
Iron Constitution	horsename	Iron Constitution
Blacklegs	horsename	Blacklegs
Diminuendo	horsename	Diminuendo
Play the Red	horsename	Play The Red
Bireme	horsename	Bireme
Bryan G.	horsename	Bryan G.
Juliette Marny	horsename	Juliette Marny
Rich Tradition	horsename	Rich Tradition
Gilles de Retz	horsename	Gilles de Retz
Hindus	horsename	Hindus
Trading Leather	horsename	Trading Leather
Chamossaire	horsename	Chamossaire
Myrobella	horsename	Myrobella
Neapolitan Way	horsename	Neapolitan Way
Charon	horsename	Charon
Rose Bowl	horsename	Rose Bowl
Oratorio	horsename	Oratorio
Mount Nelson	horsename	Mount Nelson
Medicean	horsename	Medicean
Irish Elegance	horsename	Irish Elegance
Simply Perfect	horsename	Simply Perfect
Les Arcs	horsename	Les Arcs
Marwell	horsename	Marwell
Eastern Fleet	horsename	Eastern Fleet
Cadeaux Genereux	horsename	Cadeaux Genereux
Sharpen Up	horsename	Sharpen Up
Halfway to Heaven	horsename	Halfway to Heaven
My Dad George	horsename	My Dad George
Out of the Way	horsename	Out of the Way
First Island	horsename	First Island
Bigstone	horsename	Bigstone
Combat	horsename	Combat
Mannamead	horsename	Mannamead
Chompion	horsename	Chompion
Indian Ink	horsename	Indian Ink
Take Charge Indy	horsename	Take Charge Indy
Novellist	horsename	Novellist
Crimplene	horsename	Crimplene
Ad Valorem	horsename	Ad Valorem
Sendawar	horsename	Sendawar
Intello	horsename	Intello
Peeress	horsename	Peeress
Verrazano	horsename	Verrazano
Height of Fashion	horsename	Height of Fashion
Master Willie	horsename	Master Willie
Artaius	horsename	Artaius
Cormorant Wood	horsename	Cormorant Wood
One So Wonderful	horsename	One So Wonderful
Shardari	horsename	Shardari
War Command	horsename	War Command
Only Royale	horsename	Only Royale
Tolomeo	horsename	Tolomeo
Solford	horsename	Solford
Unite	horsename	Unite
Ajdal	horsename	Ajdal
Don't Forget Me	horsename	Don't Forget Me
Sonic Lady	horsename	Sonic Lady
Darara	horsename	Darara
Declaration of War	horsename	Declaration of War
Teleprompter	horsename	Teleprompter
Sadeem	horsename	Sadeem
Will Take Charge	horsename	Will Take Charge
Gildoran	horsename	Gildoran
Royal Rebel	horsename	Royal Rebel
Cash Run	horsename	Cash Run
Longboat	horsename	Longboat
Paean	horsename	Paean
Milligram	horsename	Milligram
Forest Flower	horsename	Forest Flower
Princess of Sylmar	horsename	Princess of Sylmar
Carroll House	horsename	Carroll House
Park Express	horsename	Park Express
Park Appeal	horsename	Park Appeal
Lear Fan	horsename	Lear Fan
Law Society	horsename	Law Society
Celestial Storm	horsename	Celestial Storm
Wool Winder	horsename	Wool Winder
Mouktar	horsename	Mouktar
Rousillon	horsename	Rousillon
Dunkirk	horsename	Dunkirk
Kala Dancer	horsename	Kala Dancer
Bakharoff	horsename	Bakharoff
Pure Clan	horsename	Pure Clan
Maori Venture	horsename	Maori Venture
Treve	horsename	Treve
Huntingdale	horsename	Huntingdale
Leading Light	horsename	Leading Light
Galileo Rock	horsename	Galileo Rock
Grey Sovereign	horsename	Grey Sovereign
Kizuna	horsename	Kizuna
Derring-Do	horsename	Derring-Do
Sabirli	horsename	Sabirli
Lorenzaccio	horsename	Lorenzaccio
Akiyda	horsename	Akiyda
On the House	horsename	On The House
Awaasif	horsename	Awaasif
Harbour	horsename	Harbour
Green Forest	horsename	Green Forest
L'Emigrant	horsename	L'Emigrant
Luth Enchantee	horsename	Luth Enchantee
Cut Above	horsename	Cut Above
Bikala	horsename	Bikala
Glint of Gold	horsename	Glint of Gold
Military Attack	horsename	Military Attack
Diamond Shoal	horsename	Diamond Shoal
Stanerra	horsename	Stanerra
Jupiter Island	horsename	Jupiter Island
Wind and Wuthering	horsename	Wind and Wuthering
Vayrann	horsename	Vayrann
Queen's Hussar	horsename	Queen's Hussar
Petition	horsename	Petition
My Swallow	horsename	My Swallow
Cawston's Pride	horsename	Cawston's Pride
Deep Diver	horsename	Deep Diver
Sallust	horsename	Sallust
Imperatrix	horsename	Imperatrix
Reform	horsename	Reform
Ki Ming	horsename	Ki Ming
Committed	horsename	Committed
Scratch	horsename	Scratch
Dane Ripper	horsename	Dane Ripper
Cambremer	horsename	Cambremer
Almaarad	horsename	Almaarad
Sing Sing	horsename	Sing Sing
Twilight Alley	horsename	Twilight Alley
Jacinth	horsename	Jacinth
Spectrum	horsename	Spectrum
Olympic Glory	horsename	Olympic Glory
Fairy Footsteps	horsename	Fairy Footsteps
Blue Wind	horsename	Blue Wind
To-Agori-Mou	horsename	To-Agori-Mou
Detroit	horsename	Detroit
Shamus Award	horsename	Shamus Award
Beldale Flutter	horsename	Beldale Flutter
Northjet	horsename	Northjet
Kings Lake	horsename	Kings Lake
Little Wolf	horsename	Little Wolf
Al Nasr	horsename	Al Nasr
Hightail	horsename	Hightail
Light Cavalry	horsename	Light Cavalry
Outstrip	horsename	Outstrip
Chriselliam	horsename	Chriselliam
Kingston Hill	horsename	Kingston Hill
Beholder	horsename	Beholder
Dank	horsename	Dank
Mizdirection	horsename	Mizdirection
Fiorente	horsename	Fiorente
Folklore	horsename	Folklore
Groupie Doll	horsename	Groupie Doll
The Wonder	horsename	The Wonder
Recitation	horsename	Recitation
Madam Gay	horsename	Madam Gay
Circus Ring	horsename	Circus Ring
Tolmi	horsename	Tolmi
Shoot A Line	horsename	Shoot A Line
Precocious	horsename	Precocious
Gorytus	horsename	Gorytus
Quick As Lightning	horsename	Quick As Lightning
Monteverdi	horsename	Monteverdi
Cairn Rouge	horsename	Cairn Rouge
Argument	horsename	Argument
Posse	horsename	Posse
Mrs Penny	horsename	Mrs Penny
Tyrnavos	horsename	Tyrnavos
Shakapour	horsename	Shakapour
Flat Out	horsename	Flat Out
Lord Kanaloa	horsename	Lord Kanaloa
Compton Admiral	horsename	Compton Admiral
Elmaamul	horsename	Elmaamul
Environment Friend	horsename	Environment Friend
One in a Million	horsename	One in a Million
Scintillate	horsename	Scintillate
Tap On Wood	horsename	Tap On Wood
Son of Love	horsename	Son of Love
Tromos	horsename	Tromos
Top Ville	horsename	Top Ville
Le Marmot	horsename	Le Marmot
Joshua Tree	horsename	Joshua Tree
Thatching	horsename	Thatching
Bellypha	horsename	Bellypha
Dickens Hill	horsename	Dickens Hill
Northern Baby	horsename	Northern Baby
Swiss Maid	horsename	Swiss Maid
Gay Mecene	horsename	Gay Mecene
Nebos	horsename	Nebos
Sigy	horsename	Sigy
Toormore	horsename	Toormore
No Nay Never	horsename	No Nay Never
Shared Belief	horsename	Shared Belief
She's a Tiger	horsename	She's a Tiger
Points Offthebench	horsename	Points Offthebench
My Miss Aurelia	horsename	My Miss Aurelia
Annie Power	horsename	Annie Power
The New One	horsename	The New One
Albertas Run	horsename	Albertas Run
Again	horsename	Again
Tarascon	horsename	Tarascon
Saoirse Abu	horsename	Saoirse Abu
Turtle Island	horsename	Turtle Island
Grey Swallow	horsename	Grey Swallow
Like-A-Butterfly	horsename	Like-A-Butterfly
Trabolgan	horsename	Trabolgan
Rule Supreme	horsename	Rule Supreme
Newmill	horsename	Newmill
Back In Front	horsename	Back In Front
Big Zeb	horsename	Big Zeb
French Holly	horsename	French Holly
My Tent Or Yours	horsename	My Tent Or Yours
Darlan	horsename	Darlan
Puccini	horsename	Puccini
Intersky Falcon	horsename	Intersky Falcon
Desert Prince	horsename	Desert Prince
Polar Falcon	horsename	Polar Falcon
Landing Light	horsename	Landing Light
Barton	horsename	Barton
Fiveforthree	horsename	Fiveforthree
Jezki	horsename	Jezki
Our Conor	horsename	Our Conor
Sire de Grugy	horsename	Sire de Grugy
Honor Code	horsename	Honor Code
Champagne Fever	horsename	Champagne Fever
More Of That	horsename	More Of That
Lord Windermere	horsename	Lord Windermere
California Chrome	horsename	California Chrome
Oscar Whisky	horsename	Oscar Whisky
Royal Gait	horsename	Royal Gait
Hunt Ball	horsename	Hunt Ball
Granville Again	horsename	Granville Again
African Story	horsename	African Story
Pineau de Re	horsename	Pineau de Re
Australia	horsename	Australia
Kingman	horsename	Kingman
Just A Way	horsename	Just A Way
Sacred Falls	horsename	Sacred Falls
Seek Again	horsename	Seek Again
Winsili	horsename	Winsili
Wicked Strong	horsename	Wicked Strong
Night of Thunder	horsename	Night of Thunder
Lucky Pulpit	horsename	Lucky Pulpit
Miss France	horsename	Miss France
Tap Dance City	horsename	Tap Dance City
Alkaased	horsename	Alkaased
Ibn Bey	horsename	Ibn Bey
Niniski	horsename	Niniski
Solinus	horsename	Solinus
Julio Mariner	horsename	Julio Mariner
Roland Gardens	horsename	Roland Gardens
Fair Salinia	horsename	Fair Salinia
Hawaiian Sound	horsename	Hawaiian Sound
The Marquis	horsename	The Marquis
Noble Mission	horsename	Noble Mission
Acamas	horsename	Acamas
Buckskin	horsename	Buckskin
The Grey Gatsby	horsename	The Grey Gatsby
Jaazeiro	horsename	Jaazeiro
Homing	horsename	Homing
Marvellous	horsename	Marvellous
Taghrooda	horsename	Taghrooda
Il Tempo	horsename	Il Tempo
Lichine	horsename	Lichine
Ballydoyle	horsename	Ballydoyle
Hoist The King	horsename	Hoist The King
Empire Glory	horsename	Empire Glory
Double Form	horsename	Double Form
Avenir Certain	horsename	Avenir Certain
Invincible Spirit	horsename	Invincible Spirit
Stopchargingmaria	horsename	Stopchargingmaria
Super Concorde	horsename	Super Concorde
Mrs McArdy	horsename	Mrs McArdy
War Front	horsename	War Front
Sanedtki	horsename	Sanedtki
Cloonlara	horsename	Cloonlara
Cherry Hinton	horsename	Cherry Hinton
Crystal Palace	horsename	Crystal Palace
Dancing Maid	horsename	Dancing Maid
Durtal	horsename	Durtal
Pharly	horsename	Pharly
Sir Taurus	horsename	Sir Taurus
Mukhadram	horsename	Mukhadram
Gallo Blue Chip	horsename	Gallo Blue Chip
Sea The Moon	horsename	Sea The Moon
Godswalk	horsename	Godswalk
Scatter the Gold	horsename	Scatter the Gold
Gentilhombre	horsename	Gentilhombre
Rizeena	horsename	Rizeena
Slade Power	horsename	Slade Power
Vitiges	horsename	Vitigès
Integral	horsename	Integral
Gunner B	horsename	Gunner B
Queensway	horsename	Queensway
Relkino	horsename	Relkino
Manado	horsename	Manado
Telescope	horsename	Telescope
Shangamuzo	horsename	Shangamuzo
Untapable	horsename	Untapable
Bayern	horsename	Bayern
Magnificient Style	horsename	Magnificient Style
Theia	horsename	Theia
Lawman	horsename	Lawman
Pasty	horsename	Pasty
Oats	horsename	Oats
Orange Bay	horsename	Orange Bay
Riverqueen	horsename	Riverqueen
Mendez	horsename	Mendez
Siberian Express	horsename	Siberian Express
Lochnager	horsename	Lochnager
Adelaide	horsename	Adelaide
Val de l'Orne	horsename	Val de l'Orne
Nobiliary	horsename	Nobiliary
Mariacci	horsename	Mariacci
Cry of Truth	horsename	Cry of Truth
Broadway Dancer	horsename	Broadway Dancer
Sea Sovereign	horsename	Sea Sovereign
Roussalka	horsename	Roussalka
May Hill	horsename	May Hill
Hittite Glory	horsename	Hittite Glory
Arctic Tern	horsename	Arctic Tern
Sheriff's Star	horsename	Sheriff's Star
Bay Express	horsename	Bay Express
Flirting Around	horsename	Flirting Around
Main Sequence	horsename	Main Sequence
Ectot	horsename	Ectot
Harp Star	horsename	Harp Star
Wild Man From Borneo	horsename	Wild Man From Borneo
Melchbourne	horsename	Melchbourne
Bitty Girl	horsename	Bitty Girl
Gentle Thoughts	horsename	Gentle Thoughts
Polygamy	horsename	Polygamy
Saritamer	horsename	Saritamer
Hippodamia	horsename	Hippodamia
Comtesse de Loir	horsename	Comtesse de Loir
Charm Spirit	horsename	Charm Spirit
Boldboy	horsename	Boldboy
Dankaro	horsename	Dankaro
Caracolero	horsename	Caracolero
Lianga	horsename	Lianga
Take A Reef	horsename	Take A Reef
Dibidale	horsename	Dibidale
Close Hatches	horsename	Close Hatches
Goldencents	horsename	Goldencents
Dayatthespa	horsename	Dayatthespa
Karakontie	horsename	Karakontie
Hooked	horsename	Hooked
Protectionist	horsename	Protectionist
Admire Rakti	horsename	Admire Rakti
Araldo	horsename	Araldo
Toast of New York	horsename	Toast of New York
Ragstone	horsename	Ragstone
Giacometti	horsename	Giacometti
Buoy	horsename	Buoy
Admetus	horsename	Admetus
Gleneagles	horsename	Gleneagles
Tiggy Wiggy	horsename	Tiggy Wiggy
Al Bahathri	horsename	Al Bahathri
Zagreb	horsename	Zagreb
Balthazar King	horsename	Balthazar King
English Prince	horsename	English Prince
Sir Harry Lewis	horsename	Sir Harry Lewis
Winged Love	horsename	Winged Love
Malacate	horsename	Malacate
North Stoke	horsename	North Stoke
Take Charge Lady	horsename	Take Charge Lady
Take Charge Brandi	horsename	Take Charge Brandi
Texas Red	horsename	Texas Red
New Year's Day	horsename	New Year's Day
Epiphaneia	horsename	Epiphaneia
Epitome	horsename	Epitome
Countess Diana	horsename	Countess Diana
Pleasant Stage	horsename	Pleasant Stage
Caressing	horsename	Caressing
Sweet Catomine	horsename	Sweet Catomine
Proud Spell	horsename	Proud Spell
Wait A While	horsename	Wait A While
Bird Town	horsename	Bird Town
Farda Amiga	horsename	Farda Amiga
Surfside	horsename	Surfside
Designs On Rome	horsename	Designs On Rome
Flintshire	horsename	Flintshire
Phoenix Reach	horsename	Phoenix Reach
Able Friend	horsename	Able Friend
Variety Club	horsename	Variety Club
Fairy King Prawn	horsename	Fairy King Prawn
Faugheen	horsename	Faugheen
Teeton Mill	horsename	Teeton Mill
Algan	horsename	Algan
Bobby's Kitten	horsename	Bobby's Kitten
Call Equiname	horsename	Call Equiname
Martha's Son	horsename	Martha's Son
Klairon Davis	horsename	Klairon Davis
Elegant Prince	horsename	Elegant Prince
Kentucky Gold	horsename	Kentucky Gold
Crowned Prince	horsename	Crowned Prince
Deep Sensation	horsename	Deep Sensation
Remittance Man	horsename	Remittance Man
Connaught	horsename	Connaught
Judy the Beauty	horsename	Judy the Beauty
American Pharoah	horsename	American Pharoah
Work All Week	horsename	Work All Week
Belardo	horsename	Belardo
Found	horsename	Found
Connaught Bridge	horsename	Connaught Bridge
Sarah Siddons	horsename	Sarah Siddons
Lagunette	horsename	Lagunette
Olwyn	horsename	Olwyn
John F Kennedy	horsename	John F Kennedy
Tapestry	horsename	Tapestry
Godetia	horsename	Godetia
Kilijaro	horsename	Kilijaro
Gravelines	horsename	Gravelines
Kalamoun	horsename	Kalamoun
Reine de Saba	horsename	Reine de Saba
Dunette	horsename	Dunette
Policeman	horsename	Policeman
Natroun	horsename	Natroun
Hours After	horsename	Hours After
Sanglamore	horsename	Sanglamore
Polytain	horsename	Polytain
Hernando	horsename	Hernando
Ragmar	horsename	Ragmar
Holding Court	horsename	Holding Court
Anabaa Blue	horsename	Anabaa Blue
Blue Canari	horsename	Blue Canari
Mongolian Khan	horsename	Mongolian Khan
Darsi	horsename	Darsi
Mirska	horsename	Mirska
Vautour	horsename	Vautour
Le Havre	horsename	Le Havre
Zephyr Bay	horsename	Zephyr Bay
Reliable Man	horsename	Reliable Man
Saonois	horsename	Saonois
Jolypha	horsename	Jolypha
Un de Sceaux	horsename	Un de Sceaux
Dodging Bullets	horsename	Dodging Bullets
Bacchanal	horsename	Bacchanal
Cole Harden	horsename	Cole Harden
Coneygree	horsename	Coneygree
Princeful	horsename	Princeful
Anzum	horsename	Anzum
Karshi	horsename	Anzum
Cyborgo	horsename	Cyborgo
Flatterer	horsename	Flatterer
Nomadic Way	horsename	Nomadic Way
New Policy	horsename	New Policy
Norton's Coin	horsename	Norton's Coin
Prince Bishop	horsename	Prince Bishop
Charter Party	horsename	Charter Party
Dortmund	horsename	Dortmund
Acclamation	horsename	Acclamation
The Thinker	horsename	The Thinker
Thunder And Roses	horsename	Thunder and Roses
Many Clouds	horsename	Many Clouds
Seagram	horsename	Seagram
Bob Back	horsename	Bob Back
Mr Frisk	horsename	Mr Frisk
Literato	horsename	Literato
Legal Case	horsename	Legal Case
Dernier Empereur	horsename	Dernier Empereur
Limestone Lad	horsename	Limestone Lad
Ask	horsename	Ask
Sweet Idea	horsename	Sweet Idea
Presvis	horsename	Presvis
Lovely Maria	horsename	Lovely Maria
Legatissimo	horsename	Legatissimo
Privy Councillor	horsename	Privy Councillor
Thunderhead	horsename	Thunderhead
Happy Knight	horsename	Happy Knight
Jay Eye See	horsename	Jay Eye See
Kingsway	horsename	Kingsway
Lambert Simnel	horsename	Lambert Simnel
Dancing Time	horsename	Dancing Time
Firing Line	horsename	Firing Line
Picture Play	horsename	Picture Play
Believe It	horsename	Believe It
Hycilla	horsename	Hycilla
Why Hurry	horsename	Why Hurry
Keen Pauline	horsename	Keen Pauline
Hidden Lake	horsename	Hidden Lake
Don Cossack	horsename	Don Cossack
Elm Park	horsename	Elm Park
Taj Rossi	horsename	Taj Rossi
Golden Horn	horsename	Golden Horn
Epicuris	horsename	Epicuris
Solow	horsename	Solow
Tehran	horsename	Tehran
Turkhan	horsename	Turkhan
Sun Castle	horsename	Sun Castle
Commotion	horsename	Commotion
Talma	horsename	Talma
Sardanapale	horsename	Sardanapale
Duramente	horsename	Duramente
La Farina	horsename	La Farina
Sayani	horsename	Sayani
Jack Hobbs	horsename	Jack Hobbs
Persian Gulf	horsename	Persian Gulf
Romeo Hanover	horsename	Romeo Hanover
Qualify	horsename	Qualify
Felicitation	horsename	Felicitation
Picaroon	horsename	Picaroon
Littleprincessemma	horsename	Littleprincessemma
Mon Talisman	horsename	Mon Talisman
Eclair au Chocolat	horsename	Eclair au Chocolat
Tanerko	horsename	Tanerko
Mieuxce	horsename	Mieuxce
Clairvoyant	horsename	Clairvoyant
Easton	horsename	Easton
Prestige	horsename	Prestige
Tiller	horsename	Tiller
Dubai Destination	horsename	Dubai Destination
Araafa	horsename	Araafa
Free Eagle	horsename	Free Eagle
Byword	horsename	Byword
Papineau	horsename	Papineau
Trip To Paris	horsename	Trip To Paris
Shake The Yoke	horsename	Shake The Yoke
Exclusive	horsename	Exclusive
Fallen For You	horsename	Fallen For You
Immortal Verse	horsename	Immortal Verse
Maids Causeway	horsename	Maids Causeway
Lillie Langtry	horsename	Lillie Langtry
Balisada	horsename	Balisada
Sophisticat	horsename	Sophisticat
Kissing Cousin	horsename	Kissing Cousin
Gold Splash	horsename	Gold Splash
Chimes of Freedom	horsename	Chimes of Freedom
Golden Opinion	horsename	Golden Opinion
Magic of Life	horsename	Magic of Life
Excellent Art	horsename	Excellent Art
Zafeen	horsename	Zafeen
Black Minnaloushe	horsename	Black Minnaloushe
Dr Fong	horsename	Dr Fong
Starborough	horsename	Starborough
Bijou d'Inde	horsename	Bijou d'Inde
Muhaarar	horsename	Muhaarar
Brief Truce	horsename	Brief Truce
Shavian	horsename	Shavian
Shaadi	horsename	Shaadi
Persian Heights	horsename	Persian Heights
Proclamation	horsename	Proclamation
Among Men	horsename	Among Men
Distant View	horsename	Distant View
Dylan Mouth	horsename	Dylan Mouth
Postponed	horsename	Postponed
Soviet Star	horsename	Soviet Star
Second Set	horsename	Second Set
Distant Relative	horsename	Distant Relative
Ali-Royal	horsename	Ali-Royal
Reel Buddy	horsename	Reel Buddy
Court Masterpiece	horsename	Court Masterpiece
Noalcoholic	horsename	Noalcoholic
Ace of Aces	horsename	Ace of Aces
Pastoral Pursuits	horsename	Pastoral Pursuits
Agnes World	horsename	Agnes World
Elnadim	horsename	Elnadim
Compton Place	horsename	Compton Place
Arabian Queen	horsename	Arabian Queen
Lake Coniston	horsename	Lake Coniston
Owington	horsename	Owington
Hamas	horsename	Hamas
Polish Patriot	horsename	Polish Patriot
Jwala	horsename	Jwala
Margot Did	horsename	Margot Did
Keen Ice	horsename	Keen Ice
Upset	horsename	Upset
Borderlescott	horsename	Borderlescott
Kingsgate Native	horsename	Kingsgate Native
La Cucaracha	horsename	La Cucaracha
Bahamian Pirate	horsename	Bahamian Pirate
Kyllachy	horsename	Kyllachy
Lochangel	horsename	Lochangel
Ya Malak	horsename	Ya Malak
Bondi Beach	horsename	Bondi Beach
Coastal Bluff	horsename	Coastal Bluff
So Factual	horsename	So Factual
Piccolo	horsename	Piccolo
Simple Verse	horsename	Simple Verse
Handsome Sailor	horsename	Handsome Sailor
Shalaa	horsename	Shalaa
My Emma	horsename	My Emma
Catchascatchcan	horsename	Catchascatchcan
Rhyme 'n' Reason	horsename	Rhyme 'n' Reason
Shutthefrontdoor	horsename	Shutthefrontdoor
Quiff	horsename	Quiff
Punctilious	horsename	Punctilious
New Bay	horsename	New Bay
Key Change	horsename	Key Change
Air Force Blue	horsename	Air Force Blue
Pure Grain	horsename	Pure Grain
Shareta	horsename	Shareta
Germany	horsename	Germany
Super Tassa	horsename	Super Tassa
Magnificent Star	horsename	Magnificent Star
Fascinating Rock	horsename	Fascinating Rock
Hellenic	horsename	Hellenic
Roseate Tern	horsename	Roseate Tern
Winx	horsename	Winx
Bint Pasha	horsename	Bint Pasha
Untold	horsename	Untold
Sally Brown	horsename	Sally Brown
Esoterique	horsename	Esoterique
Make Believe	horsename	Make Believe
Liam's Map	horsename	Liam's Map
Minding	horsename	Minding
Stephanie's Kitten	horsename	Stephanie's Kitten
Songbird	horsename	Songbird
Runhappy	horsename	Runhappy
Prince of Penzance	horsename	Prince of Penzance
Tepin	horsename	Tepin
King Kamehameha	horsename	King Kamehameha
Lovely Day	horsename	Lovely Day
Special Week	horsename	Special Week
Grass Wonder	horsename	Grass Wonder
Jungle Pocket	horsename	Jungle Pocket
Rose Kingdom	horsename	Rose Kingdom
Screen Hero	horsename	Screen Hero
Lando	horsename	Lando
Marvelous Crown	horsename	Marvelous Crown
Legacy World	horsename	Legacy World
Ginevra	horsename	Ginevra
Pay the Butler	horsename	Pay the Butler
Katsuragi Ace	horsename	Katsuragi Ace
Half Iced	horsename	Half Iced
Brown Panther	horsename	Brown Panther
Red Cadeaux	horsename	Red Cadeaux
Condessa	horsename	Condessa
Blue Blue Sea	horsename	Blue Blue Sea
Busaca	horsename	Busaca
Attica Meli	horsename	Attica Meli
Sookera	horsename	Sookera
Devon Ditty	horsename	Devon Ditty
Woodstream	horsename	Woodstream
Desirable	horsename	Desirable
Embla	horsename	Embla
Minstrella	horsename	Minstrella
Pass the Peace	horsename	Pass the Peace
Dead Certain	horsename	Dead Certain
Capricciosa	horsename	Capricciosa
Wannabe Grand	horsename	Wannabe Grand
Seazun	horsename	Seazun
Regal Rose	horsename	Regal Rose
Airwave	horsename	Airwave
Carry On Katie	horsename	Carry On Katie
Magical Romance	horsename	Magical Romance
Donna Blini	horsename	Donna Blini
Serious Attitude	horsename	Serious Attitude
Hooray	horsename	Hooray
Lightening Pearl	horsename	Lightening Pearl
Rosdhu Queen	horsename	Rosdhu Queen
Vorda	horsename	Vorda
Shamshir	horsename	Shamshir
Ivanka	horsename	Ivanka
Fairy Heights	horsename	Fairy Heights
Aqaarid	horsename	Aqaarid
Glorosia	horsename	Gloriosa
Sunspangled	horsename	Sunspangled
JK Shesalady	horsename	JK Shesalady
Teggiano	horsename	Teggiano
Gossamer	horsename	Gossamer
Red Bloom	horsename	Red Bloom
Listen	horsename	Listen
Hibaayeb	horsename	Hibaayeb
White Moonstone	horsename	White Moonstone
Lyric of Light	horsename	Lyric of Light
Together Forever	horsename	Together Forever
Casamento	horsename	Casamento
Dilshaan	horsename	Dilshaan
American Post	horsename	American Post
Nichols Canyon	horsename	Nichols Canyon
The Tatling	horsename	The Tatling
Maurice	horsename	Maurice
Manhattan Cafe	horsename	Manhattan Cafe
Still in Love	horsename	Still in Love
Admire Vega	horsename	Admire Vega
Bubble Gum Fellow	horsename	Bubble Gum Fellow
Dance Partner	horsename	Dance Partner
Genuine	horsename	Genuine
Stellar Wind	horsename	Stellar Wind
Halwes	horsename	Halwes
Preux Chevalier	horsename	Preux Chevalier
Big Blue Kitten	horsename	Big Blue Kitten
Village Kid	horsename	Village Kid
Take Your Place	horsename	Take Your Place
Sporting Yankee	horsename	Sporting Yankee
Dactylographer	horsename	Dactylographer
Sandy Creek	horsename	Sandy Creek
Hello Gorgeous	horsename	Hello Gorgeous
Most Happy Fella	horsename	Most Happy Fella
Count Pahlen	horsename	Count Pahlen
La Verdad	horsename	La Verdad
Dunbeath	horsename	Dunbeath
Alphabatim	horsename	Alphabatim
Lanfranco	horsename	Lanfranco
Smoken Up	horsename	Smoken Up
Emmson	horsename	Emmson
Al Hareb	horsename	Al Hareb
Be My Chief	horsename	Be My Chief
Peter Davies	horsename	Peter Davies
Seattle Rhyme	horsename	Seattle Rhyme
Armiger	horsename	Armiger
Beauchamp King	horsename	Beauchamp King
Medaaly	horsename	Medaaly
Saratoga Springs	horsename	Saratoga Springs
Commander Collins	horsename	Commander Collins
Aristotle	horsename	Aristotle
Palace Episode	horsename	Palace Episode
Westburn Grant	horsename	Westburn Grant
Ibn Khaldun	horsename	Ibn Khaldun
Crowded House	horsename	Crowded House
Nihilator	horsename	Nihilator
Cellini	horsename	Cellini
Habat	horsename	Habat
Steel Heart	horsename	Steel Heart
Tachypous	horsename	Tachypous
Mohaymen	horsename	Mohaymen
Formidable	horsename	Formidable
Junius	horsename	Junius
Lawn Derby	horsename	Lawn Derby
Mattaboy	horsename	Mattaboy
Cajun	horsename	Cajun
Creag-An-Sgor	horsename	Creag-An-Sgor
Rangipo	horsename	Rangipo
Star of Seville	horsename	Star of Seville
Bassenthwaite	horsename	Bassenthwaite
Stalker	horsename	Stalker
Mister Majestic	horsename	Mister Majestic
Gallic League	horsename	Gallic League
Mon Tresor	horsename	Mon Tresor
Douvan	horsename	Douvan
Thistlecrack	horsename	Thistlecrack
Djakadam	horsename	Djakadam
Red Splash	horsename	Red Splash
Im Themightyquinn	horsename	Im Themightyquinn
Ballinode	horsename	Ballinode
Koko	horsename	Koko
Thrown In	horsename	Thrown In
Patron Saint	horsename	Patron Saint
Easter Hero	horsename	Easter Hero
Morse Code	horsename	Morse Code
Brendan's Cottage	horsename	Brendan's Cottage
Roman Hackle	horsename	Roman Hackle
Poet Prince	horsename	Poet Prince
Buffering	horsename	Buffering
Medoc II	horsename	Medoc II
Red Rower	horsename	Red Rower
Prince Regent	horsename	Prince Regent
Fortina	horsename	Fortina
Silver Fame	horsename	Silver Fame
Mont Tremblant	horsename	Mont Tremblant
Rule the World	horsename	Rule the World
Knock Hard	horsename	Knock Hard
Four Ten	horsename	Four Ten
Gay Donald	horsename	Gay Donald
Limber Hill	horsename	Limber Hill
Linwell	horsename	Linwell
Kerstin	horsename	Kerstin
Roddy Owen	horsename	Roddy Owen
Marcel	horsename	Marcel
Galileo Gold	horsename	Galileo Gold
Lumiere	horsename	Lumiere
Forli	horsename	Forli
Brody's Cause	horsename	Brody's Cause
Exaggerator	horsename	Exaggerator
Cathryn Sophia	horsename	Cathryn Sophia
Fast Clip	horsename	Fast Clip
Dark Angel	horsename	Dark Angel
Lujain	horsename	Lujain
Primo Valentino	horsename	Primo Valentino
Minardi	horsename	Minardi
Tizway	horsename	Tizway
Caleb's Posse	horsename	Caleb's Posse
Zagora	horsename	Zagora
Glória de Campeão	horsename	Gloria de Campeao
Dutch Art	horsename	Dutch Art
Merman	horsename	Merman
The Gurkha	horsename	The Gurkha
Wings of Desire	horsename	Wings of Desire
Awtaad	horsename	Awtaad
Ben's Cat	horsename	Ben's Cat
Pleascach	horsename	Pleascach
Wiggle It Jiggleit	horsename	Wiggle It Jiggleit
A Shin Hikari	horsename	A Shin Hikari
Order of St George	horsename	Order of St George
Squirt	horsename	Squirt
Makahiki	horsename	Makahiki
Deep Brillante	horsename	Deep Brillante
Logi Universe	horsename	Logi Universe
US Army Ranger	horsename	US Army Ranger
Cloth of Stars	horsename	Cloth of Stars
Harzand	horsename	Harzand
Boreal	horsename	Boreal
Daliapour	horsename	Daliapour
Sunshack	horsename	Sunshack
Creator	horsename	Creator
Apple Tree	horsename	Apple Tree
Saddlers' Hall	horsename	Saddlers' Hall
Frosted	horsename	Frosted
Saint Estephe	horsename	Saint Estephe
Be My Native	horsename	Be My Native
Easter Sun	horsename	Easter Sun
Sea Chimes	horsename	Sea Chimes
Quiet Fling	horsename	Quiet Fling
Lailani	horsename	Lailani
Speightstown	horsename	Speightstown
Zahrat Dubai	horsename	Zahrat Dubai
Sultanina	horsename	Sultanina
Favourable Terms	horsename	Favourable Terms
Rajeem	horsename	Rajeem
Nahoodh	horsename	Nahoodh
Music Show	horsename	Music Show
Lady Eli	horsename	Lady Eli
Billy Kelly	horsename	Billy Kelly
Timepiece	horsename	Timepiece
Giofra	horsename	Giofra
Lexie Lou	horsename	Lexie Lou
Spinning Queen	horsename	Spinning Queen
Majestic Roi	horsename	Majestic Roi
Half Time	horsename	Half Time
Paul Kauvar	horsename	Paul Kauvar
Margrave	horsename	Margrave
Assignee	horsename	Assignee
Montague	horsename	Montague
Buddhist	horsename	Buddhist
Refund	horsename	Refund
Dunboyne	horsename	Dunboyne
Tecumseh	horsename	Tecumseh
Knight of Ellerslie	horsename	Knight of Ellerslie
Jacobus	horsename	Jacobus
Vanguard	horsename	Vanguard
Saunterer	horsename	Saunterer
Siyouma	horsename	Siyouma
Grenada	horsename	Grenada
Cloverbrook	horsename	Cloverbrook
Culpepper	horsename	Culpepper
Shirley	horsename	Shirley
Lahib	horsename	Lahib
Maroof	horsename	Maroof
Highland Reel	horsename	Highland Reel
Shady Heights	horsename	Shady Heights
Le Capucin	horsename	Le Capucin
Ile de Chypre	horsename	Ile de Chypre
Dowsing	horsename	Dowsing
Moulton	horsename	Moulton
Little Mike	horsename	Little Mike
Scottish Rifle	horsename	Scottish Rifle
Sandford Lad	horsename	Sandford Lad
Noble Decree	horsename	Noble Decree
Targowice	horsename	Targowice
Ben Nevis	horsename	Ben Nevis
Simbir	horsename	Simbir
Lunchtime	horsename	Lunchtime
Weavers' Hall	horsename	Weavers' Hall
Sharp Edge	horsename	Sharp Edge
Hawkbill	horsename	Hawkbill
Seventh Heaven	horsename	Seventh Heaven
Mecca's Angel	horsename	Mecca's Angel
Distant Music	horsename	Distant Music
Mujahid	horsename	Mujahid
Arrogate	horsename	Arrogate
In Command	horsename	In Command
Dashing Blade	horsename	Dashing Blade
Intense Focus	horsename	Intense Focus
Scenic	horsename	Scenic
Prince of Dance	horsename	Prince of Dance
Tout Seul	horsename	Tout Seul
Shaman Ghost	horsename	Shaman Ghost
Quiet Reflection	horsename	Quiet Reflection
Diktat	horsename	Diktat
Idaho	horsename	Idaho
Harbour Law	horsename	Harbour Law
Almanzor	horsename	Almanzor
Tante Rose	horsename	Tante Rose
The Pizza Man	horsename	The Pizza Man
Cherokee Rose	horsename	Cherokee Rose
Rachel's Valentina	horsename	Rachels Valentina
Goodricke	horsename	Goodricke
Lavinia Fontana	horsename	Lavinia Fontana
Hot Hitter	horsename	Hot Hitter
Gormley	horsename	Gormley
Bolt The Duer	horsename	Bolt The Duer
Iktamal	horsename	Iktamal
Wrath of Titans	horsename	Wrath of Titans
Malibu Moon	horsename	Malibu Moon
Pipalong	horsename	Pipalong
Churchill	horsename	Churchill
African Rose	horsename	African Rose
Classic Empire	horsename	Classic Empire
Practical Joke	horsename	Practical Joke
Markab	horsename	Markab
Limato	horsename	Limato
Laverne Hanover	horsename	Laverne Hanover
Fayr Jag	horsename	Fayr Jag
