Bruntingthorpe Aerodrome	lid	EG74
St. Albert Airport	lid	CES3
Al Asad Airbase	lid	MAA
Ciudad Real Central Airport	lid	CQM
Ali Air Base	lid	TAL
Land Force Atlantic Area Training Centre Aldershot	lid	CKM9
Mar de Cortés International Airport	lid	(Location of airport in Mexico)
Cape Gloucester Airport	lid	CPG
Saidor Airport	lid	SDR
Finschhafen Airport	lid	FIN
Ikerasak Heliport	lid	IKE
Illorsuit Heliport	lid	ILL
Ukkusissat Heliport	lid	UKK
Saqqaq Heliport	lid	QUP
Qeqertaq Heliport	lid	QQT
Aappilattoq Heliport	lid	AAP
Upernavik Kujalleq Heliport	lid	UPK
Kangersuatsiaq Heliport	lid	KAQ
Calzada Larga Airport	lid	MP23
Chame Airport	lid	MP24
Mutukula Airport	lid	UG-0003
Shiroro Airstrip	lid	DN50
Castellón–Costa Azahar Airport	lid	CDT
Al-Taqaddum Air Base	lid	MAT
Anse-à-Galets Airport	lid	HT-0002
Sangapi Airport	lid	SNI
Gallia–Meigs Regional Airport	lid	GAS
Bajoga Northeast Airport	lid	DN54
Goldstone Gts Airport	lid	0
Tangier Island Airport	lid	TGI
Güeppi Airport	lid	SP01
