Roman Catholic Archdiocese of Tours	local	Archidiocèse de Tours
Roman Catholic Archdiocese of Quebec	local	Archidiocèse de Québec
Roman Catholic Archdiocese of Los Angeles	local	(Arquidiócesis de Los Ángeles)
Roman Catholic Archdiocese of San Francisco	local	(Arquidiócesis de San Francisco)
Roman Catholic Diocese of Urgell	local	Diócesis de Urgell
Roman Catholic Diocese of Urgell	local	Diòcesi d'Urgell
Japanese Orthodox Church	local	日本ハリストス正教会
Diocese of Sodor and Man	local	Aspickys Sodor as Vannin
Roman Catholic Diocese of Sofia and Plovdiv	local	Епархия София и Пловдив
Roman Catholic Diocese of Mainz	local	Bistum Mainz
Roman Catholic Diocese of Surat Thani	local	สังฆมณฑลสุราษฎร์ธานี
Roman Catholic Archdiocese of Bangkok	local	อัครสังฆมณฑลกรุงเทพฯ
Roman Catholicism in Thailand	local	อัครสังฆมณฑลกรุงเทพฯ
Roman Catholic Diocese of Passau	local	Bistum Passau
Diocese of St Asaph	local	Esgobaeth Llanelwy
Diocese of Växjö	local	Växjö stift
Diocese of Monmouth	local	Esgobaeth Mynwy
Roman Catholic Archdiocese of Besançon	local	Archidiocèse de Besançon
Roman Catholic Diocese of Basel	local	Bistum Basel
Roman Catholic Diocese of Saint Gallen	local	Bistum Sankt Gallen
Roman Catholic Diocese of Chur	local	Bistum Chur
Roman Catholic Diocese of Arecibo	local	Diócesis de Arecibo
Roman Catholic Diocese of Caguas	local	Diócesis de Caguas
Roman Catholic Diocese of Ponce	local	Diócesis de Ponce
Roman Catholic Diocese of Mayagüez	local	Diócesis de Mayagüez
Roman Catholic Archdiocese of San Juan de Puerto Rico	local	Arquidiócesis de San Juan
Roman Catholic Archdiocese of San Juan de Puerto Rico	local	de Puerto Rico
Roman Catholic Archdiocese of Manila	local	Arkidiyosesis ng Maynila
Roman Catholic Archdiocese of Manila	local	(Arquidiócesis de Manila)
Roman Catholic Archdiocese of Esztergom-Budapest	local	Esztergom-Budapesti Főegyházmegye
Roman Catholic Archdiocese of Eger	local	Egri főegyházmegye
Roman Catholic Diocese of Chiang Mai	local	สังฆมณฑลเชียงใหม่
Roman Catholic Archdiocese of Jaro	local	Arkidiyosesis sang Jaro
Roman Catholic Archdiocese of Milan	local	Arcidiocesi di Milano
Diocese of Oslo	local	Oslo bispedømme
Roman Catholic Archdiocese of Venice	local	Patriarcato di Venezia
Archdiocese of Uppsala	local	Uppsala stift
Diocese of Sør-Hålogaland	local	Sør-Hålogaland bispedømme
Roman Catholic Diocese of Chanthaburi	local	สังฆมณฑลจันทบุรี
Roman Catholic Archdiocese of Paris	local	Archidiocèse de Paris
Roman Catholic Archdiocese of New Orleans	local	Archidiocèse de la Nouvelle-Orléans
Roman Catholic Archdiocese of Reims	local	Archidiocèse de Reims
Patriarchate of Lisbon	local	Patriarcado de Lisboa
Roman Catholic Archdiocese of Puebla de los Ángeles	local	Arquidiócesis de Puebla de los Angeles
Roman Catholic Archdiocese of Munich and Freising	local	Bistum München und Freising
Roman Catholic Archdiocese of Bamberg	local	Erzbistum Bamberg
Roman Catholic Archdiocese of Utrecht	local	Aartsbisdom Utrecht
Roman Catholic Diocese of Hong Kong	local	香港教區
Roman Catholic Archdiocese of Ranchi	local	रांची के सूबा
Roman Catholic Diocese of Haarlem-Amsterdam	local	Bisdom Haarlem-Amsterdam
Roman Catholic Diocese of Beauvais	local	Diocèse de Beauvais - Noyon - Senlis
Roman Catholic Diocese of Sindhudurg	local	सिंधुदुर्ग के सूबा
Roman Catholic Archdiocese of Gwangju	local	광주 대교구
Roman Catholic Archdiocese of Seoul	local	서울 대교구
Roman Catholic Archdiocese of Daegu	local	대구 대교구
Roman Catholic Diocese of Andong	local	안동 교구
Roman Catholic Diocese of Chunchon	local	춘천 교구
Roman Catholic Diocese of Gulbarga	local	गुलबर्गा के सूबा
Roman Catholic Diocese of Incheon	local	인천 교구
Roman Catholic Diocese of Cheju	local	제주 교구
Roman Catholic Diocese of Pyongyang	local	평양 교구
Roman Catholic Diocese of Jeonju	local	전주 교구
Roman Catholic Diocese of Busan	local	부산 교구
Roman Catholic Diocese of Suwon	local	수원 교구
Roman Catholic Diocese of Uijeongbu	local	의정부시
Roman Catholic Diocese of Wonju	local	원주 교구
Roman Catholic Diocese of Daejeon	local	대전 교구
Roman Catholic Archdiocese of Gniezno	local	Archidiecezja Gnieźnieńska
Roman Catholic Diocese of Jaipur	local	जयपुर के सूबा
Roman Catholic Diocese of Roermond	local	Bisdom Roermond
Roman Catholic Territorial Prelature of Batanes	local	Prelatura Teritoryal ng Batanes
Apostolic Vicariate of Paksé	local	ອັກຄະສາວົກແທນຂອງເມືອງປາກເຊ
Roman Catholic Diocese of Đà Lạt	local	Giáo phận Ðà Lạt
Roman Catholic Diocese of Kon Tum	local	Giáo phận Kontum
Roman Catholic Diocese of Ban Mê Thuột	local	Giáo phận Ban Mê Thuột
Roman Catholic Diocese of Trebinje-Mrkan	local	Trebinjsko-mrkanska biskupija
Roman Catholic Diocese of Banja Luka	local	Banjolučka biskupija
Roman Catholic Diocese of Mostar-Duvno	local	Mostarsko-duvanjska biskupija
Roman Catholic Archdiocese of Vrhbosna	local	Vrhbosanska nadbiskupija
Diocese of Skara	local	Skara stift
Roman Catholic Diocese of Tezpur	local	तेजपुर के सूबा
Apostolic Prefecture of Battambang	local	ភូមិភាគបាត់ដំបង
Apostolic Prefecture of Kompong Cham	local	ភូមិភាគកំពង់ចាម
Ancient See of Aarhus	local	Aarhus Stift
Diocese of Lund	local	Lunds stift
Diocese of Lund	local	Lund ærkebispedømme
Apostolic Vicariate of Phnom Penh	local	សាវកជំនួសរាជធានីភ្នំពេញ
Diocese of Stavanger	local	''
Roman Catholic Diocese of Hildesheim	local	Bistum Hildesheim
Roman Catholic Diocese of Osnabrück	local	Bistum Osnabrück
Roman Catholic Diocese of Sion	local	Bistum Sitten
Roman Catholic Diocese of Sion	local	Évêché de Sion
Roman Catholic Archdiocese of Toledo	local	Archidiócesis de Toledo
Roman Catholic Diocese of Serrinha	local	Diocese de Serrinha
Roman Catholic Diocese of Jaca	local	Diócesis de Jaca
Diocese of Swansea and Brecon	local	Esgobaeth Abertawe ac Aberhonddu
Roman Catholic Diocese of Dubrovnik	local	Dubrovačka biskupija
Diocese of Gothenburg	local	Göteborgs stift
Diocese of Linköping	local	Linköpings stift
Diocese of Karlstad	local	Karlstads stift
Diocese of Härnösand	local	Härnösands stift
Diocese of Luleå	local	Luleå stift
Roman Catholic Archdiocese of Cambrai	local	Archidiocèse de Cambrai
Roman Catholic Archdiocese of Caceres	local	Arkidiyosesis kan Cáceres
Roman Catholic Diocese of Xuân Lộc	local	Giáo phận Xuân Lộc
Roman Catholic Diocese of Thanh Hóa	local	Giáo phận Thanh Hóa
Roman Catholic Diocese of Bà Rịa	local	Giáo phận Bà Rịa
Diocese of Llandaff	local	Esgobaeth Llandaf
Diocese of Stockholm	local	Stockholms stift
Diocese of Västerås	local	Västerås stift
Diocese of Strängnäs	local	Strängnäs stift
Diocese of Visby	local	Visby stift
Roman Catholic Diocese of Buxar	local	बक्सर के सूबा
Roman Catholic Diocese of Querétaro	local	Diócesis de Querétaro
Roman Catholic Diocese of Quimper	local	Diocèse de Quimper et Léon
Roman Catholic Diocese of Imus	local	Diyosesis ng Imus
Roman Catholic Diocese of Itanagar	local	ईटानगर के सूबा
Roman Catholic Diocese of Miao	local	मियाओ के सूबा
Roman Catholic Archdiocese of Bourges	local	Archidiocèse de Bourges
Roman Catholic Diocese of Maumere	local	Keuskupan Maumere
Roman Catholic Diocese of Orange	local	Giáo phận Quận Cam
Roman Catholic Archdiocese of Yucatán	local	Arquidiócesis de Yucatán
Roman Catholic Archdiocese of Rouen	local	Archidiocèse de Rouen
Roman Catholic Archdiocese of Freiburg	local	Erzbistum Freiburg
Roman Catholic Diocese of Coutances	local	Diocèse de Coutances-Avranches
Roman Catholic Diocese of San Diego	local	Diócesis de San Diego
Roman Catholic Diocese of Copenhagen	local	Bispedømmet København
Roman Catholic Diocese of Reykjavík	local	Biskupsdæmi Reykjavíkur
Apostolic Vicariate of Savannakhet	local	ອັກຄະສາວົກແທນຂອງສະຫວັນນະເຂດ
Roman Catholic Diocese of Helsinki	local	Helsingin katolinen hiippakunta - Helsingfors katolska stift
Roman Catholic Diocese of Down and Connor	local	Deoise An Dúin agus Chonaire
Apostolic Vicariate of Luang Prabang	local	ອັກຄະສາວົກແທນຂອງແຂວງຫລວງພະບາງ
Roman Catholic Diocese of Linares	local	Diócesis de Linares
Roman Catholic Archdiocese of Guadalajara	local	Arquidiócesis de Guadalajara
Apostolic Vicariate of Brunei Darussalam	local	Kerasulan Vicariate Brunei
Roman Catholic Archdiocese of Monterrey	local	Arquidiócesis de Monterrey
Roman Catholic Archdiocese of Hermosillo	local	Arquidiócesis de Hermosillo
Roman Catholic Archdiocese of Acapulco	local	Arquidiócesis de Acapulco
Roman Catholic Diocese of Macau	local	天主教澳門教區
Roman Catholic Diocese of Macau	local	Tiānzhǔjiào Àomén jiàoqū
Roman Catholic Archdiocese of Vaduz	local	Erzbistum Vaduz
Roman Catholic Diocese of Darjeeling	local	दार्जिलिंग के सूबा
Diocese of St David's	local	Esgobaeth Tyddewi
Roman Catholic Diocese of Varaždin	local	Varaždinska biskupija
Roman Catholic Archdiocese of Armagh	local	Ard-Deoise Ard Mhacha
Roman Catholic Archdiocese of Davao	local	Arsidyosesis sa Davao
Roman Catholic Diocese of Meaux	local	Diocèse de Meaux
Roman Catholic Diocese of Jashpur	local	जशपुर के सूबा
Roman Catholic Archdiocese of Bar	local	Barska Nadbiskupija
Roman Catholic Archdiocese of Bar	local	Kryedioqeza e Tivarit
Apostolic Administration of Prizren	local	Administrata Apostolike
Apostolic Administration of Prizren	local	Призренска апостолска администратура
Roman Catholic Diocese of Subotica	local	Епархија Суботице
Roman Catholic Diocese of Zrenjanin	local	Епархија Зрењанин
Roman Catholic Diocese of Hvar-Brač-Vis	local	Hvarsko-bračko-viška biskupija
Roman Catholic Archdiocese of Paderborn	local	Erzbistum Paderborn
Romanian Greek Catholic Major Archdiocese of Făgăraș and Alba Iulia	local	Arhieparhia de Făgăraș și Alba Iulia
Roman Catholic Diocese of Stockholm	local	Stockholms katolska stift
Diocese of Sigtuna	local	Sigtuna stift
Roman Catholic Archdiocese of Lyon	local	Archidiocèse de Lyon
Roman Catholic Archdiocese of Bordeaux	local	Archidiocèse de Bordeaux-Bazas
Roman Catholic Diocese of Gap	local	Diocèse de Gap-Embrun
Roman Catholic Diocese of Fréjus-Toulon	local	Diocèse de Fréjus-Toulon
Roman Catholic Diocese of Digne	local	Diocèse de Digne-Riez-Sisteron
Roman Catholic Archdiocese of Aix	local	Archidiocèse d'Aix-Arles
Roman Catholic Diocese of Tulle	local	Diocèse de Tulle
Roman Catholic Archdiocese of Braga	local	Arquidiocese de Braga
Roman Catholic Diocese of Nice	local	Diocèse de Nice
Roman Catholic Diocese of Limoges	local	Diocèse de Limoges
Roman Catholic Diocese of Troyes	local	Diocèse de Troyes
Roman Catholic Diocese of Požega	local	Požeška biskupija
Roman Catholic Diocese of Mondoñedo-Ferrol	local	Diócesis de Mondoñedo-Ferrol
Roman Catholic Archdiocese of Malta	local	Arċidjoċesi ta' Malta
Roman Catholic Diocese of Tui-Vigo	local	Diócesis de Tui-Vigo (Spanish)
Roman Catholic Diocese of Tui-Vigo	local	Diocese de Tui-Vigo (Galician)
Roman Catholic Archdiocese of Santiago de Compostela	local	Arquidiócesis de Santiago de Compostela
Roman Catholic Diocese of Ourense	local	Diócesis de Ourense
Roman Catholic Diocese of Lugo	local	Diócesis de Lugo
Roman Catholic Diocese of Metz	local	Diocèse de Metz
Roman Catholic Archdiocese of Wrocław	local	Archidiecezja Wrocławska
Roman Catholic Archdiocese of Rosario	local	Arquidiócesis de Rosario
Roman Catholic Diocese of Huesca	local	Diócesis de Huesca
Roman Catholic Archdiocese of Zaragoza	local	Archidiócesis de Zaragoza
Roman Catholic Diocese of Séez	local	Diocèse de Séez
Roman Catholic Diocese of Tarazona	local	Diócesis de Tarazona
Roman Catholic Diocese of Barbastro-Monzón	local	Diócesis de Barbastro-Monzón
Roman Catholic Diocese of Lleida	local	Diócesis de Lleida (Spanish)
Roman Catholic Diocese of Lleida	local	Diòcesi de Lleida (Catalan)
Roman Catholic Diocese of Bayeux	local	Diocèse de Bayeux-Lisieux
Roman Catholic Diocese of Teruel and Albarracín	local	Diócesis de Teruel y Albarracín
Roman Catholic Diocese of Segorbe-Castellón	local	Diócesis de Segorbe-Castellón
Roman Catholic Diocese of Segorbe-Castellón	local	Bisbat de Sogorb-Castelló
Roman Catholic Archdiocese of Valencia in Spain	local	Arxidiòcesi de València
Roman Catholic Archdiocese of Valencia in Spain	local	Arquidiocesis de Valencia
Roman Catholic Diocese of Langres	local	Diocèse de Langres
Roman Catholic Archdiocese of Tarragona	local	Arxidiòcesi de Tarragona
Roman Catholic Archdiocese of Tarragona	local	Archidiócesis de Tarragona
Roman Catholic Diocese of Sapë	local	Dioqeza e Sapës
Roman Catholic Diocese of Grenoble-Vienne	local	Diocèse de Grenoble-Vienne
Roman Catholic Archdiocese of Zagreb	local	Zagrebačka nadbiskupija
Roman Catholic Diocese of Autun	local	Diocèse d'Autun - Chalon-sur-Saône - Mâcon - Cluny
Roman Catholic Diocese of Orléans	local	Diocèse d'Orléans
Roman Catholic Diocese of Ajaccio	local	Diocèse d'Ajaccio
Roman Catholic Archdiocese of Gatineau	local	Archidiocèse de Gatineau
Roman Catholic Archdiocese of Moncton	local	Archidiocèse de Moncton
Roman Catholic Diocese of Jaffna	local	யாழ்ப்பாண மறை மாவட்டம்
Roman Catholic Diocese of Amos	local	Diocèse d'Amos
Roman Catholic Diocese of Huelva	local	Diócesis de Huelva
Apostolic Vicariate of Southern Arabia	local	النيابة الرسولية من جنوب الجزيرة العربية
Apostolic Vicariate of Northern Arabia	local	النيابة الرسولية العربية الشمالية
Roman Catholic Archdiocese of Fort-de-France–Saint-Pierre	local	Archidiocèse de Fort-de-France e Saint-Pierre
Roman Catholic Diocese of Parañaque	local	Diyosesis ng Parañaque
List of Major Archbishops of Kiev–Galicia	local	Kyiv–Halych
Eparchy of Bačka	local	Бачка епархија
Eparchy of Bačka	local	Bačka eparhija
Eparchy of Srem	local	Епархија сремска
Eparchy of Banat	local	Банатска епархија
Eparchy of Banat	local	Banatska eparhija
Metropolitanate of Karlovci	local	Карловачка митрополија
Metropolitanate of Karlovci	local	Karlovačka mitropolija
Metropolitanate of Belgrade	local	Београдска митрополија
Metropolitanate of Belgrade	local	Beogradska mitropolija
Patriarchate of Karlovci	local	Карловачка патријаршија
Patriarchate of Karlovci	local	Karlovačka patrijaršija
Roman Catholic Diocese of Gozo	local	Djoċesi ta' Għawdex
Apostolic Vicariate of Northern Germany	local	Apostolisches Vikariat der Nordischen Missionen Deutschlands
Apostolic Vicariate of Northern Germany	local	Apostolisches Vikariat der Nordischen Missionen / Det apostoliske vikariat i nord
Roman Catholic Diocese of Agen	local	Diocèse d'Agen
Roman Catholic Archdiocese of Vilnius	local	Vilniaus Arkivyskupija
Roman Catholic Archdiocese of Bologna	local	Arcidiocesi di Bologna
Roman Catholic Archdiocese of Hamburg	local	Erzbistum Hamburg
Roman Catholic Diocese of Lausanne, Geneva and Fribourg	local	Diocèse de Lausanne, Genève et Fribourg
Roman Catholic Archdiocese of Bahía Blanca	local	Arquidiócesis de Bahía Blanca
Roman Catholic Archdiocese of Buenos Aires	local	Arquidiócesis de Buenos Aires
Diocese of Ribe	local	Ribe Stift
Roman Catholic Diocese of Viedma	local	Diócesis de Viedma
Roman Catholic Archdiocese of Sens	local	Archidiocèse de Sens-Auxerre
Roman Catholic Diocese of Belley-Ars	local	Diocèse de Belley-Ars
Roman Catholic Archdiocese of Berlin	local	Erzbistum Berlin
Roman Catholic Diocese of Dresden-Meissen	local	Bistum Dresden-Meißen
Roman Catholic Diocese of Regensburg	local	Bistum Regensburg
Roman Catholic Archdiocese of Prague	local	Arcibiskupství pražské
Roman Catholic bishopric of Odense	local	Odense Stift
Roman Catholic Archdiocese of Lipa	local	Arsidiyosesis ng Lipa
Roman Catholic Diocese of Matamoros	local	Diócesis de Matamoros
Roman Catholic Diocese of Angoulême	local	Diocèse d'Angoulême
Roman Catholic Diocese of Périgueux	local	Diocèse de Périgueux-Sarlat
Roman Catholic Diocese of Guntur	local	గుంటూరు డియోసెస్
Roman Catholic Diocese of Vác	local	Váci Egyházmegye
Roman Catholic Diocese of Indore	local	इंदौर के सूबा
Syro-Malabar Catholic Eparchy of Kothamangalam	local	കോതമംഗലം രൂപത
Roman Catholic Diocese of Saint-Flour	local	Diocèse de Saint-Flour
Roman Catholic Diocese of Oradea Mare	local	Dieceza Romano-Catolică de Oradea
Roman Catholic Archdiocese of Zadar	local	Zadarska nadbiskupija
Syro-Malabar Catholic Eparchy of Belthangady	local	ಬೆಳ್ತಂಗಡಿ ಡಯಾಸಿಸ್
Romanian Catholic Eparchy of Cluj-Gherla	local	Eparhia de Cluj-Gherla
Roman Catholic Diocese of Coimbatore	local	கோயம்புத்தூர் மாவட்ட
Roman Catholic Diocese of Calbayog	local	Diyosesis han Calbayog
Roman Catholic Archdiocese of Burgos	local	Archidiócesis de Burgos
Te Hui Amorangi ki Te Tairawhiti	local	Te Hui Amorangi ki Te Tai Rāwhiti
Roman Catholic Archdiocese of Montpellier	local	Archidiocèse de Montpellier - Lodève - Béziers - Agde - Saint-Pons-de-Thomières
Roman Catholic Diocese of Cork and Ross	local	Deoise Chorcaí agus Rosa
Roman Catholic Archdiocese of Madrid	local	Archidiócesis de Madrid
Syro-Malabar Catholic Eparchy of Rajkot	local	राजकोट के सूबा (Hindi)
Syro-Malabar Catholic Eparchy of Rajkot	local	રાજકોટ ડાયોસિઝ (Gujarati)
Syro-Malabar Catholic Eparchy of Sagar	local	सागर धर्मप्रांत
Syro-Malabar Catholic Eparchy of Adilabad	local	आदिलाबाद के सूबा
Syro-Malabar Catholic Eparchy of Bijnor	local	बिजनौर के सूबा
Syro-Malabar Catholic Eparchy of Chanda	local	चांदा च्या बिशपच्या अधिकारातील प्रदेश
Syro-Malabar Catholic Eparchy of Gorakhpur	local	गोरखपुर के सूबा
Syro-Malabar Catholic Eparchy of Kalyan	local	कल्याण के सूबा
Roman Catholic Archdiocese of Seville	local	Archidiócesis de Sevilla
Syro-Malabar Catholic Eparchy of Jagdalpur	local	जगदलपुर के सूबा
Syro-Malabar Catholic Eparchy of Satna	local	सतना के सूबा
Syro-Malabar Catholic Eparchy of Ujjain	local	उज्जैन के सूबा
Syro-Malabar Catholic Eparchy of Thuckalay	local	தக்கலை மறைமாவட்டத்தின்
Roman Catholic Archdiocese of Naples	local	Arcidiocesi di Napoli
Roman Catholic Archdiocese of Luxembourg	local	Erzdiözees Lëtzebuerg
Roman Catholic Archdiocese of Luxembourg	local	Archidiocèse de Luxembourg
Roman Catholic Archdiocese of Luxembourg	local	Erzdiözese Luxemburg
Roman Catholic Archdiocese of Turin	local	Arcidiocesi di Torino
Roman Catholic Diocese of Coimbra	local	Diocese de Coimbra
Roman Catholic Diocese of Cahors	local	Diocèse de Cahors
Roman Catholic Diocese of Amiens	local	Diocèse d'Amiens
Roman Catholic Diocese of Valence	local	Diocèse de Valence - Die - Saint-Paul-Trois-Châteaux
Roman Catholic Diocese of Vannes	local	Diocèse de Vannes
Roman Catholic Archdiocese of Warsaw	local	Archidiecezja Warszawska
Roman Catholic Diocese of Lutsk	local	Єпархія Луцьку
Roman Catholic Archdiocese of Shkodër-Pult	local	Kryedioqeza e Shkodrës-Pult
Roman Catholic Diocese of Bragança-Miranda	local	Diocese de Bragança-Miranda
Roman Catholic Archdiocese of Cagliari	local	Arcidiocesi di Cagliari
Roman Catholic Archdiocese of Mexico	local	Arquidiócesis de México
Roman Catholic Diocese of Tagbilaran	local	Diyosesis sa Tagbilaran
Roman Catholic Diocese of Talibon	local	Diyosesis sa Talibon
Roman Catholic Diocese of Graz-Seckau	local	Diözese Graz-Seckau
Ancient Diocese of Ribe	local	Ribe Stift
Roman Catholic Diocese of Porto, Portugal	local	Diocese do Porto
Roman Catholic Archdiocese of Bombay	local	मुंबई के सूबा
Roman Catholic Archdiocese of Karachi	local	کراچی کے میٹروپولیٹن
Roman Catholic Diocese of Meath	local	Deoise na Mí
Roman Catholic Diocese of Ferns	local	Deoise Fearna
Roman Catholic Diocese of Raphoe	local	Deoise Ráth Bhoth
Roman Catholic Diocese of Kildare and Leighlin	local	Deoise Chill Dara agus Leithghlinne
Roman Catholic Diocese of Ossory	local	Deoise Osraí
Roman Catholic Archdiocese of Cashel and Emly	local	Ard-Deoise Chaisil agus Imligh
Diocese of Connor	local	Deoise Chonaire
Roman Catholic Diocese of Ardagh and Clonmacnoise	local	Deoise Ardach agus Chluain Mhic Nóis
Roman Catholic Diocese of Limerick	local	Deoise Luimnigh
Roman Catholic Diocese of Waterford and Lismore	local	Deoise Phort Láirge agus Lios Mór
Roman Catholic Archdiocese of Dublin	local	Ard-Deoise Bhaile Átha Cliath
Roman Catholic Archdiocese of Tuam	local	Ard-Deoise Thuama
Roman Catholic Territorial Prelature of Trondheim	local	Trondheim Stift – Midt-Norge
Military Ordinariate of the Philippines	local	Ordinaryato Militar ng Pilipinas
Roman Catholic Diocese of Linz	local	Diözese Linz
Roman Catholic Archdiocese of Canberra and Goulburn	local	Archdiocese of Canberra and Goulburn
Roman Catholic Archdiocese of Wellington	local	Poneke
Roman Catholic Diocese of Groningen-Leeuwarden	local	Bisdom Groningen-Leeuwarden
Roman Catholic Archdiocese of Jakarta	local	Keuskupan Agung Jakarta
Roman Catholic Archdiocese of Nouméa	local	Archidiocèse de Nouméa
Roman Catholic Diocese of Port-Vila	local	Diocèse de Port-Vila
Roman Catholic Diocese of Wallis et Futuna	local	Diocèse de Wallis et Futuna
Roman Catholic Archdiocese of Papeete	local	Archidiocèse de Papeete
Roman Catholic Diocese of Taiohae o Tefenuaenata	local	Diocèse de Taiohae o Tefenuaenata
Roman Catholic Diocese of Chartres	local	Diocèse de Chartres
Roman Catholic Diocese of Évreux	local	Diocèse d'Evreux
Roman Catholic Archdiocese of Chihuahua	local	Arquidiócesis de Chihuahua
Roman Catholic Archdiocese of Barcelona	local	Archidiócesis de Barcelona
Roman Catholic Archdiocese of Barcelona	local	Arxidiòcesi de Barcelona
Roman Catholic Diocese of Namur	local	Diocèse de Namur
Roman Catholic Diocese of Namur	local	Bistum Namur
Roman Catholic Diocese of Namur	local	Bisdom Namen
Roman Catholic Diocese of Nancy	local	Diocèse de Nancy
Roman Catholic Diocese of Rodez	local	Diocèse de Rodez-Vabres
Roman Catholic Diocese of Tarbes-et-Lourdes	local	Diocèse de Tarbes et Lourdes
Roman Catholic Diocese of Tepic	local	Diócesis de Tepic
Roman Catholic Diocese of Tarnów	local	Diecezja Tarnowska
Roman Catholic Diocese of Tortosa	local	Diócesis de Tortosa (Spanish)
Roman Catholic Diocese of Tortosa	local	Diòcesi de Tortosa (Catalan)
Ukrainian Catholic Eparchy of Saint Vladimir the Great of Paris	local	Diocèse de Saint-Vladimir-le-Grand de Paris
Roman Catholic Diocese of Aachen	local	Bistum Aachen
Roman Catholic Archdiocese of Puerto Montt	local	Arquidiócesis de Puerto Montt
Roman Catholic Archdiocese of León	local	Arquidiócesis de León
Roman Catholic Diocese of San Carlos de Ancud	local	Diócesis de San Carlos de Ancud
Roman Catholic Archdiocese of Durango	local	Arquidiócesis de Durango
Roman Catholic Archdiocese of Xalapa	local	Arquidiócesis de Xalapa
Apostolic Vicariate of Aysén	local	Vicariato Apostólico de Aysén
Roman Catholic Diocese of Punta Arenas	local	Diócesis de Punta Arenas
Roman Catholic Diocese of Talca	local	Diócesis de Talca
Roman Catholic Archdiocese of San Luis Potosí	local	Arquidiócesis de San Luis Potosí
Roman Catholic Archdiocese of Tijuana	local	Arquidiócesis de Tijuana
Roman Catholic Archdiocese of Tlalnepantla	local	Arquidiócesis de Tlalnepantla
Roman Catholic Archdiocese of Tuxtla	local	Arquidiócesis de Tuxtla
Roman Catholic Diocese of Chilpancingo-Chilapa	local	Diócesis de Chilpancingo-Chilapa
Roman Catholic Diocese of Ciudad Altamirano	local	Diócesis de Ciudad Altamirano
Roman Catholic Diocese of Tlapa	local	Diócesis de Tlapa
Roman Catholic Diocese of Rancagua	local	Diócesis de Rancagua
Roman Catholic Diocese of Ciudad Juárez	local	Diócesis de Ciudad Juárez
Roman Catholic Diocese of Cuauhtémoc-Madera	local	Diócesis de Cuauhtémoc-Madera
Roman Catholic Diocese of Nuevo Casas Grandes	local	Diócesis de Nuevo Casas Grandes
Roman Catholic Diocese of Parral	local	Diócesis de Parral
Roman Catholic Diocese of Culiacán	local	Diócesis de Culiacán
Roman Catholic Diocese of Ciudad Obregón	local	Diócesis de Ciudad Obregón
Roman Catholic Diocese of Colima	local	Diócesis de Colima
Roman Catholic Diocese of San Juan de los Lagos	local	Diócesis de San Juan de los Lagos
Roman Catholic Diocese of Ciudad Guzmán	local	Diócesis de Ciudad Guzmán
Roman Catholic Diocese of Aguascalientes	local	Diócesis de Aguascalientes
Roman Catholic Diocese of Autlán	local	Diócesis de Autlán
Roman Catholic Diocese of Mazatlán	local	Diócesis de Mazatlán
Roman Catholic Diocese of Torreón	local	Diócesis de Torreón
Roman Catholic Diocese of Tarahumara	local	Diócesis de Tarahumara
Roman Catholic Diocese of Coatzacoalcos	local	Diócesis de Coatzacoalcos
Roman Catholic Diocese of Orizaba	local	Diócesis de Orizaba
Roman Catholic Diocese of Córdoba	local	Diócesis de Córdoba
Roman Catholic Diocese of Tuxpan	local	Diócesis de Tuxpan
Roman Catholic Diocese of Papantla	local	Diócesis de Papantla
Roman Catholic Diocese of San Andrés Tuxtla	local	Diócesis de San Andrés Tuxtla
Roman Catholic Diocese of Veracruz	local	Diócesis de Veracruz
Roman Catholic Diocese of Celaya	local	Diócesis de Celaya
Roman Catholic Diocese of Irapuato	local	Diócesis de Irapuato
Roman Catholic Diocese of Atlacomulco	local	Diócesis de Atlacomulco
Roman Catholic Diocese of Saltillo	local	Diócesis de Saltillo
Roman Catholic Diocese of Nuevo Laredo	local	Diócesis de Nuevo Laredo
Roman Catholic Diocese of Piedras Negras	local	Diócesis de Piedras Negras
Roman Catholic Diocese of Ciudad Victoria	local	Diócesis de Ciudad Victoria
Roman Catholic Diocese of Linares	local	Diócesis de Linares
Roman Catholic Diocese of Toluca	local	Diócesis de Toluca
Roman Catholic Diocese of Cuernavaca	local	Diócesis de Cuernavaca
Roman Catholic Diocese of Apatzingan	local	Diócesis de Apatzingan
Roman Catholic Diocese of Tampico	local	Diócesis de Tampico
Roman Catholic Diocese of Tehuacán	local	Diócesis de Tehuacán
Roman Catholic Diocese of Huajuapan de León	local	Diócesis de Huajuapan de León
Roman Catholic Diocese of Tacámbaro	local	Diócesis de Tacámbaro
Roman Catholic Diocese of Zamora in Mexico	local	Diócesis de Zamora in México
Roman Catholic Diocese of Tlaxcala	local	Diócesis de Tlaxcala
Roman Catholic Diocese of Ciudad Valles	local	Diócesis de Ciudad Valles
Roman Catholic Diocese of Matehuala	local	Diócesis de Matehuala
Roman Catholic Diocese of Zacatecas	local	Diócesis de Zacatecas
Roman Catholic Diocese of Cuautitlán	local	Diócesis de Cuautitlán
Roman Catholic Diocese of Ensenada	local	Diócesis de Ensenada
Roman Catholic Diocese of La Paz en la Baja California Sur	local	Diócesis de La Paz en la Baja California Sur
Roman Catholic Diocese of Mexicali	local	Diócesis de Mexicali
Roman Catholic Diocese of Ecatepec	local	Diócesis de Ecatepec
Roman Catholic Diocese of Netzahualcóyotl	local	Diócesis de Netzahualcóyotl
Roman Catholic Diocese of Texcoco	local	Diócesis de Texcoco
Roman Catholic Diocese of Valle de Chalco	local	Diócesis de Valle de Chalco
Roman Catholic Diocese of Tula	local	Diócesis de Tula
Roman Catholic Diocese of Huejutla	local	Diócesis de Huejutla
Roman Catholic Diocese of Campeche	local	Diócesis de Campeche
Roman Catholic Diocese of Tabasco	local	Diócesis de Tabasco
Roman Catholic Diocese of San Cristóbal de Las Casas	local	Diócesis de San Cristóbal de Las Casas
Roman Catholic Diocese of Ciudad Lázaro Cárdenas	local	Diócesis de Ciudad Lázaro Cárdenas
Roman Catholic Diocese of Tapachula	local	Diócesis de Tapachula
Roman Catholic Archdiocese of Morelia	local	Arquidiócesis de Morelia
Territorial Prelature of Cancún-Chetumal	local	Prélature Territoriale de Cancún-Chetumal
Roman Catholic Territorial Prelature of El Salto	local	Prelatura Territorial de El Salto
Territorial Prelature of Jesús María del Nayar	local	Prélature Territoriale  de Jesús María del Nayar
Roman Catholic Archdiocese of Santo Domingo	local	Arquidiócesis de Santo Domingo
Diocese of Dublin and Glendalough	local	Deoisí Aontaithe Bhaile Átha Cliath agus Ghleann Dá Loch
Roman Catholic Diocese of Basse-Terre	local	Diocèse de Basse-Terre et Pointe-à-Pitre
Roman Catholic Diocese of Cayenne	local	Diocèse de Cayenne
Roman Catholic Archdiocese of Lahore	local	لاہور کے میٹروپولیٹن
Roman Catholic Diocese of Paramaribo	local	Bisdom Paramaribo
Roman Catholic Archdiocese of Port-au-Prince	local	Acheveche nan Pòtoprens
Roman Catholic Diocese of Willemstad	local	Bisdom Willemstad
Roman Catholic Archdiocese of Tulancingo	local	Arquidiócesis de Tulancingo
Roman Catholic Diocese of Lamego	local	Diocese de Lamego
Roman Catholic Diocese of Les Cayes	local	Dyosèz nan Les Cayes
Roman Catholic Diocese of Comayagua	local	Diócesis de Comayagua
Roman Catholic Diocese of Granada	local	Diócesis de Granada
Roman Catholic Diocese of Cádiz y Ceuta	local	Diócesis de Cádiz y Ceuta
Roman Catholic Diocese of Saint-Hyacinthe	local	Diocése de Saint-Hyacinthe
Roman Catholic Diocese of Bathurst in Canada	local	Diocèse de Bathurst
Roman Catholic Archdiocese of Paraná	local	Arquidiócesis de Paraná
Roman Catholic Diocese of Concordia in Argentina	local	Diócesis de Concordia
Roman Catholic Archdiocese of Córdoba	local	Arquidiócesis de Córdoba
Roman Catholic Diocese of San Francisco	local	Diócesis de San Francisco
Roman Catholic Diocese of Alto Valle del Río Negro	local	Diócesis de Alto Valle del Río Negro
Roman Catholic Diocese of Añatuya	local	Diócesis de Añatuya
Roman Catholic Archdiocese of Corrientes	local	Arquidiócesis de Corrientes
Roman Catholic Archdiocese of La Plata in Argentina	local	Arquidiócesis de La Plata
Roman Catholic Archdiocese of Mendoza	local	Arquidiócesis de Mendoza
Roman Catholic Archdiocese of Resistencia	local	Arquidiócesis de Resistencia
Roman Catholic Diocese of Formosa, Argentina	local	Diócesis de Formosa
Roman Catholic Archdiocese of Salta	local	Arquidiócesis de Salta
Roman Catholic Archdiocese of San Juan de Cuyo	local	Arquidiócesis de San Juan de Cuyo
Roman Catholic Archdiocese of Santa Fe de la Vera Cruz	local	Arquidiócesis de Santa Fe de la Vera Cruz
Roman Catholic Archdiocese of Tucumán	local	Arquidiócesis de Tucumán
Roman Catholic Diocese of Avellaneda-Lanús	local	Diócesis de Avellaneda-Lanús
Roman Catholic Diocese of Azul	local	Diócesis de Azul
Roman Catholic Territorial Prelature of Cafayate	local	Prelatura Territorial de Cafayate
Roman Catholic Diocese of Chascomús	local	Diócesis de Chascomús
Roman Catholic Diocese of Concepción	local	Diócesis de Concepción
Roman Catholic Diocese of Catamarca	local	Diócesis de Catamarca
Roman Catholic Diocese of Gregorio de Laferrere	local	Diócesis de Gregorio de Laferrere
Roman Catholic Diocese of Cruz del Eje	local	Diócesis de Cruz del Eje
Roman Catholic Diocese of Goya	local	Diócesis de Goya
Roman Catholic Territorial Prelature of Deán Funes	local	Prelatura territorial de Deán Funes
Roman Catholic Diocese of Gualeguaychú	local	Diócesis de Gualeguaychú
Roman Catholic Territorial Prelature of Humahuaca	local	Prelatura Territorial de Humahuaca
Roman Catholic Diocese of Jujuy	local	Diócesis de Jujuy
Roman Catholic Diocese of La Rioja	local	Diócesis de La Rioja
Roman Catholic Diocese of Lomas de Zamora	local	Diócesis de Lomas de Zamora
Roman Catholic Diocese of Soissons	local	Diocèse de Soissons, Laon et Saint-Quentin
Roman Catholic Diocese of Le Puy-en-Velay	local	Diocèse de Le Puy-en-Velay
Roman Catholic Diocese of Châlons	local	Diocèse de Châlons
Roman Catholic Diocese of Killaloe	local	Deoise Chill Dalua
Roman Catholic Archdiocese of Marseille	local	Archidiocèse de Marseille
Roman Catholic Archdiocese of Mercedes-Luján	local	Arquidiócesis de Mercedes-Luján
Roman Catholic Diocese of Mar del Plata	local	Diócesis de Mar del Plata
Roman Catholic Diocese of Argyll and the Isles	local	Gaelic: Sgìr-Easbuig Earraghàidheal 's nan Eilean
Roman Catholic Diocese of Sivagangai	local	சிவகங்கை மறைமாவட்ட
Roman Catholic Diocese of Merlo-Moreno	local	Diócesis de Merlo-Moreno
Roman Catholic Diocese of Morón	local	Diócesis de Morón
Roman Catholic Diocese of Krk	local	Krčka biskupija
Roman Catholic Diocese of Viviers	local	Diocèse de Viviers
Roman Catholic Diocese of Clogher	local	Deoise Chlochair
Roman Catholic Archdiocese of Caracas	local	Arquidiocesis de Caracas
Roman Catholic Archdiocese of Santiago de Chile	local	Arquidiócesis de Santiago de Chile
Roman Catholic Diocese of Padua	local	Diocesi di Padova
Roman Catholic Archdiocese of Rabat	local	Archidiocèse de Rabat
Roman Catholic Archdiocese of Tanger	local	Archidiocèse de Tanger
Roman Catholic Archdiocese of Nanking	local	天主教南京总教区
Roman Catholic Archdiocese of Bangalore	local	बंगलौर के सूबा
Roman Catholic Archdiocese of Colombo	local	கொழும்பு உயர்மறை
Diocese of Copenhagen	local	Københavns Stift
Roman Catholic Archdiocese of Granada	local	Archidiócesis de Granada
Roman Catholic Archdiocese of Izmir	local	İzmir Başpiskoposluğu
Roman Catholic Archdiocese of Monaco	local	Archidiocèse de Monaco
Roman Catholic Archdiocese of Santa Cruz de la Sierra	local	Arquidiócesis de Santa Cruz de la Sierra
Diocese of Vyatka and Slobodskoy	local	Вятская и Слободская епархия
Roman Catholic Archdiocese of Huế	local	Tổng Giáo Phận Huê
Roman Catholic Archdiocese of Hanoi	local	Tổng Giáo Phận Hà Nội
Roman Catholic Diocese of Bắc Ninh	local	Giáo phận Bắc Ninh
Roman Catholic Diocese of Bùi Chu	local	Giáo phận Bùi Chu
Roman Catholic Diocese of Cần Thơ	local	Giáo phận Cần Thơ
Roman Catholic Diocese of Hải Phòng	local	Giáo Phận Hải Phòng
Roman Catholic Diocese of Đà Nẵng	local	Giáo phận Đà Nẵng
Roman Catholic Diocese of Hưng Hóa	local	Giáo Phận Hung Hoá
Roman Catholic Diocese of Lạng Sơn and Cao Bằng	local	Giáo phận Lạng Sơn Cao Bằng
Roman Catholic Diocese of Long Xuyên	local	Giáo phận Long Xuyên
Roman Catholic Diocese of Mỹ Tho	local	Giáo phận Mỹ Tho
Roman Catholic Diocese of Nha Trang	local	Giáo Phận Nha Trang
Roman Catholic Diocese of Phan Thiết	local	Giáo phận Phan Thiết
Roman Catholic Diocese of Phát Diệm	local	Giáo phận Phát Diệm
Roman Catholic Diocese of Phú Cường	local	Giáo phận Phú Cường
Roman Catholic Diocese of Qui Nhơn	local	Giáo phận Quy Nhơn
Roman Catholic Diocese of Thái Bình	local	Giáo phận Thái Bình
Roman Catholic Diocese of Vinh	local	Giáo phận Vinh
Roman Catholic Diocese of Vĩnh Long	local	Giáo phận Vĩnh Long
Roman Catholic Diocese of Saint-Denis-de-La Réunion	local	Diocèse de Saint-Denis-de-La Réunion
Roman Catholic Diocese of Luçon	local	Diocèse de Luçon
Diocese of Viborg	local	Viborg Stift
Roman Catholic Archdiocese of Kaunas	local	Kauno Arkivyskupija
Roman Catholic Archdiocese of Taipei	local	天主教台北總教區
Roman Catholic Archdiocese of Kuala Lumpur	local	Keuskupan Agung Kuala Lumpur
Roman Catholic Archdiocese of Kuching	local	Keuskupan Agung Kuching
Roman Catholic Archdiocese of Dhaka	local	ঢাকার বিশপের এলাকা
Roman Catholic Diocese of Shanghai	local	天主教上海教区
Roman Catholic Archdiocese of Zamboanga	local	Arquidiocesis de Zamboanga
Roman Catholic Archdiocese of Zamboanga	local	Arkidiyosesis ng Zamboanga
Roman Catholic Diocese of Funchal	local	Diocese do Funchal
Roman Catholic Archdiocese of Saurímo	local	Arquidiocese de Saurimo
Roman Catholic Diocese of Breda	local	Bisdom Breda
Roman Catholic Diocese of Sandakan	local	Keuskupan Sandakan
Roman Catholic Diocese of Rotterdam	local	Bisdom Rotterdam
Roman Catholic Archdiocese of Nueva Segovia	local	Arkidiocesis ti Nueva Segovia
Roman Catholic Diocese of Le Mans	local	Diocèse du Mans
Roman Catholic Diocese of Osorno	local	Diócesis de Osorno
Roman Catholic Diocese of Rafaela	local	Diócesis de Rafaela
Roman Catholic Diocese of Reconquista	local	Diócesis de Reconquista
Roman Catholic Diocese of San Luis	local	Diócesis de San Luis
Roman Catholic Diocese of Santiago del Estero	local	Diócesis de Santiago del Estero
Roman Catholic Diocese of Venado Tuerto	local	Diócesis de Venado Tuerto
Roman Catholic Diocese of San Nicolás de los Arroyos	local	Diócesis de San Nicolás de los Arroyos
Roman Catholic Diocese of San Roque de Presidencia Roque Sáenz Peña	local	Diócesis de San Roque de Presidencia Roque Sáenz Peña
Roman Catholic Diocese of San Rafael	local	Diócesis de San Rafael
Roman Catholic Diocese of Quilmes	local	Diócesis de Quilmes
Roman Catholic Diocese of Zárate-Campana	local	Diócesis de Zárate-Campana
Roman Catholic Diocese of Neuquén	local	Diócesis de Neuquén
Roman Catholic Diocese of Nueve de Julio	local	Diócesis de Nueve de Julio
Roman Catholic Diocese of Santo Tomé	local	Diócesis de Santo Tomé
Roman Catholic Diocese of Posadas	local	Diócesis de Posadas
Roman Catholic Diocese of Puerto Iguazú	local	Diócesis de Posadas
Roman Catholic Diocese of Villa de la Concepción del Río Cuarto	local	Diócesis de Villa de la Concepción del Río Cuarto
Roman Catholic Diocese of Villa María	local	Diócesis de Villa María
Roman Catholic Diocese of Santa Rosa in Argentina	local	Diócesis de Santa Rosa
Roman Catholic Diocese of San Carlos de Bariloche	local	Diócesis de San Carlos de Bariloche
Roman Catholic Diocese of Río Gallegos	local	Diócesis de Río Gallegos
Roman Catholic Diocese of Comodoro Rivadavia	local	Diócesis de Comodoro Rivadavia
Roman Catholic Diocese of San Isidro	local	Diócesis de San Isidro
Roman Catholic Diocese of San Justo	local	Diócesis de San Justo
Roman Catholic Diocese of San Martín	local	Diócesis de San Martín
Roman Catholic Diocese of San Miguel	local	Diócesis de San Miguel
Apostolic Vicariate of Vientiane	local	ອັກຄະສາວົກແທນຂອງນະຄອນຫຼວງວຽງ
Roman Catholic Archdiocese of Lviv	local	Митрополія Львова
Roman Catholic Diocese of Essen	local	Bistum Essen
Roman Catholic Archdiocese of Poitiers	local	Archidiocèse de Poitiers
Roman Catholic Diocese of Münster	local	Bistum Münster
Roman Catholic Diocese of Balanga	local	Diyosesis ng Balanga
Roman Catholic Diocese of Derry	local	Deoise Dhoire
Roman Catholic Diocese of Kerry	local	Deoise Chiarraí
Roman Catholic Diocese of Laval	local	Diocèse de Laval
Roman Catholic Diocese of Dromore	local	Deoise an Droma Mhóir
Roman Catholic Diocese of Kilmore	local	Deoise na Cille Móire
Roman Catholic Diocese of Mende	local	Diocèse de Mende
Roman Catholic Diocese of Moulins	local	Diocèse de Moulins
Roman Catholic Diocese of Jerez de la Frontera	local	Diócesis de Jerez de la Frontera
Roman Catholic Archdiocese of Ljubljana	local	Nadškofija Ljubljana
Roman Catholic Diocese of Saint-Étienne	local	Diocèse de Saint-Etienne
Roman Catholic Archdiocese of Albi	local	Archidiocèse d'Albi-Castres-Lavaur
Roman Catholic Diocese of Garissa	local	Jimbo la Garissa
Roman Catholic Diocese of Malindi	local	Dayosisi ya Malindi
Roman Catholic Diocese of Šiauliai	local	Šiaulių vyskupija
Roman Catholic Archdiocese of Auch	local	Archidiocèse d'Auch-Condom-Lectoure-Lombez
Roman Catholic Diocese of Lugano	local	Diocesi di Lugano
Roman Catholic Diocese of Blois	local	Diocèse de Blois
Roman Catholic Archdiocese of Mérida-Badajoz	local	Archidiócesis de Mérida-Badajoz
Roman Catholic Archdiocese of Dijon	local	Archidiocèse de Dijon
Roman Catholic Diocese of Saint-Claude	local	Diocèse de Saint-Claude
Roman Catholic Diocese of Nîmes	local	Diocèse de Nîmes-Uzès et de l'Est
Roman Catholic Archdiocese of Rennes	local	Archidiocèse de Rennes, Dol et Saint-Malo
Roman Catholic Diocese of Saint-Brieuc	local	Diocèse de Saint-Brieuc et Tréguier
Roman Catholic Diocese of Annecy	local	Diocèse d'Annecy
Roman Catholic Diocese of Aire and Dax	local	Diocèse d'Aire et Dax
Roman Catholic Diocese of Carcassonne-Narbonne	local	Diocèse de Carcassonne et Narbonne
Roman Catholic Diocese of Nevers	local	Diocèse de Nevers
Roman Catholic Archdiocese of Avignon	local	Archidiocèse d'Avignon
Roman Catholic Archdiocese of Toulouse	local	Archidiocèse de Toulouse-Saint-Bertrand de Comminges-Rieux
Roman Catholic Archdiocese of Lille	local	Archidiocèse de Lille
Roman Catholic Diocese of Bayonne	local	Diocèse de Bayonne-Lescar e Oloron
Roman Catholic Diocese of Angers	local	Diocèse d'Angers
Roman Catholic Archdiocese of Clermont	local	Archidiocèse de Clermont
Roman Catholic Archdiocese of Chambéry–Saint-Jean-de-Maurienne–Tarentaise	local	Archidiocèse de Chambéry - Saint-Jean-de-Maurienne - Tarentaise
Roman Catholic Diocese of Nantes	local	Diocèse de Nantes
Roman Catholic Diocese of Perpignan-Elne	local	Diocèse de Perpignan-Elne
Roman Catholic Diocese of La Rochelle and Saintes	local	Diocèse de La Rochelle et Saintes
Roman Catholic Diocese of Pamiers	local	Diocèse de Pamiers-Mirepoix-Couserans
Roman Catholic Diocese of Le Havre	local	Diocèse du Havre
Romanian Catholic Eparchy of Lugoj	local	Eparhia de Lugoj
Roman Catholic Diocese of Montauban	local	Diocèse de Montauban
Roman Catholic Diocese of Tournai	local	Diocèse de Tournai
Roman Catholic Diocese of Tournai	local	Bistum Tournai
Roman Catholic Diocese of Tournai	local	Bisdom Doornik
Bishopric of Cammin	local	Bistum Cammin( )
Syro-Malabar Catholic Eparchy of Bhadravathi	local	ಭದ್ರಾವತಿಯಲ್ಲಿನ ಡಯಾಸಿಸ್ನ
Roman Catholic Archdiocese of Bratislava	local	Arcibiskupstvo Bratislava
Roman Catholic Archdiocese of Košice	local	Košická arcidiecéza
Roman Catholic Diocese of Nitra	local	Biskupstvo Nitra
Roman Catholic Diocese of 's-Hertogenbosch	local	Bisdom den Bosch
Roman Catholic Diocese of Bruges	local	Diocèse de Bruges
Roman Catholic Diocese of Bruges	local	Bistum Brügge
Roman Catholic Diocese of Bruges	local	Bisdom Brugge
Roman Catholic Diocese of Hasselt	local	Diocèse de Hasselt
Roman Catholic Diocese of Hasselt	local	Bistum Hasselt
Roman Catholic Diocese of Hasselt	local	Bisdom Hasselt
Roman Catholic Diocese of Spiš	local	Spišská Diecéza
Roman Catholic Diocese of Rožňava	local	Dieceze Roznavska
Roman Catholic Archdiocese of Lucca	local	Arcidiocesi di Lucca
Roman Catholic Diocese of Penang	local	Keuskupan Pulau Pinang
Roman Catholic Diocese of Penang	local	天主教檳城教區
Roman Catholic Archdiocese of Naxos, Tinos, Andros and Mykonos	local	Αρχιεπισκοπή Νάξου, Τήνου, Άνδρου και Μυκόνου
Roman Catholic Archdiocese of Cebu	local	Artsidiyosesis sa Sugbo
Roman Catholic Diocese of Eluru	local	ఏలూరు డియోసెస్
Roman Catholic Diocese of San Pablo	local	Diyosesis ng San Pablo
Roman Catholic Archdiocese of Olomouc	local	Arcidiecézní Olomouce
Roman Catholic Diocese of Versailles	local	Diocèse de Versailles
Roman Catholic Archdiocese of Salzburg	local	Erzdiözese Salzburg
Roman Catholic Archdiocese of Cologne	local	Erzbistum Köln
Roman Catholic Archdiocese of San Fernando	local	Arkidiyosesis ning San Fernando
Roman Catholic Archdiocese of Lingayen-Dagupan	local	Arkidiosis na Lingayen-Dagupan
Roman Catholic Archdiocese of Lingayen-Dagupan	local	Arkidiocesis ti Lingayen-Dagupan
Anglican Diocese of Western Kowloon	local	西九龍教區
Roman Catholic Diocese of Trier	local	Bistum Trier
Roman Catholic Diocese of Győr	local	Győri Egyházmegye
Roman Catholic Diocese of Pécs	local	Pécsi Egyházmegye
Roman Catholic Archdiocese of Veszprém	local	Veszprémi Főegyházmegye
Roman Catholic Archdiocese of Kalocsa-Kecskemét	local	Kalocsa-Kecskeméti főegyházmegye
Roman Catholic Diocese of Fulda	local	Bistum Fulda
Roman Catholic Archdiocese of Valladolid	local	Archidiócesis de Valladolid
Roman Catholic Diocese of San Marino-Montefeltro	local	Diocesi di San Marino-Montefeltro
Roman Catholic Diocese of Melfi-Rapolla-Venosa	local	Diocesi di Melfi-Rapolla-Venosa
Roman Catholic Archdiocese of Strasbourg	local	Archidiocèse de Strasbourg
Diocese of Roskilde	local	Roskildes  Stift
Roman Catholic Diocese of Orán	local	Diócesis de Orán
Roman Catholic Diocese of Elbląg	local	Diecezja Elbląska
Roman Catholic Diocese of Ełk	local	Diecezja Ełcka
Roman Catholic Archdiocese of Częstochowa	local	Archidiecezja Częstochowska
Roman Catholic Archdiocese of Białystok	local	Archidiecezja Białostocka
Roman Catholic Archdiocese of Gdańsk	local	Archidiecezja Gdańska
Roman Catholic Archdiocese of Katowice	local	Archidiecezja Katowicka
Roman Catholic Archdiocese of Łódź	local	Archidiecezja łódzka
Roman Catholic Archdiocese of Poznań	local	Archidiecezja Poznańska
Roman Catholic Archdiocese of Lublin	local	Archidiecezja Lubelska
Roman Catholic Archdiocese of Przemyśl	local	Archidiecezja Przemyska
Roman Catholic Archdiocese of Szczecin-Kamień	local	Archidiecezja Szczecińsko-Kamieńska
Roman Catholic Diocese of Pelplin	local	Diecezja Pelplińska
Roman Catholic Diocese of Koszalin-Kołobrzeg	local	Diecezja Koszalińsko-Kołobrzeska
Roman Catholic Diocese of Zielona Góra-Gorzów	local	Diecezja Zielonogórsko-Gorzowska
Roman Catholic Diocese of Radom	local	Diecezja Radomska
Roman Catholic Diocese of Sosnowiec	local	Diecezja Sosnowiecka
Roman Catholic Diocese of Gliwice	local	Diecezja Gliwicka
Roman Catholic Diocese of Toruń	local	Diecezja Toruńska
Roman Catholic Diocese of Opole	local	Diecezja Opolska
Roman Catholic Diocese of Łowicz	local	Diecezja łowicka
Roman Catholic Diocese of Płock	local	Diecezja Płocka
Roman Catholic Diocese of Kalisz	local	Diecezja Kaliska
Roman Catholic Diocese of Rzeszów	local	Diecezja Rzeszowska
Roman Catholic Diocese of Zamość-Lubaczów	local	Diecezja Zamojsko-Lubaczowska
Roman Catholic Diocese of Siedlce	local	Diecezja Siedlecka
Roman Catholic Diocese of Sandomierz	local	Diecezja Sandomierska
Roman Catholic Diocese of Erfurt	local	Bistum Erfurt
Roman Catholic Diocese of Limburg	local	Bistum Limburg
Roman Catholic Diocese of Ponta Grossa	local	Diocese de Ponta Grossa
Roman Catholic Diocese of Bydgoszcz	local	Diecezja Bydgoska
Roman Catholic Diocese of Włocławek	local	Diecezja Włocławska
Roman Catholic Diocese of Legnica	local	Diecezja Legnicka
Roman Catholic Diocese of Świdnica	local	Diecezja Świdnicka
Roman Catholic Archdiocese of Minsk-Mohilev	local	Мінска-Магілёўская архідыяцэзія
Roman Catholic Diocese of Pinsk	local	Пінскай дыяцэзіі
Roman Catholic Diocese of Grodno	local	Гродзенскай дыяцэзіі
Roman Catholic Diocese of Vitebsk	local	Віцебскай дыяцэзіі
Roman Catholic Diocese of Telšiai	local	Vyskupija Telšių
Roman Catholic Diocese of Vilkaviškis	local	Vyskupija Vilkaviškio
Roman Catholic Diocese of Kaišiadorys	local	Vyskupija Kaišiadorių
Roman Catholic Diocese of Panevėžys	local	Vyskupija Panevėžio
Roman Catholic Archdiocese of Riga	local	Rīgas arhidiecēze
Roman Catholic Diocese of Jelgava	local	Diecēze Jelgavas
Roman Catholic Diocese of Liepāja	local	Diecēzē Liepājas
Roman Catholic Diocese of Rēzekne-Aglona	local	Diecēze Rēzeknes-Aglonas
Roman Catholic Diocese of Saint Joseph at Irkutsk	local	Епархия Святого Иосифа в Иркутске
Roman Catholic Diocese of Transfiguration at Novosibirsk	local	Преображенской епархии в Новосибирске
Roman Catholic Archdiocese of Split-Makarska	local	Splitsko-makarska nadbiskupija
Roman Catholic Diocese of Eisenstadt	local	Diözese Eisenstadt
Roman Catholic Diocese of Sankt Pölten	local	Diözese St. Pölten
Roman Catholic Diocese of Innsbruck	local	Diözese Innsbruck
Roman Catholic Diocese of Gurk	local	Diözese Gurk-Klagenfurt
Roman Catholic Diocese of Gurk	local	Krška škofija
Roman Catholic Diocese of Feldkirch	local	Diözese Feldkirch
Roman Catholic Diocese of Sant Feliu de Llobregat	local	Diócesis de Sant Feliu de Llobregat (Spanish)
Roman Catholic Diocese of Sant Feliu de Llobregat	local	Diòcesi de Sant Feliu de Llobregat (Catalan)
Roman Catholic Diocese of Terrassa	local	Diócesis de Tarrassa (Spanish)
Roman Catholic Diocese of Terrassa	local	Diòcesi de Terrassa (Catalan)
Roman Catholic Diocese of Bilbao	local	Diócesis de Bilbao
Roman Catholic Diocese of Osma-Soria	local	Diócesis de Osma-Soria
Roman Catholic Diocese of Palencia	local	Diócesis de Palencia
Roman Catholic Diocese of Vitoria	local	Diócesis de Vitoria
Roman Catholic Diocese of Almería	local	Diócesis de Almería
Roman Catholic Diocese of Cartagena	local	Diócesis de Cartagena
Roman Catholic Diocese of Guadix	local	Diócesis de Guadix
Roman Catholic Diocese of Jaén	local	Diócesis de Jaén
Roman Catholic Diocese of Málaga	local	Diócesis de Málaga
Roman Catholic Diocese of Alcalá de Henares	local	Diócesis de Alcalá de Henares
Roman Catholic Diocese of Getafe	local	Diócesis de Getafe
Roman Catholic Diocese of Coria-Cáceres	local	Diócesis de Coria-Cáceres
Roman Catholic Diocese of Plasencia	local	Diócesis de Plasencia
Roman Catholic Archdiocese of Oviedo	local	Archidiócesis de Oviedo
Roman Catholic Diocese of Astorga	local	Diócesis de Astorga
Roman Catholic Diocese of León in Spain	local	Diócesis de León
Roman Catholic Diocese of Santander	local	Diócesis de Santander
Roman Catholic Diocese of Banská Bystrica	local	Banskobystrická Diecéza
Roman Catholic Archdiocese of Đakovo-Osijek	local	Đakovačko-osječka nadbiskupija
Roman Catholic Archdiocese of Pamplona y Tudela	local	Archidiócesis de Pamplona y Tudela
Roman Catholic Diocese of Calahorra y La Calzada-Logroño	local	Diócesis de Calahorra y La Calzada-Logroño
Roman Catholic Diocese of San Sebastián	local	Diócesis de San Sebastián (Spanish)
Roman Catholic Diocese of San Sebastián	local	Donostiako Elizbarrutia(Basque)
Roman Catholic Diocese of Córdoba	local	Diócesis de Córdoba
Roman Catholic Diocese of Canarias	local	Diócesis de Islas Canarias
Roman Catholic Diocese of San Cristóbal de La Laguna	local	Diócesis de San Cristóbal de La Laguna or Diócesis de Tenerife
Roman Catholic Diocese of Majorca	local	Diócesis de Mallorca
Roman Catholic Diocese of Majorca	local	Bisbat de Mallorca
Slovak Catholic Eparchy of Košice	local	Košická eparchia
Roman Catholic Diocese of Girona	local	Diòcesi de Girona
Roman Catholic Diocese of Girona	local	Diócesis de Gerona
Roman Catholic Diocese of Solsona	local	Diócesis de Solsona (Spanish)
Roman Catholic Diocese of Solsona	local	Diòcesi de Solsona (Catalan)
Roman Catholic Diocese of Vic	local	Diócesis de Vic (Spanish)
Roman Catholic Diocese of Vic	local	Diòcesi de Vic (Catalan)
Roman Catholic Diocese of Albacete	local	Diócesis de Albacete
Roman Catholic Diocese of Cuenca	local	Diócesis de Cuenca
Roman Catholic Diocese of Ciudad Real	local	Diócesis de Ciudad Real
Roman Catholic Diocese of Sigüenza-Guadalajara	local	Diócesis de Sigüenza-Guadalajara
Roman Catholic Diocese of Ibiza	local	Diocesis de Ibiza
Roman Catholic Diocese of Ibiza	local	Bisbat d' Eivissa
Roman Catholic Diocese of Menorca	local	Diócesis de Menorca
Roman Catholic Diocese of Menorca	local	Bisbat de Menorca
Roman Catholic Diocese of Orihuela-Alicante	local	Diócesis de Orihuela-Alicante
Roman Catholic Diocese of Orihuela-Alicante	local	Bisbat d'Orihola-Alacant
Roman Catholic Diocese of Ávila	local	Diócesis de Ávila
Roman Catholic Diocese of Ciudad Rodrigo	local	Diócesis de Ciudad Rodrigo
Roman Catholic Diocese of Salamanca	local	Diócesis de Salamanca
Roman Catholic Diocese of Segovia	local	Diócesis de Segovia
Roman Catholic Diocese of Zamora in Spain	local	Diócesis de Zamora
Roman Catholic Diocese of Niigata	local	カトリック新潟教区
Roman Catholic Diocese of Sapporo	local	カトリック札幌司教区
Roman Catholic Archdiocese of Trento	local	Arcidiocesi di Trento
Roman Catholic Archdiocese of Osaka	local	カトリック大阪大司教区
Roman Catholic Archdiocese of Nagasaki	local	カトリック長崎大司教区
Roman Catholic Diocese of Verdun	local	Diocèse de Verdun
Eparchy of Lungro	local	Diocesi di Lungro
Roman Catholic Diocese of Prato	local	Diocesi di Prato
Roman Catholic Diocese of Trapani	local	Diocesi di Trapani
Roman Catholic Diocese of Litoměřice	local	Diecéze Litoměřice
Roman Catholic Diocese of Hradec Králové	local	Diecéze královéhradecká
Roman Catholic Diocese of Brno	local	Diecéze Brno
Roman Catholic Diocese of Ostrava-Opava	local	Diecéze ostravsko-opavská
Italo-Albanese Eparchy of Piana degli Albanesi	local	Eparchia di Piana degli Albanesi
Italo-Albanese Eparchy of Piana degli Albanesi	local	Eparhia e Horës së Arbëreshëvet
Roman Catholic Diocese of Debrecen–Nyíregyháza	local	Debrecen-Nyíregyházi egyházmegye
Roman Catholic Diocese of Szeged–Csanád	local	Szeged-Csanádi egyházmegye
Hungarian Catholic Archeparchy of Hajdúdorog	local	Hajdúdorogi Főegyházmegye
Roman Catholic Diocese of Székesfehérvár	local	Székesfehérvári egyházmegye
Roman Catholic Diocese of Kaposvár	local	Kaposvári egyházmegye
Roman Catholic Diocese of Szombathely	local	Szombathelyi egyházmegye
Roman Catholic Archdiocese of Rijeka	local	Riječka nadbiskupija
Roman Catholic Diocese of Gospić-Senj	local	Gospićko-senjska biskupija
Roman Catholic Diocese of Poreč-Pula	local	Porečko-pulska biskupija
Roman Catholic Diocese of Šibenik	local	Šibenska biskupija
Roman Catholic Diocese of Angra	local	Diocese de Angra
Roman Catholic Diocese of Aveiro	local	Diocese de Aveiro
Roman Catholic Diocese of Beja	local	Diocese de Beja
Roman Catholic Archdiocese of Evora	local	Arquidiocese de Évora
Roman Catholic Diocese of Faro	local	Diocese do Algarve
Roman Catholic Diocese of Santarém, Portugal	local	Diocese de Santarém
Roman Catholic Diocese of Setúbal	local	Diocese de Setúbal
Roman Catholic Diocese of Portalegre-Castelo Branco	local	Diocese de Portalegre-Castelo Branco
Roman Catholic Diocese of Leiria-Fátima	local	Diocese de Leiria-Fátima
Roman Catholic Diocese of Viana do Castelo	local	Diocese de Viana do Castelo
Roman Catholic Diocese of Viseu	local	Diocese de Viseu
Episcopal Diocese of Taiwan	local	臺灣聖公會
Roman Catholic Diocese of Vila Real	local	Diocese de Vila Real
Roman Catholic Archdiocese of Trnava	local	Arcibiskupstvo Trnava
Roman Catholic Diocese of Žilina	local	Žilinská Diecéza
Slovak Catholic Eparchy of Bratislava	local	Bratislavská eparchia
Slovak Catholic Metropolitan Archeparchy of Prešov	local	Prešovská Archieparchia
Roman Catholic Archdiocese of Tiranë-Durrës	local	Kryedioqeza e Tiranë-Durrës
Roman Catholic Diocese of Rrëshen	local	Dioqeza e Rrëshenit
Roman Catholic Diocese of Lezhë	local	Dioqeza e Lezhës
Albanian Catholic Apostolic Administration of Southern Albania	local	Administratura Apostolike e Shqiperisë së Jugut
Roman Catholic Diocese of Koper	local	Škofija Koper
Roman Catholic Diocese of Novo Mesto	local	Škofija Novo mesto
Roman Catholic Diocese of Celje	local	Škofija Celje
Roman Catholic Archdiocese of Maribor	local	Nadškofija Maribor
Roman Catholic Diocese of Murska Sobota	local	Škofija Murska Sobota
Roman Catholic Diocese of Deventer	local	Bisdom Deventer
Roman Catholic Diocese of Crete	local	Επισκοπή Κρήτης
Roman Catholic Diocese of Chios	local	Επισκοπή Χίου
Roman Catholic Diocese of Santorini	local	Επισκοπή Θήρας
Roman Catholic Diocese of Syros	local	Επισκοπή Σύρου
Roman Catholic Archdiocese of Rhodes	local	Αρχιεπισκοπή Ρόδου
Roman Catholic Archdiocese of Corfu, Zakynthos, and Cephalonia	local	Αρχιεπισκοπή Κερκύρας, Ζακύνθου, και Κεφαλληνίας
Romanian Catholic Eparchy of Oradea Mare	local	Episcopia de Oradea Mare
Roman Catholic Diocese of Guarda, Portugal	local	Diocese da Guarda
Roman Catholic Archdiocese of Belgrade	local	Beogradska nadbiskupija
Roman Catholic Archdiocese of Belgrade	local	Belgrádi főegyházmegye
Roman Catholic Archdiocese of Cochabamba	local	Arquidiócesis de Cochabamba
Roman Catholic Archdiocese of Sucre	local	Arquidiócesis de Sucre
Roman Catholic Archdiocese of La Paz	local	Arquidiócesis de La Paz
Roman Catholic Diocese of Coroico	local	Diócesis de Coroico
Roman Catholic Diocese of El Alto	local	Diócesis de El Alto
Roman Catholic Diocese of Oruro	local	Diócesis de Oruro
Roman Catholic Diocese of San Ignacio de Velasco	local	Diócesis de San Ignacio de Velasco
Roman Catholic Diocese of Potosí	local	Diócesis de Potosí
Roman Catholic Diocese of Tarija	local	Diócesis de Tarija
Roman Catholic Territorial Prelature of Aiquile	local	Prelatura Territorial de Aiquile
Roman Catholic Territorial Prelature of Corocoro	local	Prelatura Territorial de Corocoro
Roman Catholic Archdiocese of Barranquilla	local	Arquidiócesis de Barranquilla
Roman Catholic Diocese of El Banco	local	Diócesis de El Banco
Roman Catholic Diocese of Riohacha	local	Diócesis de Riohacha
Roman Catholic Diocese of Santa Marta	local	Diócesis de Santa Marta
Roman Catholic Diocese of Valledupar	local	Diócesis de Valledupar
Roman Catholic Archdiocese of Ozamiz	local	Arkidiyosesis ng Ozamiz
Roman Catholic Diocese of Arica	local	Diócesis de San Marcos de Arica
Roman Catholic Archdiocese of Antofagasta	local	Arquidiócesis de Antofagasta
Roman Catholic Diocese of Iquique	local	Diócesis de Iquique
Roman Catholic Archdiocese of Concepción	local	Arquidiócesis de Concepción
Roman Catholic Archdiocese of La Serena	local	Arquidiócesis de La Serena
Roman Catholic Territorial Prelature of Illapel	local	Prelatura Territorial de Illapel
Roman Catholic Diocese of Copiapó	local	Diócesis de Copiapó
Roman Catholic Diocese of Melipilla	local	Diócesis de Melipilla
Roman Catholic Diocese of San Felipe, Chile	local	Diócesis de San Felipe
Roman Catholic Diocese of San Bernardo	local	Diócesis de San Bernardo
Roman Catholic Diocese of Valparaíso	local	Diócesis de Valparaíso
Roman Catholic Diocese of Chillán	local	Diócesis de Chillán
Roman Catholic Diocese of Temuco	local	Diócesis de Temuco
Roman Catholic Diocese of Villarrica	local	Diócesis de Villarrica
Roman Catholic Diocese of San Juan de Calama	local	Diócesis de San Juan Bautista de Calama
Roman Catholic Diocese of Santa María de Los Ángeles	local	Diócesis de Santa María de Los Angeles
Roman Catholic Diocese of Valdivia	local	Diócesis de Valdivia
Roman Catholic Archdiocese of Cagayan de Oro	local	Arkidyosesis sa Cagayan de Oro
Roman Catholic Archdiocese of Aparecida	local	Arquidiocese de Aparecida
Roman Catholic Archdiocese of Aracaju	local	Arquidiocese de Aracaju
Roman Catholic Archdiocese of Belém do Pará	local	Arquidiocese de Belém do Pará
Roman Catholic Diocese of Estância	local	Diocese de Estância
Roman Catholic Diocese of Propriá	local	Diocese de Propriá
Roman Catholic Diocese of Abaetetuba	local	Diocese de Abaetetuba
Roman Catholic Diocese of Bragança do Pará	local	Diocese de Bragança do Pará
Roman Catholic Diocese of Castanhal	local	Diocese de Castanhal
Roman Catholic Diocese of Macapá	local	Diocese de Macapá
Roman Catholic Diocese of Marabá	local	Diocese de Marabá
Roman Catholic Diocese of Ponta de Pedras	local	Diocese de Ponta de Pedras
Roman Catholic Diocese of Santarém, Brazil	local	Diocese de Santarém
Roman Catholic Diocese of Santíssima Conceição do Araguaia	local	Diocese de Santíssima Conceição do Araguaia
Roman Catholic Archdiocese of Belo Horizonte	local	Arquidiocese de Belo Horizonte
Roman Catholic Diocese of Pasig	local	Diyosesis ng Pasig
Roman Catholic Archdiocese of Verapoly	local	Varapuzha
Roman Catholic Diocese of Divinópolis	local	Diocese de Divinópolis
Roman Catholic Diocese of Luz	local	Diocese de Luz
Roman Catholic Diocese of Oliveira	local	Diocese de Oliveira
Roman Catholic Diocese of Sete Lagoas	local	Diocese de Sete Lagoas
Roman Catholic Archdiocese of Botucatu	local	Arquidiocese de Botucatu
Roman Catholic Archdiocese of Brasília	local	Arquidiocese de Brasília
Roman Catholic Archdiocese of Campinas	local	Arquidiocese de Campinas
Roman Catholic Archdiocese of Campo Grande	local	Arquidiocese de Campo Grande
Roman Catholic Archdiocese of Cascavel	local	Arquidiocese de Cascavel
Roman Catholic Archdiocese of Cuiabá	local	Arquidiocese de Cuiabá
Roman Catholic Diocese of Araçatuba	local	Diocese de Araçatuba
Roman Catholic Diocese of Assis	local	Diocese de Assis
Roman Catholic Diocese of Bauru	local	Diocese de Bauru
Roman Catholic Diocese of Lins	local	Diocese de Lins
Roman Catholic Diocese of Marília	local	Diocese de Marília
Roman Catholic Diocese of Ourinhos	local	Diocese de Ourinhos
Roman Catholic Diocese of Presidente Prudente	local	Diocese de Presidente Prudente
Roman Catholic Diocese of Luziânia	local	Diocese de Luziânia
Roman Catholic Diocese of Uruaçu	local	Diocese de Uruaçu
Roman Catholic Diocese of Amparo	local	Diocese de Amparo
Roman Catholic Diocese of Bragança Paulista	local	Diocese de Bragança Paulista
Roman Catholic Diocese of Limeira	local	Diocese de Limeira
Roman Catholic Diocese of Piracicaba	local	Diocese de Piracicaba
Roman Catholic Diocese of São Carlos	local	Diocese de São Carlos
Roman Catholic Diocese of Dourados	local	Diocese de Dourados
Roman Catholic Diocese of Corumbá	local	Diocese de Corumbá
Roman Catholic Diocese of Jardim	local	Diocese de Jardim
Roman Catholic Diocese of Coxim	local	Diocese de Coxim
Roman Catholic Diocese of Três Lagoas	local	Diocese de Três Lagoas
Roman Catholic Diocese of Foz do Iguaçu	local	Diocese de Foz do Iguaçu
Roman Catholic Diocese of Palmas–Francisco Beltrão	local	Diocese de Palmas–Francisco Beltrão
Roman Catholic Diocese of Toledo, Brazil	local	Diocese de Toledo
Roman Catholic Diocese of Diamantino	local	Diocese de Diamantino
Roman Catholic Diocese of Barra do Garças	local	Diocese de Barra do Garças
Diocese of Guiratinga	local	Diocese de Guiratinga
Roman Catholic Diocese of Juína	local	Diocese de Juína
Roman Catholic Diocese of São Luíz de Cáceres	local	Diocese de São Luíz de Cáceres
Roman Catholic Diocese of Rondonópolis-Guiratinga	local	Diocese de Rondonópolis-Guiratinga
Roman Catholic Archdiocese of Diamantina	local	Arquidiocese de Diamantina
Roman Catholic Archdiocese of Feira de Santana	local	Arquidiocese de Feira de Santana
Roman Catholic Archdiocese of Curitiba	local	Arquidiocese de Curitiba
Roman Catholic Archdiocese of Florianópolis	local	Arquidiocese de Florianópolis
Roman Catholic Diocese of Ghent	local	Diocèse de Gand
Roman Catholic Diocese of Ghent	local	Bistum von Gent
Roman Catholic Diocese of Ghent	local	Bisdom Gent
Roman Catholic Diocese of Liège	local	Diocèse de Liège
Roman Catholic Diocese of Liège	local	Bistum Lüttich
Roman Catholic Diocese of Liège	local	Bisdom Luik
Roman Catholic Archdiocese of Fortaleza	local	Arquidiocese de Fortaleza
Roman Catholic Archdiocese of Goiânia	local	Arquidiocese de Goiânia
Roman Catholic Archdiocese of Mariana	local	Arquidiocese de Mariana
Apostolic Vicariate of Thessaloniki	local	Αποστολικό Βικαριάτο Θεσσαλονίκης
Eparchy of Križevci	local	Križevačka eparhija
Roman Catholic Archdiocese of Tuguegarao	local	Arkidiocesis ti Tuguegarao , Arkidiocesis nat Tuguegarao , Archidiocensya yoh Tuguegaraow
Roman Catholic Archdiocese of Capiz	local	Artsidiyosesis sang Capiz
Roman Catholic Archdiocese of Cotabato	local	Arkidiyosesis ng Cotabato
Roman Catholic Archdiocese of Cotabato	local	Arkidiyosis sang Cotabato
Roman Catholic Archdiocese of Cotabato	local	Artsidiyosesis sa Cotabato
Roman Catholic Diocese of Guarapuava	local	Diocese de Guarapuava
Roman Catholic Diocese of Paranaguá	local	Diocese de Paranaguá
Roman Catholic Diocese of São José dos Pinhais	local	Diocese de São José dos Pinhais
Roman Catholic Diocese of Araçuaí	local	Diocese de Araçuaí
Roman Catholic Diocese of União da Vitória	local	Diocese de União da Vitória
Roman Catholic Diocese of Almenara	local	Diocese de Almenara
Roman Catholic Diocese of Guanhães	local	Diocese de Guanhães
Roman Catholic Diocese of Teófilo Otoni	local	Diocese de Teófilo Otoni
Roman Catholic Diocese of Barra	local	Diocese de Barra
Roman Catholic Diocese of Barreiras	local	Diocese de Barreiras
Roman Catholic Diocese of Bonfim	local	Diocese de Bonfim
Roman Catholic Diocese of Irecê	local	Diocese de Irecê
Roman Catholic Diocese of Juazeiro	local	Diocese de Juazeiro
Roman Catholic Diocese of Paulo Afonso	local	Diocese de Paulo Afonso
Roman Catholic Diocese of Ruy Barbosa	local	Diocese de Barra
Roman Catholic Diocese of Caçador	local	Diocese de Caçador
Roman Catholic Diocese of Chapecó	local	Diocese de Chapecó
Roman Catholic Diocese of Blumenau	local	Diocese de Blumenau
Roman Catholic Diocese of Criciúma	local	Diocese de Blumenau
Roman Catholic Diocese of Joaçaba	local	Diocese de Joaçaba
Roman Catholic Diocese of Joinville	local	Diocese de Joinville
Roman Catholic Diocese of Rio do Sul	local	Diocese de Rio do Sul
Roman Catholic Diocese of Lages	local	Diocese de Lages
Roman Catholic Diocese of Tubarão	local	Diocese de Blumenau
Roman Catholic Diocese of Crateús	local	Diocese de Crateús
Roman Catholic Diocese of Crato	local	Diocese de Crato
Roman Catholic Diocese of Iguatu	local	Diocese de Iguatuvinus
Roman Catholic Diocese of Itapipoca	local	Diocese de Itapipoca
Roman Catholic Diocese of Limoeiro do Norte	local	Diocese de Limoeiro do Norte
Roman Catholic Diocese of Sobral	local	Diocese de Sobral
Roman Catholic Diocese of Quixadá	local	Diocese de Quixadá
Roman Catholic Diocese of Tianguá	local	Diocese de Tianguá
Roman Catholic Archdiocese of Moscow	local	Архиепархия Матери Божией в Москве
Roman Catholic Archdiocese of Athens	local	Ιερά Αρχιεπισκοπή Καθολικών Αθηνών
Roman Catholic Diocese of Caraguatatuba	local	Diocese de Caraguatatuba
Roman Catholic Diocese of São José dos Campos	local	Diocese de São José dos Campos
Roman Catholic Diocese of Lorena	local	Diocese de Lorena
Roman Catholic Diocese of Taubaté	local	Diocese de Taubaté
Roman Catholic Diocese of Cametá	local	Diocese de Cametá
Roman Catholic Diocese of Formosa, Brazil	local	Diocese de Formosa
Roman Catholic Territorial Prelature of Itaituba	local	Prelazia Territorial de Itaituba
Roman Catholic Territorial Prelature of Marajó	local	Prelazia Territorial de Marajó
Roman Catholic Diocese of Óbidos	local	Diocese de Óbidos
Roman Catholic Territorial Prelature of Xingu	local	Prelazia Territorial de Xingu
Roman Catholic Diocese of Primavera do Leste–Paranatinga	local	Diocese de Primavera do Leste-Paranatinga
Territorial Prelature of São Félix do Araguaia	local	Prelazia Territorial de São Félix
Roman Catholic Diocese of Syrmia	local	Епархија Сријема
Roman Catholic Archdiocese of Vienna	local	Erzdiözese Wien
Roman Catholic Diocese of Kyiv-Zhytomyr	local	Єпархія Київ-Житомир
Roman Catholic Diocese of Kamyanets-Podilskyi	local	Єпархія Кам'янець-Подільський
Roman Catholic Diocese of Mukacheve	local	Єпархія Мукачево
Roman Catholic Diocese of Antwerp	local	Diocèse d'Anvers
Roman Catholic Diocese of Antwerp	local	Bistum von Antwerpen
Roman Catholic Diocese of Antwerp	local	Bisdom Antwerpen
Roman Catholic Diocese of Kharkiv-Zaporizhia	local	Єпархія Харків-Запоріжжя
Roman Catholic Diocese of Odessa-Simferopol	local	Єпархія Одеса-Сімферополь
Roman Catholic Diocese of Nicopolis	local	Епархия Никопол
Roman Catholic Diocese of Iași	local	Episcopia de Iaşi
Roman Catholic Archdiocese of Bucharest	local	Arhidieceza De Bucureşti
Roman Catholic Archdiocese of Alba Iulia	local	Arhiepiscopia de Alba Iulia
Roman Catholic Diocese of Satu Mare	local	Dieceza Satu Mare
Roman Catholic Diocese of Timișoara	local	Dieceza de Timișoara
Roman Catholic Archdiocese of Anqing	local	天主教安庆总教区
Roman Catholic Archdiocese of Beijing	local	天主教北京总教区
Roman Catholic Archdiocese of Changsha	local	天主教长沙总教区
Roman Catholic Archdiocese of Guangzhou	local	天主教广州总教区
Roman Catholic Archdiocese of Fuzhou	local	天主教福州总教区
Roman Catholic Archdiocese of Chongqing	local	天主教重庆总教区
Roman Catholic Archdiocese of Guiyang	local	天主教贵阳总教区
Roman Catholic Archdiocese of Jinan	local	天主教济南总教区
Roman Catholic Archdiocese of Hankou	local	天主教汉口总教区
Roman Catholic Archdiocese of Hangzhou	local	天主教杭州总教区
Roman Catholic Archdiocese of Kaifeng	local	天主教开封总教区
Roman Catholic Archdiocese of Kunming	local	天主教昆明总教区
Roman Catholic Archdiocese of Lanzhou	local	天主教兰州总教区
Roman Catholic Archdiocese of Nanchang	local	天主教南昌总教区
Roman Catholic Archdiocese of Nanning	local	天主教南宁总教区
Roman Catholic Archdiocese of Xi’an	local	天主教西安总教区
Roman Catholic Archdiocese of Taiyuan	local	天主教太原总教区
Roman Catholic Archdiocese of Shenyang	local	天主教奉天总教区
Roman Catholic Archdiocese of Suiyuan	local	天主教绥远总教区
Roman Catholic Diocese of Xiwanzi	local	天主教西湾子教区
Roman Catholic Diocese of Ningxia	local	天主教宁夏教区
Roman Catholic Diocese of Jining	local	天主教集宁教区
Roman Catholic Diocese of Wuzhou	local	天主教梧州教区
Roman Catholic Diocese of Nanlong	local	天主教安龙教区
Roman Catholic Diocese of Wuhu	local	芜湖教区
Roman Catholic Diocese of Bengbu	local	蚌埠教区
Roman Catholic Diocese of Datong	local	天主教大同教区
Roman Catholic Diocese of Hongdong	local	天主教洪洞教区
Roman Catholic Diocese of Fenyang	local	天主教汾阳教区
Roman Catholic Diocese of Yuci	local	天主教榆次教区
Roman Catholic Diocese of Lu’an	local	天主教潞安教区
Roman Catholic Diocese of Shuozhou	local	天主教朔州教区
Roman Catholic Diocese of Haimen	local	天主教海门教区
Roman Catholic Diocese of Suzhou	local	天主教苏州教区
Roman Catholic Diocese of Xuzhou	local	天主教徐州教区
Roman Catholic Diocese of Changde	local	天主教常德教区
Roman Catholic Diocese of Hengzhou	local	天主教衡州教区
Roman Catholic Diocese of Yuanling	local	天主教沅陵教区
Roman Catholic Diocese of Fengxiang	local	天主教凤翔教区
Roman Catholic Diocese of Hanzhong	local	天主教汉中教区
Roman Catholic Diocese of Sanyuan	local	天主教三原教区
Roman Catholic Diocese of Yan’an	local	天主教延安教区
Roman Catholic Diocese of Zhouzhi	local	天主教盩厔教区
Roman Catholic Diocese of Anguo	local	安国教区
Roman Catholic Diocese of Daming	local	教區大名
Roman Catholic Diocese of Baoding	local	保定教区
Roman Catholic Diocese of Jingxian	local	天主教景县教区
Roman Catholic Diocese of Shunde	local	天主教顺德教区
Roman Catholic Diocese of Xuanhua	local	天主教宣化教区
Roman Catholic Diocese of Xianxian	local	天主教献县教区
Roman Catholic Diocese of Yongnian	local	天主教永年教区
Roman Catholic Diocese of Yongping	local	天主教永平教区
Roman Catholic Diocese of Zhaoxian	local	天主教赵县教区
Roman Catholic Diocese of Zhengding	local	天主教正定教区
Roman Catholic Diocese of Funing	local	天主教福宁教区
Roman Catholic Diocese of Tingzhou	local	天主教汀州教区
Roman Catholic Diocese of Xiamen	local	天主教厦门教区
Roman Catholic Diocese of Beihai	local	天主教北海教区
Roman Catholic Diocese of Jiangmen	local	天主教江门教区
Roman Catholic Diocese of Jiaying	local	天主教嘉应教区
Roman Catholic Diocese of Shantou	local	天主教汕头教区
Roman Catholic Diocese of Shaozhou	local	天主教韶州教区
Diocese of Aarhus	local	Århus Stift
Roman Catholic Diocese of Lishui	local	天主教丽水教区
Roman Catholic Diocese of Ningbo	local	天主教宁波教区
Roman Catholic Diocese of Taizhou	local	天主教台州教区
Roman Catholic Diocese of Yongjia	local	天主教永嘉教区
Roman Catholic Diocese of Dali	local	天主教大理教区
Roman Catholic Diocese of Chengdu	local	天主教成都教区
Roman Catholic Diocese of Jiading	local	天主教嘉定教区
Roman Catholic Diocese of Kangding	local	天主教康定教区
Roman Catholic Diocese of Ningyuan	local	天主教宁远教区
Roman Catholic Diocese of Shunqing	local	天主教顺庆教区
Roman Catholic Diocese of Suifu	local	天主教叙府教区
Roman Catholic Diocese of Wanxian	local	天主教万县教区
Roman Catholic Diocese of Hanyang	local	天主教汉阳教区
Roman Catholic Diocese of Laohekou	local	天主教老河口教区
Roman Catholic Diocese of Puqi	local	天主教蒲圻教区
Roman Catholic Diocese of Qizhou	local	天主教蕲州教区
Roman Catholic Diocese of Shinan	local	天主教施南教区
Roman Catholic Diocese of Wuchang	local	天主教武昌教区
Roman Catholic Diocese of Xiangyang	local	天主教襄阳教区
Roman Catholic Diocese of Yichang	local	天主教宜昌教区
Roman Catholic Diocese of Caozhou	local	天主教曹州教区
Roman Catholic Diocese of Qingdao	local	天主教青岛教区
Roman Catholic Diocese of Yanggu	local	天主教阳谷教区
Roman Catholic Diocese of Yantai	local	天主教烟台教区
Roman Catholic Diocese of Yanzhou	local	天主教兖州教区
Roman Catholic Diocese of Yizhou	local	天主教沂州教区
Roman Catholic Diocese of Zhoucun	local	天主教周村教区
Roman Catholic Diocese of Pingliang	local	天主教平凉教区
Roman Catholic Diocese of Qinzhou	local	天主教秦州教区
Roman Catholic Diocese of Skopje	local	Скопска бискупија
Roman Catholic Diocese of Ganzhou	local	天主教赣州教区
Roman Catholic Diocese of Ji’an	local	天主教吉安教区
Roman Catholic Diocese of Nancheng	local	天主教南城教区
Roman Catholic Diocese of Yujiang	local	天主教余江教区
Roman Catholic Diocese of Nanyang	local	天主教南阳教区
Roman Catholic Diocese of Luoyang	local	天主教洛阳教区
Roman Catholic Diocese of Weihui	local	天主教卫辉教区
Roman Catholic Diocese of Guide	local	天主教归德教区
Roman Catholic Diocese of Xinyang	local	天主教信阳教区
Roman Catholic Diocese of Belfort-Montbéliard	local	Diocèse de Belfort-Montbéliard
Roman Catholic Diocese of Créteil	local	Diocèse de Créteil
Roman Catholic Diocese of Évry-Corbeil-Essonnes	local	Diocèse d'Evry-Corbeil-Essonnes
Roman Catholic Diocese of Nanterre	local	Diocèse de Nanterre
Roman Catholic Diocese of Pontoise	local	Diocèse de Pontoise
Roman Catholic Diocese of Saint-Denis	local	Diocèse de Saint-Denis
Roman Catholic Diocese of Zhengzhou	local	天主教郑州教区
Roman Catholic Diocese of Zhumadian	local	天主教驻马店教区
Roman Catholic Diocese of Chifeng	local	天主教赤峰教区
Roman Catholic Diocese of Jilin	local	天主教吉林教区
Roman Catholic Diocese of Rehe	local	天主教热河教区
Roman Catholic Diocese of Yanji	local	天主教延吉教区
Roman Catholic Diocese of Sipingjie	local	天主教四平街教区
Roman Catholic Diocese of Fushun	local	天主教抚顺教区
Roman Catholic Diocese of Yingkou	local	天主教营口教区
Diocese of Rome	local	Diocesi di Roma
Roman Catholic Diocese of Chittagong	local	চট্টগ্রাম এর বিশপের এলাকা
Roman Catholic Diocese of Dinajpur	local	দিনাজপুর এর বিশপের এলাকা
Roman Catholic Diocese of Khulna	local	খুলনা এর বিশপের এলাকা
Roman Catholic Diocese of Mymensingh	local	ময়মনসিংহ এর বিশপের এলাকা
Roman Catholic Diocese of Rajshahi	local	রাজশাহী এর বিশপের এলাকা
Roman Catholic Diocese of Belgaum	local	बेलगाम के सूबा
Roman Catholic Archdiocese of Agra	local	आगरा के सूबा
Roman Catholic Archdiocese of Bhopal	local	भोपाल के सूबा
Apostolic Prefecture of Ulaanbaatar	local	Улаанбаатар хот дахь Элч нарын эрх мэдэлд суурилсан шашны засаг захиргаа
Roman Catholic Archdiocese of Delhi	local	दिल्ली के सूबा
Roman Catholic Archdiocese of Cuttack-Bhubaneswar	local	कटक भुवनेश्वर के सूबा
Roman Catholic Archdiocese of Imphal	local	इम्फाल के सूबा
Roman Catholic Archdiocese of Gandhinagar	local	गांधीनगर के सूबा (Hindi)
Roman Catholic Archdiocese of Gandhinagar	local	ગાંધીનગર આર્ચબિશપ (Gujarati)
Roman Catholic Archdiocese of Hyderabad	local	हैदराबाद के सूबा
Roman Catholic Diocese of Kohima	local	कोहिमा के सूबा
Roman Catholic Diocese of Tainan	local	天主教台南教區
Roman Catholic Diocese of Taichung	local	天主教台中教區
Roman Catholic Diocese of Kiayi	local	天主教嘉義教區
Roman Catholic Diocese of Kaohsiung	local	天主教高雄教區
Roman Catholic Diocese of Hwalien	local	天主教花蓮教區
Roman Catholic Diocese of Trincomalee	local	திருகோணமலை மட்டக்களப்பு மறைமாவட்டத்தின்
Roman Catholic Diocese of Ratnapura	local	இரத்தினபுரி மறைமாவட்டத்தின்
Roman Catholic Diocese of Kurunegala	local	குருணாகல் மாவட்ட
Roman Catholic Diocese of Hsinchu	local	天主教新竹教區
Roman Catholic Diocese of Kandy	local	கண்டி மாவட்ட
Roman Catholic Diocese of Mannar	local	மன்னார் மறைமாவட்டம
Roman Catholic Diocese of Badulla	local	பதுளை மாவட்ட
Roman Catholic Diocese of Galle	local	காலி மாவட்ட
Roman Catholic Diocese of Chilaw	local	சிலாபம் மறைமாவட்டம்
Roman Catholic Diocese of Anuradhapura	local	அநுராதபுரம் மாவட்ட
Roman Catholic Archdiocese of Guwahati	local	गुवाहाटी के सूबा
Roman Catholic Archdiocese of Madras and Mylapore	local	சென்னை-மயிலை உயர்மறைமாவட்டம்
Roman Catholic Archdiocese of Nagpur	local	नागपूर बिशपच्या अधिकारातील प्रदेश
Roman Catholic Archdiocese of Madurai	local	மதுரை உயர்மறை
Roman Catholic Archdiocese of Patna	local	पटना के सूबा
Roman Catholic Archdiocese of Pondicherry and Cuddalore	local	புதுவை கடலூர் உயர் மறைமாவட்டம்
Roman Catholic Archdiocese of Shillong	local	शिलांग के सूबा
Roman Catholic Archdiocese of Raipur	local	रायपुर के सूबा
Roman Catholic Archdiocese of Kota Kinabalu	local	Keuskupan Agung Kota Kinabalu
Roman Catholic Archdiocese of Visakhapatnam	local	విశాఖపట్నం ఆర్చ్డియోసెస్
Roman Catholic Archdiocese of Trivandrum	local	തിരുവനന്തപുരം
Roman Catholic Diocese of Chingleput	local	செங்கல்பட்டு மறைமாவட்ட
Roman Catholic Diocese of Ootacamund	local	உதகமண்டலம் மறைமாவட்டம்
Roman Catholic Diocese of Vellore	local	வேலூர் மறைமாவட்டம்
Roman Catholic Diocese of Allahabad	local	इलाहाबाद के सूबा
Roman Catholic Diocese of Ajmer	local	अजमेर के सूबा
Roman Catholic Diocese of Bareilly	local	बरेली के सूबा
Roman Catholic Diocese of Jhansi	local	झांसी के सूबा
Roman Catholic Diocese of Lucknow	local	लखनऊ के सूबा
Roman Catholic Diocese of Lucknow	local	لکھنؤ کے صوبہ
Roman Catholic Diocese of Udaipur	local	उदयपुर के सूबा
Roman Catholic Diocese of Varanasi	local	वाराणसी के सूबा
Roman Catholic Diocese of Karwar	local	कारवार के सूबा
Roman Catholic Diocese of Chikmagalur	local	चिकमगलूर के सूबा
Roman Catholic Diocese of Mysore	local	मैसूर के सूबा
Roman Catholic Diocese of Mangalore	local	मंगलौर के सूबा
Roman Catholic Diocese of Shimoga	local	शिमोगा के सूबा
Roman Catholic Diocese of Khandwa	local	खंडवा के सूबा
Roman Catholic Diocese of Nashik	local	नासिक के सूबा
Roman Catholic Diocese of Poona	local	पूना के सूबा
Roman Catholic Diocese of Vasai	local	वसई के सूबा
Roman Catholic Diocese of Asansol	local	आसनसोल के सूबा
Roman Catholic Diocese of Jalpaiguri	local	जलपाईगुड़ी के सूबा
Roman Catholic Diocese of Baruipur	local	বারুইপুর के सूबा
Roman Catholic Diocese of Raiganj	local	ওদিকে? এর বিশপের এলাকা
Roman Catholic Diocese of Bagdogra	local	बागडोगरा के सूबा
Roman Catholic Diocese of Krishnagar	local	কৃশনগর এর বিশপের এলাকা
Roman Catholic Diocese of Balasore	local	बालासोर के सूबा
Roman Catholic Diocese of Berhampur	local	बहरामपुर के सूबा
Roman Catholic Diocese of Sambalpur	local	संबलपुर के सूबा
Roman Catholic Diocese of Rourkela	local	राउरकेला के सूबा
Roman Catholic Diocese of Jammu–Srinagar	local	जम्मू श्रीनगर के सूबा
Roman Catholic Diocese of Jalandhar	local	जालंधर के सूबा
Roman Catholic Diocese of Simla and Chandigarh	local	शिमला और चंडीगढ़ के सूबा
Roman Catholic Diocese of Ahmedabad	local	अहमदाबाद के सूबा (Hindi)
Roman Catholic Diocese of Ahmedabad	local	અમદાવાદ ડાયોસિઝ (Gujarati)
Roman Catholic Diocese of Baroda	local	बड़ौदा के सूबा (Hindi)
Roman Catholic Diocese of Baroda	local	ઓફ બરોડા ડાયોસિઝ (Gujarati)
Roman Catholic Diocese of Khamman	local	खम्मम के सूबा
Roman Catholic Diocese of Cuddapah	local	कडप्पा के सूबा
Roman Catholic Diocese of Kurnool	local	कुरनूल के सूबा
Roman Catholic Diocese of Nalgonda	local	नलगोंडा के सूबा
Roman Catholic Diocese of Warangal	local	वारंगल के सूबा
Roman Catholic Diocese of Dindigul	local	திண்டுக்கல் மறைமாவட்டம்
Roman Catholic Diocese of Palayamkottai	local	பாளையங்கோட்டை மறைமாவட்ட
Roman Catholic Diocese of Tiruchirapalli	local	திருச்சிராப்பள்ளி மறைமாவட்டம்
Roman Catholic Diocese of Kottar	local	கோட்டாறு மறைமாவட்டம்
Roman Catholic Diocese of Tuticorin	local	தூத்துக்குடி மறைமாவட்டம்
Roman Catholic Diocese of Amravati	local	अमरावती च्या बिशपच्या अधिकारातील प्रदेश
Roman Catholic Diocese of Aurangabad	local	औरंगाबाद बिशपच्या अधिकारातील प्रदेश
Roman Catholic Diocese of Bettiah	local	बेतिया के सूबा
Roman Catholic Diocese of Bhagalpur	local	भागलपुर के सूबा
Roman Catholic Diocese of Muzaffarpur	local	मुजफ्फरपुर के सूबा
Roman Catholic Diocese of Purnea	local	पूर्णिया के सूबा
Roman Catholic Diocese of Kumbakonam	local	கும்பகோணம் மறைமாவட்டம்
Roman Catholic Diocese of Dharmapuri	local	धर्मपुरी के सूबा
Roman Catholic Diocese of Salem	local	சேலம் மறைமாவட்டம்
Roman Catholic Diocese of Tanjore	local	தஞ்சை மறைமாவட்டம்
Roman Catholic Diocese of Ambikapur	local	अंबिकापुर के सूबा
Roman Catholic Diocese of Raigarh	local	रायगढ़ के सूबा
Roman Catholic Diocese of Masan	local	마산 교구
Roman Catholic Diocese of Cheongju	local	청주 교구
Roman Catholic Diocese of Hamhung	local	함흥 교구
Roman Catholic Diocese of Daltonganj	local	डाल्टनगंज के सूबा
Roman Catholic Diocese of Dumka	local	दुमका के सूबा
Roman Catholic Diocese of Gumla	local	गुमला के सूबा
Roman Catholic Diocese of Hazaribag	local	हजारीबाग के सूबा
Roman Catholic Diocese of Jamshedpur	local	जमशेदपुर के सूबा (Hindi)
Roman Catholic Diocese of Jamshedpur	local	জামশেদপুর এর বিশপের এলাকা (Bengali)
Roman Catholic Diocese of Khunti	local	खूंटी के सूबा
Roman Catholic Diocese of Port Blair	local	पोर्ट ब्लेयर के सूबा
Roman Catholic Diocese of Simdega	local	सिमडेगा के सूबा
Roman Catholic Diocese of Agartala	local	আগরতলা এর বিশপের এলাকা
Roman Catholic Diocese of Aizawl	local	आइजोल के सूबा
Roman Catholic Diocese of Jowai	local	जोवाई के सूबा
Roman Catholic Diocese of Neyyattinkara	local	നെയ്യാറ്റിന്കര
Roman Catholic Diocese of Alleppey	local	ആലപ്പുഴ രൂപത
Roman Catholic Diocese of Punalur	local	പുനലൂര്
Roman Catholic Diocese of Nellore	local	నెల్లూరు డియోసెస్
Roman Catholic Diocese of Vijayawada	local	విజయవాడ డియోసెస్
Roman Catholic Diocese of Srikakulam	local	శ్రీకాకుళం డియోసెస్
Roman Catholic Archdiocese of Goa and Daman	local	Goy ani Daman Mha-Dhormprant
Roman Catholic Diocese of Bongaigaon	local	बोंगईगांव के सूबा
Roman Catholic Diocese of Dibrugarh	local	डिब्रूगढ़ के सूबा
Roman Catholic Diocese of Diphu	local	दिफू के सूबा
Roman Catholic Archdiocese of Ende	local	Keuskupan Agung Ende
Roman Catholic Archdiocese of Kupang	local	Keuskupan Agung Kupang
Roman Catholic Archdiocese of Makassar	local	Keuskupan Agung Makassar
Roman Catholic Archdiocese of Medan	local	Keuskupan Agung Medan
Roman Catholic Archdiocese of Merauke	local	Keuskupan Agung Merauke
Roman Catholic Archdiocese of Palembang	local	Keuskupan Agung Palembang
Roman Catholic Archdiocese of Pontianak	local	Keuskupan Agung Pontianak
Roman Catholic Archdiocese of Samarinda	local	Keuskupan Agung Samarinda
Roman Catholic Archdiocese of Semarang	local	Keuskupan Agung Semarang
Roman Catholic Diocese of Malang	local	Keuskupan Malang
Roman Catholic Diocese of Surabaya	local	Keuskupan Surabaya
Roman Catholic Diocese of Purwokerto	local	Keuskupan Purwokerto
Roman Catholic Diocese of Denpasar	local	Keuskupan Denpasar
Roman Catholic Diocese of Larantuka	local	Keuskupan Larantuka
Roman Catholic Diocese of Ruteng	local	Keuskupan Ruteng
Roman Catholic Diocese of Bogor	local	Keuskupan Bogor
Roman Catholic Diocese of Bandung	local	Keuskupan Bandung
Roman Catholic Diocese of Atambua	local	Keuskupan Atambua
Roman Catholic Diocese of Weetebula	local	Keuskupan Weetebula
Roman Catholic Diocese of Amboina	local	Keuskupan Amboina
Roman Catholic Diocese of Manado	local	Keuskupan Manado
Roman Catholic Diocese of Padang	local	Keuskupan Padang
Roman Catholic Diocese of Sibolga	local	Keuskupan Sibolga
Roman Catholic Diocese of Pangkal-Pinang	local	Keuskupan Pangkal Pinang
Roman Catholic Diocese of Pangkal-Pinang	local	槟港天主教教区
Roman Catholic Diocese of Tanjungkarang	local	Keuskupan Tanjungkarang
Roman Catholic Diocese of Keningau	local	Keuskupan Keningau
Roman Catholic Diocese of Miri	local	Keuskupan Miri
Roman Catholic Diocese of Sibu	local	Keuskupan Sibu
Roman Catholic Diocese of Islamabad-Rawalpindi	local	اسلام آباد راولپنڈی کے کیتھولک چرچ
Roman Catholic Diocese of Faisalabad	local	فیصل آباد میں کیتھولک چرچ
Roman Catholic Diocese of Multan	local	ملتان کے کیتھولک چرچ
Roman Catholic Diocese of Hyderabad in Pakistan	local	حیدرآباد کے کیتھولک چرچ
Roman Catholic Diocese of Ilagan	local	Diyosesis ng Ilagan
Roman Catholic Diocese of Bayombong	local	Diyosesis ng Bayombong
Roman Catholic Diocese of Bayombong	local	Diocesis ti Bayombong
Roman Catholic Diocese of Cubao	local	Diyosesis ng Cubao
Roman Catholic Diocese of Antipolo	local	Diyosesis ng Antipolo
Roman Catholic Diocese of Malolos	local	Diyosesis ng Malolos
Roman Catholic Diocese of Baguio	local	Diocesis ti Baguio
Roman Catholic Diocese of Dipolog	local	Diyosesis ng Dipolog
Roman Catholic Diocese of Bangued	local	Diyosesis ti Bangued
Roman Catholic Diocese of Iligan	local	Diyosesis sa Iligan
Roman Catholic Diocese of Novaliches	local	Diyosesis ng Novaliches
Roman Catholic Diocese of Iba	local	Diyosesis ng Iba
Roman Catholic Diocese of Catarman	local	Diyosesis han Catarman
Roman Catholic Diocese of Naval	local	Diyosesis han Naval
Roman Catholic Diocese of Naval	local	Diyosesis sa Naval
Roman Catholic Diocese of Pagadian	local	Diyosesis ng Pagadian
Roman Catholic Diocese of Borongan	local	Diyosesis han Borongan
Roman Catholic Diocese of Tarlac	local	Diyosesis ning Tarlac
Roman Catholic Diocese of Tarlac	local	Diocesis ti Tarlac
Roman Catholic Diocese of Urdaneta	local	Diosis na Urdaneta
Roman Catholic Diocese of Urdaneta	local	Diocesis ti Urdaneta
Roman Catholic Diocese of Gumaca	local	Diyosesis ng Gumaca
Roman Catholic Diocese of Lucena	local	Diyosesis ng Lucena
Roman Catholic Diocese of San Jose in the Philippines	local	Diyosesis ng San Jose, Nueva Ecija
Roman Catholic Diocese of Boac	local	Diyosesis ng Boac
Roman Catholic Diocese of Cabanatuan	local	Diyosesis ng Cabanatuan
Roman Catholic Diocese of Alaminos	local	Diosis na Alaminos
Roman Catholic Diocese of Alaminos	local	Diocesis ti Alaminos
Roman Catholic Diocese of San Fernando de La Union	local	Diyosesis ng San Fernando ng Union
Roman Catholic Diocese of Agats	local	Keuskupan Agats
Roman Catholic Diocese of Jayapura	local	Keuskupan Jayapura
Roman Catholic Diocese of Manokwari–Sorong	local	Keuskupan Manokwari-Sorong
Roman Catholic Diocese of Timika	local	Keuskupan Timika
Roman Catholic Diocese of Ketapang	local	Keuskupan Ketapang
Roman Catholic Diocese of Sanggau	local	Keuskupan Sanggau
Roman Catholic Diocese of Sintang	local	Keuskupan Sintang
Roman Catholic Diocese of Banjarmasin	local	Keuskupan Banjarmasin
Roman Catholic Diocese of Palangkaraya	local	Keuskupan Pasuruan
Roman Catholic Diocese of Tanjung Selor	local	Keuskupan Tanjung Selor
Roman Catholic Diocese of San Jose de Antique	local	Diosesis kang San Jose de Antique
Roman Catholic Diocese of San Carlos	local	Diyosesis sang San Carlos
Roman Catholic Diocese of San Carlos	local	Diyosesis sa San Carlos
Roman Catholic Diocese of Kabankalan	local	Diyosesis sang Kabankalan
Roman Catholic Diocese of Tagum	local	Diyosesis ng Tagum
Roman Catholic Diocese of Mati	local	Diyosesis ng Mati
Roman Catholic Diocese of Digos	local	Diyosesis ng Digos
Roman Catholic Diocese of Bacolod	local	Diocese sang Bacolod
Roman Catholic Diocese of Marbel	local	Diyosesis sang Marbel
Roman Catholic Diocese of Kidapawan	local	Diyosesis sa Kidapawan
Roman Catholic Diocese of Kidapawan	local	Diyosesis sang Kidapawan
Roman Catholic Diocese of Romblon	local	Diyosesis ng Romblon
Roman Catholic Diocese of Maasin	local	Diyosesis sa Maasin
Roman Catholic Diocese of Dumaguete	local	Diyosesis sa Dumaguete
Roman Catholic Diocese of Kalibo	local	Diyosesis it Kalibo
Roman Catholic Diocese of Díli	local	Diocese de Díli
Roman Catholic Diocese of Baucau	local	Diocese de Baucau
Roman Catholic Diocese of Butuan	local	Diyosesis hong Butuan
Roman Catholic Diocese of Legazpi	local	Diyosesis kan Legazpi
Roman Catholic Diocese of Tandag	local	Diyosesis ng Tandag
Roman Catholic Diocese of Malaybalay	local	Diyosesis ng Malaybalay
Roman Catholic Diocese of Masbate	local	Diyosesis san Masbate
Roman Catholic Diocese of Sorsogon	local	Diyosesis kan Sorsogon
Roman Catholic Diocese of Surigao	local	Diyosesis ng Surigao
Roman Catholic Diocese of Virac	local	Diyosesis ng Virac
Roman Catholic Diocese of Libmanan	local	Diyosesis kan Libmanan
Roman Catholic Territorial Prelature of Infanta	local	Prelatura Teritoryal ng Infanta
Roman Catholic Territorial Prelature of Marawi	local	Prelatura Teritoryal ng Marawi
Roman Catholic Diocese of Ipil	local	Diocesis de Ipil
Roman Catholic Diocese of Ipil	local	Diyosesis sa Ipil
Roman Catholic Territorial Prelature of Isabela	local	Prelatura Teritoryal ng Isabela
Roman Catholic Diocese of Daet	local	Diyosesis ng Daet
Diocese of Down and Dromore	local	Deoise An Dúin agus An Droim Mór
Ancient Diocese of Viborg	local	Viborg Stift
Archdiocese of Nidaros	local	Nidaros Erkebispedømme
Ancient Diocese of the Faroe Islands	local	Færøernes Stift
Ancient Diocese of Hamar	local	Bispedømme Hamar
Roman Catholic Archdiocese of Palo	local	Arkidiyosesis han Palo
Roman Catholic Archdiocese of Palo	local	Arkidiyosesis sa Palo
Roman Catholic Diocese of Fajardo–Humacao	local	Diócesis de Fajardo–Humacao
Diocese of Tiraspol and Dubăsari	local	Eparhia de Tiraspol și Dubăsari
Diocese of Tiraspol and Dubăsari	local	Тираспольская и Дубоссарская епархия
Roman Catholic Diocese of Oslo	local	Oslo Bispedømme
Territorial Prelature of the Mission de France at Pontigny	local	Prélature territoriale de la Mission de France
Apostolic Vicariate of Istanbul	local	İstanbul Apostolik taşındi
Apostolic Vicariate of Anatolia	local	Anadolu Apostolik taşındi
Apostolic Vicariate of Benghazi	local	النيابة الرسولية بنغازي
Anglican Diocese of Egypt	local	ابروشية الكنيسة الأسقفية بمصر
Military Ordinariate of Canada	local	Ordinariat militaire du Canada
American-Canadian Macedonian Orthodox Diocese	local	(Епархија Американско Канадска)
Ukrainian Catholic Archeparchy of Ternopil–Zboriv	local	Тернопільсько-Зборівська Архиєпархія
Ukrainian Catholic Archeparchy of Ivano-Frankivsk	local	Архиєпархія з Івано-Франківська
Ruthenian Catholic Apostolic Exarchate of Czech Republic	local	Apoštolský exarchát v České republice
Apostolic Vicariate of Quetta	local	کوئٹہ کے رسولی پادری
Romanian Catholic Diocese of Maramureș	local	Eparhia de Maramureș
Romanian Catholic Eparchy of Maramureş	local	Eparhia de Maramureș
Roman Catholic Diocese of Sisak	local	Sisačka biskupija
Roman Catholic Diocese of Bjelovar-Križevci	local	Bjelovarsko-križevačka biskupija
Roman Catholic Diocese of Maliana	local	Diocese de Maliana
Italo-Albanian Catholic Church	local	Santa Maria di Grottaferrata
Military Bishopric of Argentina	local	Obispado Castrense de Argentina
Military Ordinariate of Bolivia	local	Obispado Castrense de Bolivia
Military Ordinariate of Brazil	local	Ordinariado Militar do Brasil
Military Ordinariate of Chile	local	Obispado Castrense de Chile
Military Ordinariate of Colombia	local	Obispado Castrense de Colombia
Military Ordinariate of the Dominican Republic	local	Obispado Castrense de República Dominicana
Military Ordinariate of Ecuador	local	Obispado Castrense del Ecuador
Military Ordinariate of El Salvador	local	Obispado Castrense en El Salvador
Military Ordinariate of Paraguay	local	Obispado de las Fuerzas Armadas y la Policia Nacional del Paraguay
Military Ordinariate of Peru	local	Obispado Castrense del Perú
Military Ordinariate of Venezuela	local	Ordinariato Militar de Venezuela
Military Ordinariate of Indonesia	local	Ordinariate Militer Indonesia
Military Ordinariate of Austria	local	Militärordinariat von Österreich
Military Ordinariate of Croatia	local	Vojni ordinarijat u Republici Hrvatskoj
Diocese of the French Armed Forces	local	Diocèse aux Armées Françaises
Military Ordinariate of Germany	local	Katholische Militärseelsorge
Military Ordinariate of Hungary	local	Tábori Püspökség
Military Ordinariate of Lithuania	local	Lietuvos kariuomenes ordinariatas
Military Ordinariate of Italy	local	Ordinariato Militare in Italia
Military Ordinariate of the Netherlands	local	Militair ordinariaat van Nederland
Military Ordinariate of Poland	local	Ordynariat Polowy Wojska Polskiego
Military Ordinariate of Portugal	local	Ordinariato Castrense de Portugal
Military Ordinariate of Slovakia	local	Vojenský ordinariát
Military Archbishopric of Spain	local	Arzobispado Castrense de España
Roman Catholic Diocese of Karaganda	local	Карагандинская
Roman Catholic Diocese of Laoag	local	Diocesis ti Laoag
Roman Catholic Diocese of Scala	local	Scala
Syro-Malankara Catholic Eparchy of Pathanamthitta	local	പത്തനംതിട്ട രൂപത
Chaldean Catholic Archeparchy of Amida	local	Diyarbakır'dan bir Archeparchy
Armenian Catholic Archeparchy of Istanbul	local	İstanbul Archeparchy
Eparchy of Raška and Prizren	local	Епархија рашко-призренска и косовско-метохијска
Eparchy of Raška and Prizren	local	Eparkia Rashkë - Prizren
Eparchy of Osječko polje and Baranja	local	Епархија осјечкопољска и барањска
Eparchy of Osječko polje and Baranja	local	Епархија осечкопољска и барањска
Eparchy of Osječko polje and Baranja	local	Osječkopoljska i baranjska eparhija
Roman Catholic Diocese of Roskilde	local	Roskilde Stift
Roman Catholic Territorial Prelature of Schneidemühl	local	Prälatur Schneidemühl
Roman Catholic Territorial Prelature of Schneidemühl	local	Prałatura Pilska
Roman Catholic Diocese of Sylhet	local	সিলেট এর বিশপের এলাকা
Roman Catholic Diocese of Cloyne	local	Deoise Chluana
Roman Catholic Diocese of Kalookan	local	Diyosesis ng Kalookan
Apostolic Vicariate of Puerto Princesa	local	Katoliko Romanong Diyosesis ng Puerto Princesa
Roman Catholic Diocese of Naviraí	local	Diocese de Naviraí
Territorial Abbey of Tokwon	local	천주교 덕원자치수도원구
Eparchy of Šabac	local	Шабачка епархија
Eparchy of Šabac	local	Šabačka eparhija
Archbishopric of Belgrade and Karlovci	local	Архиепископија београдско-карловачка
Diocese of Povardarie	local	(Епархија Повардарска)
Roman Catholic Territorial Prelature of Klaipėda	local	Klaipėdos prelatūra
Archdiocese of Râmnic	local	Arhiepiscopia Râmnicului
Roman Catholic Diocese of Udupi	local	उडुपी के सूबा
Syro-Malankara Catholic Eparchy of Marthandom	local	மார்த்தாண்டம் மறைமாவட்ட
Diocese of Lolland–Falster	local	Lolland–Falster Stift
Eparchy of Slavonia	local	Епархија славонска
Eparchy of Slavonia	local	Eparhija slavonska
Apostolic Vicariate of Pando	local	Vicariato Apostólico de Pando
Roman Catholic Diocese of Gómez Palacio	local	Diócesis de Gómez Palacio
Roman Catholic Diocese of Tenancingo	local	Diócesis de Tenancingo
Roman Catholic Diocese of Teotihuacan	local	Diócesis de Teotihuacan
Orthodox Archdiocese of Beirut	local	مطرانية الروم الارثودكس في بيروت
Maronite Catholic Eparchy of San Charbel in Buenos Aires	local	Eparquía de San Charbel en Buenos Aires
Roman Catholic Territorial Prelature of Esquel	local	Prelatura Territorial de Esquel
Roman Catholic Diocese of Oberá	local	Diócesis de Oberá
Apostolic Vicariate of Reyes	local	Vicariato Apostólico de Reyes
Apostolic Vicariate of Ñuflo de Chávez	local	Vicariato Apostólico de Ñuflo de Chávez
Roman Catholic Apostolic Vicariate of El Beni	local	Vicariato Apostólico de El Beni o Beni
Apostolic Vicariate of Camiri	local	Vicariato Apostólico de Camiri
Roman Catholic Diocese of Batticaloa	local	மட்டக்களப்பு மறைமாவட்டம்
Roman Catholic Diocese of Chișinău	local	Episcopia Chişinău
Cuncacestre	local	Chester-le-Street
Diocese of Birobidzhan	local	Биробиджанская и Кульдурская епархия
Diocese of Helsingør	local	HelsingørStift
Diocese of Kumanovo and Osogovo	local	Епархија Кумановско Осоговска
Diocese of Haderslev	local	Haderslev Stift
Diocese of Funen	local	Fyens Stift
Diocese of Aalborg	local	Aalborg Stift
Apostolic Administration of Estonia	local	Eesti Apostellik Administratuur
Romanian Catholic Eparchy of Bucharest	local	Eparhia Sfântul Vasile cel Mare de Bucureşti
Old Catholic Archdiocese of Utrecht	local	Aartsbisdom Utrecht
Diocese of Polog and Kumanovo	local	Епархија Полошко Кумановска
Armenian Prelacy of Canada	local	Ազգային Առաջնորդարան` Գանատայի Հայոց Թեմին
European Macedonian Orthodox Diocese	local	(Европска Епархија)
Chaldean Catholic Archeparchy of Arbil	local	إيبارشية أربيل الكلدانية
Syro-Malankara Catholic Exarchate of Khadki	local	खडकी सूबा
Syro-Malankara Catholic Eparchy of Gurgaon	local	गुड़गांव सूबा
Eparchy of Dalmatia	local	Епархија далматинска
Eparchy of Marča	local	Марчанска епархија
Diocese of Berlin and Germany	local	Berliner Diözese der Russischen Orthodoxen Kirche
Diocese of Berlin and Germany	local	Берлинская и Германская епархия Русской православной церкви
St. Paul of Thebes Church, Dharmanathapuram	local	புனித வனத்து சின்னப்பர் ஆலயம், தர்மநாதபுரம்
Metropolitanate of Dabar-Bosna	local	Митрополија Дабробосанска
Eparchy of Buda	local	Епархија будимска
Ordinariate for the Faithful of Eastern Rite in Spain	local	Ordinariato para los fieles católicos orientales en España
Eparchy of Polog and Kumanovo	local	Епархија полошко-кумановска
Metropolitanate of Skopje	local	Митрополија скопска
