Hoy	mainSettlement	Lyness
Orkney	mainSettlement	Kirkwall
Shetland	mainSettlement	Lerwick
Outer Hebrides	mainSettlement	Stornoway
Great Cumbrae	mainSettlement	Millport, Isle of Cumbrae
North Uist	mainSettlement	Lochmaddy
South Uist	mainSettlement	Lochboisdale
Benbecula	mainSettlement	Balivanich
Barra	mainSettlement	Castlebay
Raasay	mainSettlement	Inverarish
Lismore, Scotland	mainSettlement	Achnacroish
Foula	mainSettlement	Ham, Foula
Mull	mainSettlement	Tobermory, Mull
Rùm	mainSettlement	Kinloch
Gigha	mainSettlement	Ardminish
Muck, Scotland	mainSettlement	Port Mòr
Mainland, Shetland	mainSettlement	Lerwick
Mainland, Orkney	mainSettlement	Kirkwall
Eigg	mainSettlement	Cleadale
Tiree	mainSettlement	Scarinish
Coll	mainSettlement	--03-31
Yell, Shetland	mainSettlement	Mid Yell
Unst	mainSettlement	Baltasound
Papa Stour	mainSettlement	Biggings
Whalsay	mainSettlement	Symbister
Stronsay	mainSettlement	Whitehall, Orkney
Flotta	mainSettlement	Whome
Westray	mainSettlement	Pierowall
South Ronaldsay	mainSettlement	St Margaret's Hope
Shapinsay	mainSettlement	Balfour, Orkney
Northern Isles	mainSettlement	Kirkwall
Isle of Bute	mainSettlement	Rothesay, Argyll and Bute
Great Bernera	mainSettlement	Breaclete
Seil	mainSettlement	Ellenabeich
Flannan Isles	mainSettlement	Flannan Isles Lighthouse is the only habitable structure
South Walls	mainSettlement	Longhope, Orkney
Isle of Arran	mainSettlement	Brodick
Jura, Scotland	mainSettlement	Craighouse
Lewis and Harris	mainSettlement	Stornoway
Colonsay	mainSettlement	Scalasaig
Islay	mainSettlement	Port Ellen
Skye	mainSettlement	Portree
