Civil Rights Memorial	monumentName	The Civil Rights Memorial
Offa's Dyke	monumentName	Offa's Dyke
Hagia Sophia	monumentName	Hagia Sophia
Hagia Sophia	monumentName	Ayasofya
Hagia Sophia	monumentName	Ἁγία Σοφία
Hagia Sophia	monumentName	Sancta Sophia
Four Corners Monument	monumentName	Four Corners Monument
Choeung Ek	monumentName	Choeung Ek
Nelson's Column	monumentName	Nelson's Column
Galata Tower	monumentName	Galata Tower
Countess Pillar	monumentName	Countess Pillar
Grand Bazaar, Istanbul	monumentName	Grand Bazaar
St Mary's Isle	monumentName	St Mary's Isle
St Mary's Isle	monumentName	Tower of Refuge
Obelisk of Axum	monumentName	Obelisk of Axum
Voortrekker Monument	monumentName	Voortrekker Monument
Samadhi of Ranjit Singh	monumentName	Samadhi of Ranjit Singh
Monument to the People's Heroes	monumentName	Monument to
Monument to the People's Heroes	monumentName	the People's Heroes
Chiang Kai-shek Memorial Hall	monumentName	Chiang Kai-shek Memorial Hall
Sun Yat-sen Memorial Hall	monumentName	National Sun Yat-sen Memorial Hall
Old Father Time	monumentName	Father Time
Ludlow Monument	monumentName	Ludlow Monument
Montreal Botanical Garden	monumentName	Lion de la Feuillée
Canadian Tomb of the Unknown Soldier	monumentName	Tomb of the Unknown Soldier
Canadian Tomb of the Unknown Soldier	monumentName	(Tombe du Soldat Inconnu)
Christ the Redeemer	monumentName	Christ the Redeemer
Tsar Bell	monumentName	Tsar Bell
Tsar Cannon	monumentName	Tsar Cannon
Gol Gumbaz	monumentName	Gol Gumbaz
Saint-Jacques Tower	monumentName	Saint-Jacques Tower
Arch of the Sergii	monumentName	Arch of the Sergii
Georgia Guidestones	monumentName	Georgia Guidestones
Sigismund's Column	monumentName	Sigismund's Column
Christ of the Ozarks	monumentName	Christ of the Ozarks
Hermannsdenkmal	monumentName	Hermann Monument
Nizami Mausoleum	monumentName	Nizami Mausoleum
Maiden Tower	monumentName	Maiden Tower
Anıtkabir	monumentName	Anıtkabir
Catacombs of Kom el Shoqafa	monumentName	Catacombs of Kom el Shoqafa
Huguenot Monument	monumentName	Huguenot Monument
Grand Bazaar, Tehran	monumentName	Grand Bazaar
Afrikaans Language Monument	monumentName	Afrikaans Language Monument
Khojaly Massacre	monumentName	Khojaly Massacre Memorial
National War Memorial	monumentName	National War Memorial
National War Memorial	monumentName	Monument commémoratif de guerre
Republic Monument	monumentName	Republic Monument
Monument to the Battle of the Nations	monumentName	Monument to the Battle of Nations
Tomb of Anarkali	monumentName	Tomb of Anarkali
Washington Monument	monumentName	Washington Monument
Battle of Britain Monument, London	monumentName	Battle of Britain Monument
Miła 18	monumentName	Anielewicz Mound
Evil Clown of Middletown	monumentName	\
Wallace fountain	monumentName	Wallace fountains
National Law Enforcement Officers Memorial	monumentName	National Law Enforcement Officers Memorial
Monument to Minin and Pozharsky	monumentName	Monument to Minin and Pozharsky
Mount Samat National Shrine	monumentName	''Dambana ng Kagitingan
Mount Samat National Shrine	monumentName	Memorial Cross''
Our Lady of the Rockies	monumentName	Our Lady of the Rockies
Holy Trinity Column in Olomouc	monumentName	Holy Trinity Column
Terry Fox Memorial and Lookout	monumentName	Terry Fox Memorial Lookout
Victims of Communism Memorial	monumentName	Victims of Communism Memorial
Martin Luther King Jr. Memorial	monumentName	Martin Luther King Jr. Memorial
Golden Driller	monumentName	Golden Driller
Peter I Monument in Taganrog	monumentName	Peter the Great Monument
Rhodes Memorial	monumentName	Rhodes Memorial
Tanjung Simpang Mengayau	monumentName	Bronze Globe of Tanjung Simpang Mengayau
Three-Country Cairn	monumentName	Three-Country Cairn
Nagasaki Peace Park	monumentName	Nagasaki Peace Park
Peacekeeping Monument	monumentName	Peacekeeping Monument
Momine Khatun Mausoleum	monumentName	Momine Khatun Mausoleum
Khamis Mosque	monumentName	Al Khamis Mosque
Forest of the Martyrs	monumentName	Forest of the Martyrs
Vršac Castle	monumentName	Vršac Castle
Brock's Monument	monumentName	Brock's Monument
Georgetown Cenotaph	monumentName	Georgetown Cenotaph
Sea Wall, Guyana	monumentName	Sea Wall
Monument to Nicholas I	monumentName	Monument to Nicholas I
Mały Powstaniec	monumentName	The Little Insurrectionist
Clock Tower, Faisalabad	monumentName	Faisalabad clock tower
Sheboygan Hmong Memorial	monumentName	Lao, Hmong and American Veterans Memorial
Hanuman Junction	monumentName	Abhaya Anjaneya Swamy
Garibaldi Monument in Taganrog	monumentName	Garibaldi Monument
The Keeper of the Plains	monumentName	The Keeper of the Plains
Monument of Liberty, Ruse	monumentName	Monument of Liberty
Korean War Memorial Wall	monumentName	Korean War Memorial
Old City Hall Cenotaph, Toronto	monumentName	Toronto Cenotaph
Mémorial des Martyrs de la Déportation	monumentName	Mémorial des Martyrs de la Déportation
Yad Kennedy	monumentName	John F. Kennedy Memorial
Fort Moore	monumentName	Fort Moore Pioneer Memorial
Sverd i fjell	monumentName	Sverd i fjell
Ontario Veterans Memorial	monumentName	Ontario Veterans Memorial
South African War Memorial	monumentName	South African War Memorial
Shot at Dawn Memorial	monumentName	Shot at Dawn Memorial
1820 Settlers National Monument	monumentName	1820
Monumento al Jíbaro Puertorriqueño	monumentName	Monumento al Jíbaro Puertorriqueño
Bismarck Monument	monumentName	Bismarck monument
Wat's Dyke	monumentName	Wat's Dyke
Dewey Arch	monumentName	Dewey Triumphal Arch and Colonnade
Thiruvalluvar Statue	monumentName	Thiruvalluvar Statue
Lateran Obelisk	monumentName	Lateran Obelisk
Monument of Liberty, Istanbul	monumentName	Monument of Liberty, Istanbul
Monumento de Santiago	monumentName	Monument to the Heroes of the Restoration
Fountain of Neptune, Bologna	monumentName	Fountain of Neptune
Barabati fort	monumentName	Barabati Fort
Barabati fort	monumentName	ବାରବାଟି ଦୁର୍ଗ
The North Wall	monumentName	The North Wall
Guan Yin of the South Sea of Sanya	monumentName	Guanyin of the South Sea of Sanya
Petagas War Memorial	monumentName	Petagas War Memorial Garden
Ahu Akivi	monumentName	Ahu Akivi
Dr. William D. Young Memorial	monumentName	Dr. William D. Young Memorial
Wild Bill Hickok Memorial	monumentName	Wild Bill Hickok Memorial
Çanakkale Martyrs' Memorial	monumentName	Çanakkale Martyrs' Memorial
National Women's Monument	monumentName	Women's Memorial, Monument Road, Bloemfontein
White Horse at Ebbsfleet	monumentName	The White Horse at Ebbsfleet
Rizal Monument	monumentName	Rizal Monument
Mausoleum of Ruhollah Khomeini	monumentName	Harame Motahar
Mingun Bell	monumentName	Mingun Bell
Jam Gadang	monumentName	Jam Gadang
Temple of Augustus, Pula	monumentName	Temple of Augustus
Chekhov Monument in Taganrog	monumentName	Chekhov Monument in Taganrog
Double Six Monument	monumentName	Double Six Monument
Obelisk of São Paulo	monumentName	Obelisk of São Paulo
Mount Royal Cross	monumentName	Mount Royal Cross
People's Friendship Arch	monumentName	Friendship of Nations Arch
Spring Temple Buddha	monumentName	Spring Temple Buddha
Great Bell of Dhammazedi	monumentName	Great Bell of Dhammazedi
Prince Henry the Navigator	monumentName	Prince Henry the Navigator
Kentucky Medal of Honor Memorial	monumentName	Kentucky Medal of Honor Memorial
Tomb of Sher Shah Suri	monumentName	Sher Shah Suri Tomb
Crazy Horse Memorial	monumentName	Crazy Horse Memorial
Montreal Clock Tower	monumentName	Montreal Clock Tower
Alexander I Statue in Taganrog	monumentName	Monument to Alexander I
Prince Alfred's Guard Memorial	monumentName	Prince Alfred's Guard Memorial
Shaka Memorial	monumentName	Shaka Memorial
Horse Memorial	monumentName	Horse Memorial
Mazor Mausoleum	monumentName	Mazor Mausoleum
Dharan clock tower	monumentName	Dharan clock tower
Coventry Cross	monumentName	Coventry Cross
Alley of Classics, Chișinău	monumentName	The Alley of Classics
Tomb of Caecilia Metella	monumentName	Tomb of Caecilia Metella
Ramagrama stupa	monumentName	Rāmagrāma
Samora Machel Monument	monumentName	Samora Machel Monument
Taras Shevchenko Memorial	monumentName	Taras Shevchenko Memorial
Tomb of Hafez	monumentName	Hafeziyeh
Genghis Khan Equestrian Statue	monumentName	Genghis Khan Equestrian Statue
Zebrnjak	monumentName	Zebrnjak
Cathedral of Kars	monumentName	Kars Cathedral
Newkirk Viaduct Monument	monumentName	Newkirk Viaduct Monument
Nelson's Column, Montreal	monumentName	Nelson's Column
Khojaly massacre memorials	monumentName	Khojaly Massacre Memorial
Royal Monastery of Brou	monumentName	Royal Monastery of Brou
Monument to Chocolate	monumentName	Monument to Chocolate
Millennium Monument of Brest	monumentName	Brest Millennium Monument
Monument to Sergei Yesenin in St. Petersburg	monumentName	Monument to Sergei Yesenin
Urasoe yōdore	monumentName	Urasoe yōdore
Maisonneuve Monument	monumentName	Maisonneuve Monument
Roddick Gates	monumentName	Roddick Gates
Macdonald Monument	monumentName	Macdonald Monument
Boer War Memorial	monumentName	Boer War Memorial
Nicolaus Copernicus Monument, Warsaw	monumentName	Nicolaus Copernicus Monument
John Young Monument	monumentName	John Young Monument
George-Étienne Cartier Monument	monumentName	Sir George-Étienne Cartier Monument
Robert Burns Memorial	monumentName	Robert Burns Memorial
Edward VII Monument	monumentName	Edward VII Monument
Ranevskaya Monument	monumentName	Monument to Faina Ranevskaya
Ignace Bourget Monument	monumentName	Ignace Bourget Monument
Victoria Memorial	monumentName	Monument to Queen Victoria
Wilfrid Laurier Memorial	monumentName	Wilfrid Laurier Memorial
Aquae Iasae	monumentName	Aquae Iasae
Monument aux braves de N.D.G.	monumentName	Monument aux braves de Notre-Dame-de-Grâce
Fermière Monument	monumentName	La Fermière Monument
Dante Monument	monumentName	Dante Monument
Les petits Baigneurs	monumentName	Les petits Baigneurs
Jeanne Mance Monument	monumentName	Jeanne Mance Monument
Cenotaph	monumentName	Cenotaph
African Renaissance Monument	monumentName	African Renaissance Monument
Pioneers' Obelisk	monumentName	Pioneers' Obelisk
Vojinović Bridge	monumentName	Vojinović Bridge
Stephen the Great Monument	monumentName	Stephen the Great Monument
Triumphal arch, Chișinău	monumentName	Triumphal arch
Louis Cyr Monument	monumentName	Louis Cyr Monument
Capitoline Wolf, Chișinău	monumentName	Capitoline Wolf
War Memorial of Montreal West	monumentName	War Memorial of Montreal West
Despot Stefan Lazarević Memorial	monumentName	Monument to Despot Stefan Lazarević
Mihai Eminescu Statue, Montreal	monumentName	Mihai Eminescu Statue
Marie-Victorin Statue	monumentName	Marie-Victorin Statue
Skanderbeg Monument	monumentName	Skanderbeg Monument
Black Ćuprija	monumentName	Black Ćuprija
Monument of Liberty, Chișinău	monumentName	Monument of Liberty
Commando Memorial	monumentName	Commando Memorial
World Cup Sculpture	monumentName	The World Cup Sculpture
World Cup Sculpture	monumentName	The Champions
Statue of Bobby Moore, Wembley	monumentName	Bobby Moore Sculpture
Fontaine du Palmier	monumentName	Fountain of the Palm
Thanksgiving Candle	monumentName	Thanksgiving Candle
Rudi Geodetic Point	monumentName	Rudi Geodetic Point
The Boilermaker	monumentName	The Boilermaker
Goddess of Democracy	monumentName	Goddess of Democracy
Tomb of Payava	monumentName	The tomb of Payava
Transfiguration Cathedral in Odessa	monumentName	Transfiguration Cathedral in Odessa
Monument to the Victims of the Soviet Occupation	monumentName	Monument to the Victims of the Soviet Occupation
Admiral David G. Farragut	monumentName	Admiral David G. Farragut
Memorial to Victims of Stalinist Repression	monumentName	Memorial to Victims of Stalinist repression
Memorial to the People Killed by Bolsheviks	monumentName	Memorial to the people killed by Bolsheviks
Alley of Classics, Bălți	monumentName	The Alley of Classics
Major General John A. Logan	monumentName	Major General John A. Logan
Monument to Simion Murafa, Alexei Mateevici and Andrei Hodorogea	monumentName	Monument to Simion Murafa, Alexei Mateevici and Andrei Hodorogea
Adam Mickiewicz Monument, Warsaw	monumentName	Adam Mickiewicz Monument
Aviation Martyrs' Monument	monumentName	Aviation Martyrs' Monument
Aviation Martyrs' Monument	monumentName	Hava Şehitleri Anıtı
Aviation Martyrs' Monument	monumentName	(formerly) Tayyare Şehitleri Abidesi
Cross of All Nations	monumentName	Cross of All Nations
Thanjavur Maratha Palace	monumentName	Thanjavur Maratha Palace
John the Baptist Monument	monumentName	John the Baptist Monument
Sendai Daikannon	monumentName	Sendai Daikannon
Castillo de San Andrés	monumentName	Castillo de San Andrés
General Philip Sheridan	monumentName	General Philip Sheridan
Harvard Bixi	monumentName	Harvard's Chinese Stele
Askari Monument	monumentName	Askari Monument
Emperors Yan and Huang	monumentName	Emperors Yan and Huang
Secunderabad Clock Tower	monumentName	Secunderabad Clock Tower
Secunderabad Clock Tower	monumentName	సికింద్రాబాద్ క్లోక్  టవర్
George Gordon Meade Memorial	monumentName	George Gordon Meade Memorial
Keningau Oath Stone	monumentName	Keningau Oath Stone
Los Angeles Police Department Memorial for Fallen Officers	monumentName	LAPD Memorial to Fallen Officers
Red Basilica	monumentName	Red Basilica
Liberation	monumentName	Liberation
Hôtel de Blossac	monumentName	Hôtel de Blossac
National Monument	monumentName	National Monument
Esperanza Stone	monumentName	Esperanza Stone
Sun Yat-sen Memorial Hall	monumentName	Sun Yat-sen Memorial Hall
The Shot in the Back	monumentName	The Shot in the Back
Memorial for the victims killed by OUN-UPA	monumentName	Memorial for the victims killed by OUN-UPA
Paritala Anjaneya Temple	monumentName	Paritala Anjaneya Temple
Guishan Guanyin of the Thousand Hands and Eyes	monumentName	Guishan Guanyin of the Thousand Hands and Eyes
Great Buddha of Thailand	monumentName	Great Buddha of Thailand
Guanyin of the South China Sea, Mount Xiqiao	monumentName	Guanyin of the South China Sea, Mount Xiqiao
Major General George B. McClellan	monumentName	Major General George B. McClellan
Major General George Henry Thomas	monumentName	Major General George Henry Thomas
Brevet Lt. General Winfield Scott	monumentName	Brevet Lt. General Winfield Scott
Dupont Circle Fountain	monumentName	Dupont Circle Fountain
Monument du 22 Novembre 1970, Conakry	monumentName	Monument du 22 Novembre 1970
Garden of the Missing in Action	monumentName	Garden of the Missing in Action
Victims of Acts of Terror Memorial	monumentName	Victims of Acts of Terror Memorial in Israel
General John A. Rawlins	monumentName	General John A. Rawlins
Pelican Pete	monumentName	Pelican Pete
Mao Zedong Statue	monumentName	Mao Zedong Statue, Chengdu
Greek Memorial, Dhaka	monumentName	Greek Memorial
Stephenson Grand Army of the Republic Memorial	monumentName	Stephenson Grand Army of the Republic Memorial
Brigadier General Albert Pike	monumentName	Brigadier General Albert Pike
Tomb of National Heroes	monumentName	Tomb of National Heroes
Garrick's Temple to Shakespeare	monumentName	Garrick's Temple to Shakespeare
Camphill Column, Alnwick	monumentName	Camphill Column
Monument to Alfonso XII	monumentName	Monument to Alfonso XII of Spain
Dead Man's Plack	monumentName	Dead Man's Plack
Yar Muhammad Kalhoro	monumentName	ميان يار محمد ڪلهوڙو
Italians of Ethiopia	monumentName	Obelisk of Axum
De Viron Castle	monumentName	de Viron Castle
Alyosha Monument, Murmansk	monumentName	Defenders of the Soviet Arctic during the Great Patriotic War
Samuel Hahnemann Monument	monumentName	Samuel Hahnemann Monument
Château de Fondat	monumentName	Château de Fondat
Bhasha Smritistambha	monumentName	Bhasha Smritistambha
Billionth Barrel Monument	monumentName	Billionth Barrel Monument
Wesselényi Monument	monumentName	Wesselényi Monument
Matthias Corvinus Monument	monumentName	Matthias Corvinus Monument
Tuhutum Monument	monumentName	Tuhutum Monument
Holy Trinity Statue, Șimleu Silvaniei	monumentName	Holy Trinity Statue
Union Monument, Târgu Lăpuș	monumentName	Union Monument
Monumental Clock of Pachuca	monumentName	Monumental Clock of Pachuca
Lord Murugan Statue	monumentName	Lord Murugan Statue
Romanian People's Salvation Cross	monumentName	Romanian People's Salvation Cross
Liberation Tower, Bessarabia	monumentName	Liberation Tower, Bessarabia
Kailashnath Mahadev Statue	monumentName	Kailashnath Mahadev
Prussian National Monument for the Liberation Wars	monumentName	National Monument for the Liberation Wars
Gamigaya Petroglyphs	monumentName	Gamigaya Petroglyphs
Damjili Cave	monumentName	Damjili Cave
Victims of Iași Pogrom Monument	monumentName	Victims of Iaşi Pogrom Monument
Yusif ibn Kuseyir Mausoleum	monumentName	Yusif ibn Kuseyir Mausoleum
Ramana Tower	monumentName	Ramana Tower
Haji Gayib’s bathhouse	monumentName	Haji Gayib’s bathhouse
Estela de Luz	monumentName	Estela de Luz
Bromley War Memorial	monumentName	Bromley War Memorial
Bromley Parish Church Memorial	monumentName	Bromley Parish Church Memorial
Monument Indië-Nederland	monumentName	Monument Indië-Nederland
Livesey Hall War Memorial	monumentName	Livesey Hall War Memorial
Shirvanshahs’ bath houses	monumentName	Shirvanshahs’ bath houses
Garabaghlar Mausoleum	monumentName	Garabaghlar Mausoleum
Chatam Sofer Memorial	monumentName	Chatam Sofer Memorial
Pir Khidir Zinda	monumentName	Pir Khidir Zinda
Raibania fort	monumentName	Raibania fort
Mammadbayli Mausoleum	monumentName	Mammadbayli Mausoleum
Khachin-Turbatli Mausoleum	monumentName	Mausoleum in Khachin-Turbetli village
Atkinson Clock Tower	monumentName	Atkinson Clock Tower
Sheykh Babi Yagub Mausoleum	monumentName	Sheykh Babi Yagub Mausoleum
Diri Baba Mausoleum	monumentName	Diri Baba Mausoleum
Zar Cave	monumentName	Zar Cave
Tağlar Cave	monumentName	Tağlar Cave
Butt-Millet Memorial Fountain	monumentName	Butt-Millet Memorial Fountain
Historical-ethnographic museum of Khinalug village	monumentName	Historical-ethnographic museum of Khinalug village
Firoz Shah Palace Complex	monumentName	Gujri Mahal
Mausoleum of Sheikh Juneyd	monumentName	Mausoleum of Sheikh Juneyd
Allahabad pillar	monumentName	Allahabad Pillar
Papravand Mausoleum	monumentName	Papravand Mausoleum
Monument to Mirza Alakbar Sabir	monumentName	Monument to Mirza Alakbar Sabir
Monument to Nizami Ganjavi in Baku	monumentName	Monument to Nizami Ganjavi
Monument to Michael the Brave, Guruslău	monumentName	Monument to Michael the Brave
Hail to the Sunrise Statue	monumentName	Hail to the Sunrise
Juma Mosque, Nakhchivan	monumentName	Juma Mosque of Nakhchivan
Mirali Mausoleum	monumentName	Mirali Mausoleum
Akhsadan Baba Mausoleum	monumentName	Akhsadan Baba Mausoleum
Monument to Endre Ady, Zalău	monumentName	Monument to Endre Ady
Kachaghakaberd	monumentName	Kachaghakaberd
Baku Funicular	monumentName	Baku Funicular
American War Memorial, Gibraltar	monumentName	Naval Monument at Gibraltar
Pointe-Claire Windmill	monumentName	Pointe-Claire Windmill
Trenton Cenotaph	monumentName	Trenton Cenotaph
Gibraltar War Memorial	monumentName	Gibraltar War Memorial
Gates of Ganja	monumentName	Gates of Ganja
Gibraltar Cross of Sacrifice	monumentName	Gibraltar Cross of Sacrifice
Bolesław III Wrymouth Monument in Płock	monumentName	Bolesław III the Wrymouthed Monument in Płock
Basilica in Qum village	monumentName	Basilica in Qum village
Union Soldiers and Sailors Monument	monumentName	Union Soldiers and Sailors Monument
Ahmadalilar Mausoleum	monumentName	Ahmadalilar Mausoleum
Garakopaktapa	monumentName	Garakopaktapa
Valdivieso advertising sign	monumentName	Valdivieso advertising sign
Monarch advertising sign	monumentName	Monarcho advertising sign
Japanese Lantern Monument	monumentName	Japanese Lantern Monument
Cecil John Rhodes Statue	monumentName	Cecil John Rhodes Statue
Gulustan Mausoleum	monumentName	Gulustan Mausoleum
Artillery Memorial, Cape Town	monumentName	Artillery Memorial
Buzeyir cave	monumentName	Buzeyir cave
Mausoleum of Huseyn Javid	monumentName	Huseyn Javid Mausoleum
National Katyń Memorial	monumentName	National Katyń Memorial
Sir Wilfrid Laurier Park	monumentName	Monument to Queen Isabella
Saint Henri Square	monumentName	Jacques Cartier Monument
South African War Memorial	monumentName	South African War Memorial
Lone Tree Monument	monumentName	Lone Tree Monument
Monument of Sokołowo	monumentName	Monument of Sokołowo
Noah’s Mausoleum	monumentName	Noah’s Mausoleum
Monument to Nizami Ganjavi in Saint Petersburg	monumentName	Monument to Nizami Ganjavi in Saint Petersburg
Monument to Garibaldi	monumentName	Monument to Garibaldi
Monument to Nizami Ganjavi in Rome	monumentName	Monument to Nizami Ganjavi in Rome
Vimoutiers Tiger tank	monumentName	Vimoutiers Tiger tank
Monument to Nizami Ganjavi in Chișinău	monumentName	Monument to Nizami Ganjavi in Chișinău
Monument to Nizami Ganjavi in Tashkent	monumentName	Monument to Nizami Ganjavi in Tashkent
Monument to Nizami Ganjavi in Beijing	monumentName	Monument to Nizami Ganjavi in Beijing
Allar Cave	monumentName	Allar Cave
Warsaw Ghetto boundary markers	monumentName	Warsaw Ghetto boundary markers
Houston Police Officer's Memorial	monumentName	Houston Police Officer Memorial
Dewey Monument	monumentName	Dewey Monument
Imamzadeh	monumentName	Imamzadeh Mausoleum
Barda Mausoleum	monumentName	Barda Mausoleum
Star of Caledonia	monumentName	Star of Caledonia
Juma Mosque, Ordubad	monumentName	Juma Mosque in Ordubad
Imamzadeh complex in Nakhchivan	monumentName	Imamzadeh complex
Gilahli Mosque in Sheki	monumentName	Gilahli Mosque in Shaki
Juma Mosque in Sheki	monumentName	Juma Mosque in Sheki
Shwezigon Pagoda Bell	monumentName	Shwezigon Pagoda Bell
Indio Comahue Monument	monumentName	Monument to the Comahue Indian
Garghabazar Mosque	monumentName	Garghabazar Mosque
Garghabazar Caravanserai	monumentName	Kargabazar caravanserai
Kirna mausoleum	monumentName	Kirna Mausoleum
Yeddi Gumbaz mausoleum	monumentName	Yeddi Gumbaz mausoleum
Khanegah tomb	monumentName	Khanegah tomb
Ambedkar Manimandapam, Chennai	monumentName	Ambedkar Memorial
Castle of Capdepera	monumentName	The Castle of Capdepera
Monumento a la abolición de la esclavitud	monumentName	Monumento a la abolición de la esclavitud
Monumento a los heroes de El Polvorín	monumentName	Monumento a los heroes de El Polvorín
Monumento a los heroes de El Polvorín	monumentName	Monumento a los heroes de El Polvorín
Weather Machine	monumentName	Weather Machine
Ramavarma Appan Thampuran Memorial	monumentName	Ramavarma Appan Thampuran Memorial
Kandy Clock Tower	monumentName	Kandy Clock Tower
Memorial Route of Jewish Martyrdom and Struggle in Warsaw	monumentName	Memorial Route of Jewish Martyrdom and Struggle in Warsaw
Monument of Jews and Poles Common Martyrdom in Warsaw	monumentName	Monument of Jews and Poles Common Martyrdom in Warsaw
Ronald Reagan Monument	monumentName	Ronald Reagan Monument
Napoleon Bonaparte Monument	monumentName	Napoleon Bonaparte Monument
Monument in Memory of the Fallen Polish Pilots in World War II	monumentName	Monument in Memory of the Fallen Polish Airmen in WWII
Namantar Shahid Smarak	monumentName	Namantar Shahid Smarak
Permyak Salty Ears	monumentName	Permyak salty ears
Józef Piłsudski Monument, Warsaw	monumentName	Józef Piłsudski Monument
Electio Viritim Monument	monumentName	Electio Viritim Monument
Monument to Ferdinand I	monumentName	Monument to Ferdinand I
Sikorski Memorial	monumentName	Sikorski Memorial, Gibraltar
Hyde Park Holocaust memorial	monumentName	Hyde Park Holocaust Memorial
Tower of Gourze	monumentName	Tower of Gourze
Pioneer Monument	monumentName	Pioneer Monument
Berlin Wall Monument	monumentName	Berlin Wall Monument
Villa Le Trident	monumentName	Villa Le Trident
Château de l'Horizon	monumentName	Château de l’Horizon
Villa La Reine Jeanne	monumentName	Villa La Reine Jeanne
Villa La Mauresque	monumentName	Villa La Mauresque
Villa Aujourd’hui	monumentName	Villa Aujourd’hui
Chaitya Bhoomi	monumentName	Chaitya Bhoomi
Batticaloa Gate	monumentName	Batticaloa Gate
St. Jago's Arch	monumentName	St. Jago's Arch
Parents of Murdered Children Memorial	monumentName	Parents of Murdered Children Memorial
Roman Dmowski Monument, Warsaw	monumentName	Roman Dmowski Monument
Baku Turkish Martyrs' Memorial	monumentName	Baku Turkish Martyrs' Memorial
Nadan Mahal	monumentName	Nadan Mahal
Willy Brandt Monument	monumentName	Willy Brandt Monument in Warsaw
Long Live the Victory of Mao Zedong Thought	monumentName	Long Live the Victory of Mao Zedong Thought
Arch of Campanus	monumentName	Arch of Campanus
Waltham Forest Town Hall	monumentName	Waltham Forest Town Hall
Handaberd	monumentName	Handaberd
Maison Coilliot	monumentName	Coilliot House
Kumanovo Clock Tower	monumentName	Kumanovo Clock Tower
11 Living Memorial Plaza	monumentName	9
Abraham Lincoln	monumentName	Abraham Lincoln
Lifeboat Memorial, Lytham	monumentName	Lifeboat Memorial, Lytham
Lifeboat Monument, St Annes	monumentName	Lifeboat Monument, St Annes
11 Memorial Garden	monumentName	Beverly Hills 9/11 Memorial Garden
Monument to the Heroes of Warsaw	monumentName	Monument to the Heroes of Warsaw
Great Hamam of Pristina	monumentName	The great hamam of Prishina
Stefan Starzyński Monument	monumentName	Stefan Starzyński monument
Monument to the Fallen and Murdered in the East	monumentName	Monument to the Fallen and Murdered in the East
Monument to Victims of the Wola Massacre	monumentName	Monument to Victims of the Wola Massacre
Youth Mao Zedong Statue	monumentName	Youth Mao Zedong Statue
Warsaw Uprising Monument	monumentName	Warsaw Uprising Monument
Mint Clock Tower, Chennai	monumentName	Mint Clock Tower
Singu Min Bell	monumentName	Singu Min Bell
Tharrawaddy Min Bell	monumentName	Tharrawaddy Min Bell
Barrière d’Enfer	monumentName	Gate of Hell
Mansu Hill Grand Monument	monumentName	Mansudae Grand Monument
Monument to the Liberator Soldier	monumentName	Monument to the Liberator Soldier
Polish Cavalry Monument	monumentName	Polish Cavalry Monument
Gwalior Monument	monumentName	Gwalior Monument, Kolkata     গোয়ালিয়র স্মৃতি-সৌধ
Statue of Michael Jackson	monumentName	Michael Jackson Statue
Kościuszko Infantry Division Memorial	monumentName	Kościuszko Infantry Division Memorial
Monument to the Volhynia 27th Home Army Infantry Division	monumentName	Monument to the Volhynia 27th Home Army Infantry Division
Avro Anson Memorial	monumentName	Avro Anson Memorial
William Wakefield Memorial	monumentName	William Wakefield Memorial
First José Rizal Monument	monumentName	First José Rizal Monument
Statue of Mahatma Gandhi, Gandhi Maidan	monumentName	Statue of Gandhi
Queen Isabel II Statue	monumentName	Queen Isabel II Monument
Bonifacio Monument	monumentName	Bonifacio Monument
Calamba Claypot	monumentName	CALAMBANGA
Khojaly Genocide Memorial	monumentName	Khojaly Genocide Memorial
Monument to Salavat Yulaev	monumentName	Monument to Salavat Yulaev
Russia-Bashkir Monument of Friendship	monumentName	The Russia-Bashkir Monument of Friendship
Cristo Rey	monumentName	Cristo Rey
Monument to Zagir Ismagilov	monumentName	Monument to Zagir Ismagilov
Monument to the heroes of the October Revolution and the Civil War	monumentName	Monument to the heroes of the October Revolution and the Civil War
Monument to Felix Dzerzhinsky	monumentName	Monument to Felix Dzerzhinsky
Rizal Monument	monumentName	José Rizal Monument in Calamba
Khojaly Genocide Memorial	monumentName	Khojaly Genocide Memorial
Cristo del Otero	monumentName	Cristo del Otero
Diana the Huntress Fountain	monumentName	Diana the Huntress Fountain
Maha Kavi Moyinkutty Vaidyar Smaraka	monumentName	Maha Kavi Moyinkutty Vaidyar Smarakam
Monument of Sivrihisar Airplane	monumentName	Monument of Sivrihisar Airplane
Blantyre Monument	monumentName	Blantyre Monument
Independence Flagstaff	monumentName	Independence Flagstaff
Respect to Mehmetçik Monument	monumentName	Respect to Mehmetçik Monument
Atatürk Monument	monumentName	Atatürk Monument
Victory Monument	monumentName	Victory Monument
Atatürk Monument	monumentName	Atatürk Monument
Statue of Honor	monumentName	Statue of Honor
Flame of Hope	monumentName	Flame of Hope
San Martín Monument, Neuquén	monumentName	General San Martín Monument
Vinnytsia water tower	monumentName	Vinnytsia old Water Tower
Husainabad Clock Tower	monumentName	Hussainabad Clock Tower
Mehmetçik Monument	monumentName	Mehmetçik Monument
Cádiz Memorial	monumentName	Cádiz Memorial
February One	monumentName	February One
Battle of Otlukbeli Martyrs' Monument	monumentName	Battle of Otlukbeli Martyrs' Monument
Royal Naval Division Memorial	monumentName	Royal Naval Division Memorial
Freedom Monument, Bydgoszcz	monumentName	Freedom Monument
Deluge Fountain	monumentName	\
Westinghouse Memorial	monumentName	Westinghouse Memorial
Edith Cavell Memorial	monumentName	Edith Cavell Memorial
North Borneo War Monument	monumentName	North Borneo War Monument
Kundasang War Memorial	monumentName	Kundasang War Memorial
Queen Victoria Memorial, Lancaster	monumentName	Queen Victoria Memorial
Monument to the Battle of Monte Cassino in Warsaw	monumentName	Monument to the Battle of Monte Cassino in Warsaw
Tiger 131	monumentName	Tiger 131
Chinnakada Clock Tower	monumentName	Chinnakada Clock Tower
Convento de los Agustinos	monumentName	Convento de los Agustinos
Hargeisa War Memorial	monumentName	Hargeisa War Memorial
Monument to the Polish Underground State and Home Army	monumentName	Monument to the Polish Underground State and Home Army
Canberra Centenary Column	monumentName	Canberra Centenary Column
Monument to Cuauhtémoc	monumentName	Monument to Cuauhtémoc
Monument to Prince Józef Poniatowski in Warsaw	monumentName	Monument to Prince Józef Poniatowski in Warsaw
Mémorial de la France combattante	monumentName	Mémorial de la France combattante
Chartreuse du Liget	monumentName	Chartreuse of Liget
The Founders of the Daughters of the American Revolution	monumentName	The Founders of the Daughters of the American Revolution
Bali Bombings Memorial, London	monumentName	Bali Bombings Memorial
Starcevich Monument	monumentName	Starcevich Monument
Chartered Company Monument	monumentName	Chartered Company Monument
Sandakan War Monument	monumentName	Sandakan War Monument
Sangiliyan Statue	monumentName	Sangiliyan Statue
William Pryer Monument	monumentName	William Pryer Monument
Quailey's Hill Memorial	monumentName	Quailey's Hill Memorial
Sandakan Massacre Memorial	monumentName	Sandakan Massacre Memorial
Cho Huan Lai Memorial	monumentName	Cho Huan Lai Memorial
Tawau Japanese War Memorial	monumentName	Tawau Japanese War Memorial
De Fontaine Memorial	monumentName	De Fontaine Memorial
Nelsonville Cross	monumentName	Nelsonville Cross
Sandakan Memorial Park	monumentName	Sandakan Memorial Park
Last POW Camp Memorial	monumentName	Last POW Camp Memorial
Kushimoto Turkish Memorial and Museum	monumentName	Kushimoto Turkish Memorial and Museum
Morley War Memorial, Scatcherd Park	monumentName	Morley War Memorial, Scatcherd Park
Loyalty	monumentName	Loyalty
Monument to Commemorate Chinese Victims of the Atomic Bombing	monumentName	Monument to Commemorate Chinese Victims of the Atomic Bombing
Fort Saint-Elme	monumentName	Fort Saint-Elme
Chetiri Bandere Monument	monumentName	Chetiri Bandere Monument
The Bull of Navan	monumentName	The Bull
Statue of Lenin in Berdichev	monumentName	Statue of Lenin in Berdichev
Statue of Lenin in Bila Tserkva	monumentName	Statue of Lenin in Bila Tserkva
Statue of Lenin in Kharkiv	monumentName	Statue of Lenin in Kharkiv
Monument of the Great October Revolution	monumentName	Monument of the Great October Revolution
Site John McCrae	monumentName	Site John McCrae
Treaty of Lausanne Monument and Museum	monumentName	Treaty of Lausanne Monument
Hill 60	monumentName	Hill 60
Sacred Heart of Jesus	monumentName	Sacred Heart of Jesus
Torre da TV Bandeirantes	monumentName	Torre Maria Helena Mendes de Barros Saad
Virajpet Clock Tower	monumentName	Virajpet Clock Tower
Marché en Fer	monumentName	Iron Market
Cristo Rei, Madeira	monumentName	Cristo Rei
Odeillo solar furnace	monumentName	Odeillo solar furnace
Kurunegala Clock Tower	monumentName	Kurunegala Clock Tower
Chris Hani Memorial	monumentName	Chris Hani Monument
Gumbaz, Srirangapatna	monumentName	Gumbaz
Woolwich Town Hall	monumentName	Woolwich Town Hall
Mersin Martyrs' Memorial	monumentName	Mersin Martyrs' Memorial
Jesus de Greatest	monumentName	Jesus de Greatest
Birth of the New World	monumentName	Birth of the New World
Torana Gate, Malaysia	monumentName	Torana Gate
Le Marron Inconnu	monumentName	Le Marron Inconnu
Le Marron Inconnu	monumentName	The Unknown Slave
Ali Amjad's Clock	monumentName	Ali Amjad's Clock
Pegasus and Dragon	monumentName	Pegasus and Dragon
Bantayog ng mga Bayani Center	monumentName	Bantayog ng mga Bayani Center
Anti-Air War Memorial	monumentName	Anti-Air War Memorial
Kandawmin Garden Mausolea	monumentName	Kandawmin Garden Mausolea
Perry Monument	monumentName	Commodore Oliver Hazard Perry Monument
Tomb of Saadi	monumentName	Tomb of Saadi
Monument to the Allies in Dębina Zakrzowska	monumentName	Monument of Allies in Dębina Zakrzowska, Poland
Statue of the Sentinel of Freedom	monumentName	Statue of the Sentinel of Freedom
Tomb of Hayreddin Barbarossa	monumentName	Tomb of Hayreddin Barbarossa
Statue of Parashurama	monumentName	Parashurama Statue
Golden Warrior Monument	monumentName	Golden Warrior Monument
Dai Kannon of Kita no Miyako park	monumentName	Dai Kannon of Kita no Miyako park
Martyrs' Mausoleum	monumentName	Martyrs' Mausoleum
Atatürk and Şerife Bacı Monument	monumentName	Atatürk and Şerife Bacı Monument
Quezon Memorial Shrine	monumentName	Quezon Memorial Shrine
Tomb of Dai Anga	monumentName	Tomb of Dai Anga
Castillo de Colomares	monumentName	Castillo de Colomares
Dignity	monumentName	Dignity
Bismarck monument	monumentName	Bismarck monument
Haikou Clock Tower	monumentName	Haikou Clock Tower
King Zog	monumentName	King Zog's statue
Terreiro da Luta	monumentName	Terreiro da Luta
