Crandall University	mottoeng	Christ First
Acadia University	mottoeng	\
Brown University	mottoeng	In God We Hope
Barnard College	mottoeng	Following the Way of Reason
Bob Jones University	mottoeng	We seek, we trust
Chalmers University of Technology	mottoeng	Advance
Columbia University	mottoeng	In Thy light shall we see light
Dartmouth College	mottoeng	A voice crying out in the wilderness
Dalhousie University	mottoeng	Pray and work
Eindhoven University of Technology	mottoeng	Mind moves matter
University of Gothenburg	mottoeng	Renew our heritage and pass it on renewed
Geneva College	mottoeng	For Christ and Country
Grinnell College	mottoeng	Truth and Humanity
Hunter College	mottoeng	\
Lund University	mottoeng	Prepared for both the book and the sword\n- to study and to defend the country in times of war.
Massachusetts Institute of Technology	mottoeng	Mind and Hand
Millsaps College	mottoeng	In pursuit of excellence
Mount Saint Vincent University	mottoeng	\
Ohio State University	mottoeng	Education for Citizenship
Occidental College	mottoeng	The West is nearest the East
Princeton University	mottoeng	Under God's Power She Flourishes
Royal Institute of Technology	mottoeng	Science and Art
Stanford University	mottoeng	The wind of freedom blows
Simon Fraser University	mottoeng	\
Seattle University	mottoeng	For the difference we make
Syracuse University	mottoeng	Knowledge crowns those who seek her
University of Michigan	mottoeng	Arts, Knowledge, Truth
University of Washington	mottoeng	Let there be light
Uppsala University	mottoeng	Truth through the grace of God and through nature
University of Pennsylvania	mottoeng	Laws without morals are useless
University of Oxford	mottoeng	\
University of California, San Francisco	mottoeng	Let there be light
University of Rochester	mottoeng	Ever Better
University of California, Santa Cruz	mottoeng	Let there be light
University of California	mottoeng	Let there be light
University of California, Berkeley	mottoeng	Let there be light
University of California, Davis	mottoeng	Let there be light
University of California, San Diego	mottoeng	Let there be light
University of Southern California	mottoeng	Let whoever earns the palm bear it
University of Texas at Austin	mottoeng	Cultivated mind is the guardian genius of democracy.
Utrecht University	mottoeng	Sun of Righteousness, shine upon us
Upper Iowa University	mottoeng	With God For A Leader
University of Sussex	mottoeng	Be still and know
University of New Brunswick	mottoeng	Dare to be Wise
Cape Breton University	mottoeng	Perseverance Will Triumph
University of Manitoba	mottoeng	Flourish
University of Victoria	mottoeng	\
University of Manchester Institute of Science and Technology	mottoeng	By Knowledge and Work
University of Chicago	mottoeng	Let knowledge grow from more to more; and so be human life enriched
Victoria University, Toronto	mottoeng	Studies pass into character
Victoria University of Wellington	mottoeng	Wisdom is more to be desired than gold
Wabash College	mottoeng	For Knowledge and Virtue
Williams College	mottoeng	\
Yale University	mottoeng	Light and truth
York University	mottoeng	The way must be tried
University of California, Los Angeles	mottoeng	Let there be light
Jagiellonian University	mottoeng	Let reason prevail over force
Johns Hopkins University	mottoeng	The Truth Shall Set You Free
University of Glasgow	mottoeng	\
Hiram College	mottoeng	Let there be light
Emory University	mottoeng	The wise heart seeks knowledge
Lehigh University	mottoeng	Man, the servant and interpreter of nature
University of California, Irvine	mottoeng	Let there be light
University College London	mottoeng	\
Duke University	mottoeng	Knowledge and Faith
Kalamazoo College	mottoeng	Let There Be Light
California State University	mottoeng	\
Washington University in St. Louis	mottoeng	Strength through truth
United States Naval Academy	mottoeng	From Knowledge, Sea Power
Amherst College	mottoeng	Let them enlighten the lands
University of Florida	mottoeng	In the character of its citizens is the strength of the State.
University of Northern Iowa	mottoeng	\
Helsinki University of Technology	mottoeng	Work and science
University of Bristol	mottoeng	\
University of Warwick	mottoeng	Mind moves matter
Imperial College London	mottoeng	Knowledge is the adornment and protection of the Empire
Rose-Hulman Institute of Technology	mottoeng	Labor and Knowledge
Pontifical Catholic University of Campinas	mottoeng	May it shine with truth and knowledge
Xavier University – Ateneo de Cagayan	mottoeng	\
University of Mississippi	mottoeng	On behalf of knowledge and wisdom
Yeshiva University	mottoeng	Torah and secular knowledge
Jewish Theological Seminary of America	mottoeng	And the bush was not consumed – Exodus 3:2
London School of Economics	mottoeng	\
Tsinghua University	mottoeng	Self-Discipline and Social Commitment
Fudan University	mottoeng	Rich in knowledge and tenacious of purposes, inquiring with earnestness and reflecting with self-practice
Juniata College	mottoeng	Truth Sets Free
University of Waterloo	mottoeng	In harmony with truth
James Cook University	mottoeng	Light ever increasing
Roanoke College	mottoeng	\
Central Washington University	mottoeng	By teaching we learn.
University of Lausanne	mottoeng	Live knowledge
Rutgers University	mottoeng	Sun of righteousness, shine upon the West also.
American University	mottoeng	For God and Country
Brandeis University	mottoeng	Truth even unto its innermost parts
Saint Vincent College	mottoeng	Truth, justice and wisdom will conquer
Victoria University of Manchester	mottoeng	\
University of Manchester	mottoeng	\
Tufts University	mottoeng	Peace and Light
University of Paris	mottoeng	Here and anywhere on Earth
Leiden University	mottoeng	Bastion of Freedom
Boise State University	mottoeng	Splendour Without Diminishment
Massey University	mottoeng	Let knowledge flourish
University of Miami	mottoeng	Great is the truth
Chatham University	mottoeng	That our daughters may be as cornerstones, polished after the similitude of a palace.
East Carolina University	mottoeng	To Serve
University of North Carolina at Chapel Hill	mottoeng	Light and liberty
University of Calgary	mottoeng	I will lift up my eyes
Complutense University of Madrid	mottoeng	Freedom will flood all things with light
Roskilde University	mottoeng	In silence, death; in the surge, life
Anglia Ruskin University	mottoeng	Excellence through partnership
University of Otago	mottoeng	Dare to be wise
University of Southampton	mottoeng	The Heights Yield to Endeavour
Heidelberg University	mottoeng	always open – The Future. Since 1386.
Georgetown University	mottoeng	Both into One
University of Ottawa	mottoeng	God is the Lord of knowledge
National Autonomous University of Mexico	mottoeng	\
University of New South Wales	mottoeng	\
University of Notre Dame	mottoeng	Salve Regina
Monash University	mottoeng	\
San Francisco State University	mottoeng	\
University of Bath	mottoeng	\
University of York	mottoeng	On the threshold of wisdom
Trinity College, Toronto	mottoeng	After the contest, the crown
University of Liverpool	mottoeng	\
King's College London	mottoeng	\
University of Tehran	mottoeng	Rest not a moment from learning
University of Scranton	mottoeng	Religion Morals Culture
University of Kansas	mottoeng	\
Dickinson College	mottoeng	Freedom is made safe through character and learning
Monmouth College	mottoeng	Light
Tulane University	mottoeng	Not for oneself, but for one's own
Mount Allison University	mottoeng	Writing, Divinity, Knowledge
Osmania University	mottoeng	Lead us from Darkness to Light
University of North Carolina at Asheville	mottoeng	I Lift My Eyes to the Mountains
Indian Institute of Technology Bombay	mottoeng	Knowledge is the Supreme Goal
University of Western Ontario	mottoeng	Truth and usefulness
Stetson University	mottoeng	For God and Truth
Macalester College	mottoeng	Nature and Revelation are twin sisters of heaven
Haverford College	mottoeng	\
Colby College	mottoeng	Knowledge [is] the Light of the Mind
University of Münster	mottoeng	knowledge life
NUI Galway	mottoeng	With the favour of God
University of British Columbia	mottoeng	It is Yours
University of British Columbia	mottoeng	It is up to you
Hampshire College	mottoeng	To Know is Not Enough
John Carroll University	mottoeng	For the greater glory of God
Northwestern University	mottoeng	Whatsoever things are true
Northwestern University	mottoeng	The word full of grace and truth
Wellesley College	mottoeng	Not to be ministered unto, but to minister
University of Copenhagen	mottoeng	It  beholds the celestial light
St. Thomas University	mottoeng	Teach me Goodness and Knowledge and Discipline
University of Göttingen	mottoeng	For the good of all
University of St Andrews	mottoeng	Ever to Excel
University of St Andrews	mottoeng	or
University of St Andrews	mottoeng	Ever To Be The Best
Gallaudet University	mottoeng	Be opened
Greensboro College	mottoeng	, No reward without effort
Kenyon College	mottoeng	Valiantly bear the cross
West Virginia University	mottoeng	To faith virtue, and to virtue knowledge.
Kyoto University	mottoeng	Freedom of academic culture
Belhaven University	mottoeng	Not To Be Served But To Serve
Gonzaga University	mottoeng	For the Greater Glory of God
La Trobe University	mottoeng	Whoever seeks shall find
University of Queensland	mottoeng	\
Morehead State University	mottoeng	Light
University of Hawaii	mottoeng	\
Seoul National University	mottoeng	The truth is my light
Loyola Marymount University	mottoeng	For the greater glory of God
Loyola Marymount University	mottoeng	Direct us by thy light
University of Leeds	mottoeng	\
Humboldt State University	mottoeng	Light Truth
University of New England	mottoeng	Out Of Wisdom Comes Moderation
Technical University of Berlin	mottoeng	We have ideas for the future
Bowdoin College	mottoeng	As an eagle towards the sky
De Montfort University	mottoeng	Excellence and Zeal
National Taiwan University	mottoeng	Integrity, Diligence, Fidelity, Compassion
University of Kent	mottoeng	Literal translation: 'Whom to serve is to reign'
University of Adelaide	mottoeng	\
Hillsdale College	mottoeng	Strength Rejoices in the Challenge
Carleton College	mottoeng	The Revelation / Announcement of Your Words Illuminates
University of King's College	mottoeng	For God, Law, King, People
University of Birmingham	mottoeng	\
National Tsing Hua University	mottoeng	Constantly strengthen and cultivate ourselves
University of California, Santa Barbara	mottoeng	Let there be light
University of Aberdeen	mottoeng	The fear of the Lord is the beginning of wisdom
Karolinska Institutet	mottoeng	To improve human health
College of Saint Benedict and Saint John's University	mottoeng	So let your light shine
College of Saint Benedict and Saint John's University	mottoeng	Put on the Armor of Light
Bryn Mawr College	mottoeng	I Delight in the Truth
Portland State University	mottoeng	Let knowledge serve the city
University of the Cumberlands	mottoeng	A Life More Abundant
University of California, Riverside	mottoeng	Let there be light
East China Normal University	mottoeng	Pursue what we have not been taught, and practice what we are going to teach
École Polytechnique de Montréal	mottoeng	Hooke's law
Shimer College	mottoeng	Not to be served, but to serve
University of Waikato	mottoeng	For The People
University of Nevada, Las Vegas	mottoeng	All For Our Country
University of Nevada, Reno	mottoeng	All For Our Country
Wake Forest University	mottoeng	For Humanity
Florida State University	mottoeng	Strength, Skill, Character
Boston College	mottoeng	Ever to Excel
University of Pittsburgh	mottoeng	Truth and Virtue
Providence College	mottoeng	Truth
Virginia Tech	mottoeng	That I May Serve
Temple University	mottoeng	Perseverance Conquers
St. John's University	mottoeng	Christian education perfects the soul
Seton Hall University	mottoeng	Despite hazards, move forward
Villanova University	mottoeng	Truth
Villanova University	mottoeng	Cooperation
Villanova University	mottoeng	Charity
University of Alberta	mottoeng	Whatsoever things are true
RWTH Aachen University	mottoeng	Thinking the Future.
Lewis & Clark College	mottoeng	To explore, to learn, to work together
Wilberforce University	mottoeng	By one’s own toil, effort, courage
Ruhr University Bochum	mottoeng	People-centred – Cosmopolitan – High-performance
Smith College	mottoeng	In Virtue [One Gains] Knowledge
University of Massachusetts Amherst	mottoeng	\
St. Michael's College, Toronto	mottoeng	Piety, music, gymnastics
New College, Toronto	mottoeng	Strength in unity
University of Groningen	mottoeng	\
University of Jyväskylä	mottoeng	Truth is a friend
University of Tübingen	mottoeng	I dare!
University of Bologna	mottoeng	St. Peter is the father of all places and Bologna the mother of the Law
Washington and Lee University	mottoeng	Not Unmindful of the Future
University of Oregon	mottoeng	Mind moves the mass
University of South Dakota	mottoeng	Truth
University of Saskatchewan	mottoeng	For God and Country
Ghent University	mottoeng	Dare to Think
Hong Kong Polytechnic University	mottoeng	To learn and to apply, for the benefit of mankind
University of Hong Kong	mottoeng	Wisdom and Virtue
George Washington University	mottoeng	God is Our Trust
Chinese University of Hong Kong	mottoeng	Through learning and temperance to virtue
Hong Kong Baptist University	mottoeng	Light and truth
Clark University	mottoeng	Let there be light
Bard College	mottoeng	I shall give thee the crown of life
St. Olaf College	mottoeng	Forward! Forward! Men of Christ, Men of the Cross
Lincoln University	mottoeng	Science and industry with integrity
University of Auckland	mottoeng	By natural ability and hard work
National University of Ireland	mottoeng	Truth; Manhood's Truth
Australian National University	mottoeng	\
University of Malaya	mottoeng	Knowledge is the Source of Progress
University of Vermont	mottoeng	For studies and other honest pursuits
Colgate University	mottoeng	For God and for Truth
Worcester Polytechnic Institute	mottoeng	\
University of Colorado Boulder	mottoeng	Let Your Light Shine
Mississippi College	mottoeng	Truth and Virtue
Nankai University	mottoeng	Dedication to Public Interests, Acquisition of All-round Capability, Aspiration for Progress with Each Passing Day
Stevens Institute of Technology	mottoeng	Through adversity to the stars
Indiana University Bloomington	mottoeng	Light and Truth
Tuskegee University	mottoeng	Knowledge, Leadership, Service
Indian Institute of Technology Kharagpur	mottoeng	Excellence in Action is Yoga
Bloomfield College	mottoeng	Light From Darkness
Caldwell University	mottoeng	Wisdom and Knowledge
College of Saint Elizabeth	mottoeng	God is love.
Fairleigh Dickinson University	mottoeng	Literally translated from Latin to \
Drew University	mottoeng	\
Miami University	mottoeng	To Accomplish Rather Than to Be Conspicuous
Felician University	mottoeng	In Truth is Happiness
Kean University	mottoeng	Always Learning
Rider University	mottoeng	In all things prepared
Thomas Edison State University	mottoeng	Learning throughout life
Saint Peter's University	mottoeng	For the Greater Glory of God
New Jersey City University	mottoeng	\
Collège de France	mottoeng	Teaches all
Georgetown College	mottoeng	\
University of Arkansas	mottoeng	To Advance with Truth as our Leader
Connecticut College	mottoeng	\
Appalachian State University	mottoeng	To be, rather than to seem
Whitman College	mottoeng	Through adversities I rise
University of Freiburg	mottoeng	The Truth Will Set You free.
Kyushu University	mottoeng	Opening the Door to a New Century of Knowledge
De La Salle University	mottoeng	Religion, Morals, Culture
Golden Gate University	mottoeng	The welfare of the state depends upon the morals of its citizens
University of Ontario Institute of Technology	mottoeng	\
University of Texas at El Paso	mottoeng	Science and Humanities
Yenching University	mottoeng	Freedom Through Truth For Service
Iona College	mottoeng	Fight the good fight
Humboldt University of Berlin	mottoeng	The Entity of Sciences
University of Delaware	mottoeng	Knowledge is the light of the mind
Federico Santa María Technical University	mottoeng	From the shadows to the light
Queens College, City University of New York	mottoeng	\
University of Sheffield	mottoeng	To discover the causes of things
Lawrence University	mottoeng	Truth is Light
Saint Mary's College of California	mottoeng	The Sign of Faith
University of Mary Washington	mottoeng	For God, home, and country
Emmanuel College	mottoeng	\
Free University of Berlin	mottoeng	Truth
Free University of Berlin	mottoeng	Justice
Free University of Berlin	mottoeng	Liberty
Free University of Berlin	mottoeng	Gratis
Indian Institute of Technology Roorkee	mottoeng	Nothing can be achieved without hard work
Lancaster University	mottoeng	\
École Polytechnique	mottoeng	For the Homeland, Science and Glory
Aberystwyth University	mottoeng	A world without knowledge is no world at all
The Evergreen State College	mottoeng	Let it all hang out
Bates College	mottoeng	\
École normale supérieure de Lyon	mottoeng	Education through research, for research
Hendrix College	mottoeng	Unto the whole person
University of the Witwatersrand	mottoeng	Knowledge and work
Harbin Institute of Technology	mottoeng	Being strict in qualifications for graduates; making every endeavor in educating students
Queen's University Belfast	mottoeng	For so much, what shall we give back?
Jinan University	mottoeng	loyalty, sincerity, integrity and respect
University of Nebraska–Lincoln	mottoeng	Dedicated to Letters and All the Arts
University of Oklahoma	mottoeng	For the benefit of the Citizen and the State
National Cheng Kung University	mottoeng	Intellectual Development through Persistent Pursuit of Knowledge
Vrije Universiteit Amsterdam	mottoeng	Our help is in the name of the Lord
University of Nebraska system	mottoeng	Dedicated to Letters and All the Arts
Ateneo de Manila University	mottoeng	Light in the Lord
Ateneo de Manila University	mottoeng	For the Greater Glory of God
Mohawk College	mottoeng	Knowledge, the work of all
Cardiff University	mottoeng	Truth, Unity and Concord
Loughborough University	mottoeng	by Truth, Wisdom and Labour
Zhejiang University	mottoeng	Seeking the Truth and Pioneering New Trails
Colorado School of Mines	mottoeng	Invented by the imagination
Wheaton College	mottoeng	\
Laurentian University	mottoeng	Send forth thyne light and thyne truth
University of Geneva	mottoeng	Light after darkness
McMaster University	mottoeng	All things cohere in Christ
Bishop's University	mottoeng	Sound learning strengthens the spirit
University of Windsor	mottoeng	[Teach me] Goodness, discipline, knowledge
Lakehead University	mottoeng	Through Trials to Triumph
Nipissing University	mottoeng	Spirit of Integrity - Wholeness
Beijing Institute of Technology	mottoeng	Developing virtues for seeking truth; Pursuing study for perfecting practice.
University College, Toronto	mottoeng	To shed light on that which is obscure
Virginia Military Institute	mottoeng	In Peace a Glorious Asset, In War a Tower of Strength
Alfred University	mottoeng	\
Rockhurst University	mottoeng	Wisdom has built herself a home
Technical University of Munich	mottoeng	The Entrepreneurial University
University of Graz	mottoeng	Never back!
Laval University	mottoeng	By the grace of God, to no one equal
University of Indonesia	mottoeng	Truth, Honesty, Justice
California State University, Chico	mottoeng	\
University of Wales, Lampeter	mottoeng	The Word of God is the Best Learning
University of Northern Colorado	mottoeng	Wisdom is eternal
Hope College	mottoeng	Hope in God
Waterford Institute of Technology	mottoeng	Perfect to swerve
University of Melbourne	mottoeng	\
Morehouse College	mottoeng	Let there be light
University of Maine	mottoeng	I Guide
Moscow State University	mottoeng	Science is the clear learning of truth and enlightenment of the mind
Howard University	mottoeng	\
University of Padua	mottoeng	Liberty of Padua, universally and for all
University of Georgia	mottoeng	Both to teach and to inquire into the nature of things. \n'To serve' was later added to the motto without changing the seal, so the university motto in English now is \
Robert Gordon University	mottoeng	Now by all your mastered arts
Birmingham City University	mottoeng	\
California State University, Long Beach	mottoeng	\
Federal University of Minas Gerais	mottoeng	A new life begins
University of Puget Sound	mottoeng	To the heights
Texas Christian University	mottoeng	\
Vrije Universiteit Brussel	mottoeng	Conquering darkness by science
Université libre de Bruxelles	mottoeng	Conquering darkness with knowledge
Northeastern University	mottoeng	Light, Truth, Courage
Westminster Theological Seminary	mottoeng	The whole counsel of God
Florida International University	mottoeng	Hope, Knowledge, Opportunity
Memorial University of Newfoundland	mottoeng	\
Furman University	mottoeng	For Christ and Learning
Brock University	mottoeng	Push on!
Bellarmine University	mottoeng	In the Love of Truth
Liverpool John Moores University	mottoeng	Fortune favours the bold
Shandong University	mottoeng	Noble in Spirit, Boundless in Knowledge
Université catholique de Louvain	mottoeng	Seat of Wisdom, Seat of Knowledge
South China University of Technology	mottoeng	Study Extensively, Enquire Accurately; Discriminate Clearly, Practise Earnestly
Aarhus University	mottoeng	We seek solid ground in the depths
Idaho State University	mottoeng	\
Anna University	mottoeng	Progress through Knowledge
University of New Mexico	mottoeng	Life, the Light of Men
University of Dundee	mottoeng	\
Whittier College	mottoeng	Light, Poetry, Truth, Peace, and Love of Knowledge
Doshisha University	mottoeng	Truth shall make you free
Osgoode Hall Law School	mottoeng	Through law to justice
University of North Carolina at Wilmington	mottoeng	Dare to Learn
Wilmington College	mottoeng	\
Himachal Pradesh University	mottoeng	Those, who are armed with knowledge, are skilful
University of Portland	mottoeng	The truth will set you free
Woodsworth College, Toronto	mottoeng	Firm of purpose
University of Minnesota	mottoeng	A common bond for all the arts
Queen Mary University of London	mottoeng	With United Powers
Shivaji University	mottoeng	Knowledge is the elixir of life
American College, Madurai	mottoeng	Purified, Not Consumed.
William Jewell College	mottoeng	Trust in God, Work
University of North Dakota	mottoeng	Light and Law
Santa Fe)	mottoeng	I make free men from children by means of books and a balance
Fordham University	mottoeng	Wisdom and Learning
University of the West of Scotland	mottoeng	To achieve through hard work
Wheeling Jesuit University	mottoeng	Let your light shine
Washburn University	mottoeng	Not for Ourselves Alone
Tokyo Institute of Technology	mottoeng	Engineers of the Knowledge, Technology and Passion that Change our World.
University of Nottingham Malaysia Campus	mottoeng	A City is Built on Wisdom
Santa Clara University	mottoeng	For the Greater Glory of God
California Polytechnic State University	mottoeng	To Learn by Doing
Conservatoire national des arts et métiers	mottoeng	It teaches everyone everywhere
United States Coast Guard Academy	mottoeng	The sea yields to knowledge
Mills College	mottoeng	One destination,
Mills College	mottoeng	many paths.
Willamette University	mottoeng	Not unto ourselves alone are we born
Maynooth University	mottoeng	Truth Strength Courage
Dordt College	mottoeng	\
West Texas A&M University	mottoeng	Vision. Truth. Valor.
Spring Arbor University	mottoeng	Faith, Living, Learning
University of Michigan–Flint	mottoeng	Arts, Knowledge, Truth
University of Pisa	mottoeng	In supreme dignity
University of Milan	mottoeng	Knowledge enlightening the worthy
University of Puerto Rico at Mayagüez	mottoeng	Before, Now, and Forever...Colegio!
University of Dayton	mottoeng	For God and Country
University of Urbino	mottoeng	Urbino: a city campus
Illinois Wesleyan University	mottoeng	Knowledge and Wisdom
College of the Holy Cross	mottoeng	In this sign you shall conquer
Union College	mottoeng	Under the laws of Minerva, we all become brothers and sisters
University at Buffalo	mottoeng	\
Loyola University New Orleans	mottoeng	For God and country
Loyola University New Orleans	mottoeng	For the Greater Glory of God
Christian Brothers University	mottoeng	Character and Knowledge
Albion College	mottoeng	Let there be Light
Scripps College	mottoeng	\
Asbury University	mottoeng	Learning and Religion
University of California, Merced	mottoeng	Let there be light
University of Buenos Aires	mottoeng	Argentine virtue is strength and study
Porter College	mottoeng	Life is short, Art endures
Southern Methodist University	mottoeng	The Truth Shall Set You Free
United States Merchant Marine Academy	mottoeng	Deeds not Words
Ohio University	mottoeng	Religion, Learning, Civility; Above All, Virtue
Pitzer College	mottoeng	\
Berklee College of Music	mottoeng	To be, rather than to appear to be
Oakland University	mottoeng	Seek virtue and knowledge
Middlebury College	mottoeng	Knowledge and Virtue
East Los Angeles College	mottoeng	Mankind extends the life of the community
California State Polytechnic University, Pomona	mottoeng	Application of Knowledge
California State University, Los Angeles	mottoeng	\
University of Houston	mottoeng	In Time
King's College	mottoeng	\
Fairfield University	mottoeng	Through Faith to the Fullness of Truth
Gettysburg College	mottoeng	Do Great Work
Delaware State University	mottoeng	Enter to Learn, Go forth and serve
Quinnipiac University	mottoeng	\
University of Hartford	mottoeng	For humanity
University of Maryland Eastern Shore	mottoeng	Deeds, Not Words
University of Mumbai	mottoeng	\
Trinity College	mottoeng	For Church and Country
Georgia State University	mottoeng	Truth is Powerful and Will Conquer
Niagara University	mottoeng	That All May Know You
University of Hertfordshire	mottoeng	Seek Knowledge Throughout Life
D'Youville College	mottoeng	Religion and Knowledge
Ocean University of China	mottoeng	Ocean Embraces Streams All and Exploring Promises Reaching Far
Bentley University	mottoeng	Prepared
ESSEC Business School	mottoeng	The pioneering spirit
RMIT University	mottoeng	\
California State University, East Bay	mottoeng	Through Adversity to the Stars
Hamilton College	mottoeng	Know thyself
Middle East Technical University	mottoeng	Science is the truest guide in life
Trinity University	mottoeng	From Three, One
Long Island University	mottoeng	To the city and to the world
Chongqing University	mottoeng	Endure Toil, Cherish Thrift, Work Hard and Love the Country
University of Alaska system	mottoeng	To The Highest Point
Indian Institute of Technology Guwahati	mottoeng	\
Southampton Solent University	mottoeng	Spark Your Imagination
Xavier University	mottoeng	He has seen great wonders
University of Southern Queensland	mottoeng	\
Southeastern Louisiana University	mottoeng	Fidelity, Integrity, Fortitude
Fayetteville State University	mottoeng	\
North Carolina Agricultural and Technical State University	mottoeng	Mind and Hand
Hunan University	mottoeng	Seeking Truth from Facts and Daring to be Pioneers
USC School of Cinematic Arts	mottoeng	Reality ends here
University of Cincinnati	mottoeng	\
University of Texas Medical Branch	mottoeng	Cultivated mind is the guardian genius of democracy.
Maharaja Sayajirao University of Baroda	mottoeng	Love of beauty , Goodness and Intellectual Curiosity
College of Idaho	mottoeng	My Leader, my Light, my King, and my Law
British Columbia Institute of Technology	mottoeng	To each their highest attainment
College of St. Joseph	mottoeng	The Light. The Way. The Truth.
Green Mountain College	mottoeng	Let there be Light
Lyndon State College	mottoeng	Key to the Kingdom
University of Bamberg	mottoeng	Regionally rooted – academically distinguished – internationally connected
Saint Michael's College	mottoeng	Who is like God
UCL School of Pharmacy	mottoeng	Bringing Health to the World
Westminster College	mottoeng	For Christ and for Liberty
Indian Institute of Management Ahmedabad	mottoeng	Progress Through Knowledge
Champlain College	mottoeng	Let us dare
Heythrop College, University of London	mottoeng	Nothing Without Faith
Royal Veterinary College	mottoeng	Confront disease at its onset
DePaul University	mottoeng	\
Naval War College	mottoeng	Victory by seapower
University of Hanover	mottoeng	Shaping the Future with Knowledge
University of Texas at Dallas	mottoeng	Education,
University of Texas at Dallas	mottoeng	the Guardian of Society
Northern Alberta Institute of Technology	mottoeng	To Learn, To Do, To Succeed
St Patrick's College, Dublin	mottoeng	Give me understanding, Lord
Mary Immaculate College	mottoeng	The Word of God as my light
HEC Paris	mottoeng	The more you know, the more you dare
Barber–Scotia College	mottoeng	Knowledge, Truth, and Service
Landmark College	mottoeng	Know Thyself
Sun Yat-sen University	mottoeng	Study Extensively, Enquire Accurately, Reflect Carefully, Discriminate Clearly, Practise Earnestly
Garda Síochána College	mottoeng	In knowledge, safety
Silpakorn University	mottoeng	Art is long, Life is short
Chulalongkorn University	mottoeng	Knowledge with Virtue
Chulalongkorn University	mottoeng	Honour of Chula is the Honour of Serving the Public
University of Kiel	mottoeng	Peace is the greatest good
Davidson College	mottoeng	Let Learning Be Cherished Where Liberty Has Arisen
California State University, Fresno	mottoeng	Receive the light that you may give it forth.
University of Hull	mottoeng	Bearing the Torch [of learning]
Marianopolis College	mottoeng	\
St. Lawrence University	mottoeng	Faith and Truth
University of St. Thomas	mottoeng	May we grow in Christ
University of Notre Dame Australia	mottoeng	\
Lanzhou University	mottoeng	Constantly Improving, Blazing Our Own Path
Renmin University of China	mottoeng	Seeking truth from facts
University of Portsmouth	mottoeng	Let us follow the Light
Schulich School of Law	mottoeng	\
Hobart and William Smith Colleges	mottoeng	Hobart: Learn
Hobart and William Smith Colleges	mottoeng	William Smith: Life, Soul
Vilnius University	mottoeng	From here the way leads to the stars
Université de Moncton	mottoeng	Arise, Shine
Lafayette College	mottoeng	The truth shall set you free.
South Carolina State University	mottoeng	Knowledge, Duty, Honor
University of San Diego	mottoeng	Send Forth Thy Spirit
Beijing University of Posts and Telecommunications	mottoeng	Great Virtue, Profound Knowledge, Total Commitment, Harmonious Cooperation
California State University, Fullerton	mottoeng	\
Emory and Henry College	mottoeng	Increase in Excellence
University of Salamanca	mottoeng	What nature doesn't give, Salamanca doesn't provide
Duquesne University	mottoeng	It is the Spirit that gives life.
Acharya Nagarjuna University	mottoeng	\
Booth School of Business	mottoeng	Let knowledge grow from more to more; and so be human life enriched
College of Charleston	mottoeng	\
College of Charleston	mottoeng	She Cares for Her Temples, Customs and Rights.
Point Park University	mottoeng	For Knowledge, For Community, For Career
University of Guam	mottoeng	Ever Upward
University of Winnipeg	mottoeng	Let Light and Truth Flourish
Cornell College	mottoeng	God and Humanity
Presbyterian Theological College	mottoeng	\
Massey College, Toronto	mottoeng	Have the courage to be wise
University of Akron	mottoeng	Let there be light
Saint Louis University	mottoeng	For the greater glory of God
Beihang University	mottoeng	Ability, together with Integrity; Practice, in conformity with Truth and Moral Beliefs
University of Tasmania	mottoeng	The Field is Open to Talent
Catholic University of America	mottoeng	\
Rockefeller University	mottoeng	Science for the benefit of humanity
National Central University	mottoeng	Sincerity and Simplicity
Meredith College	mottoeng	Light
Central Michigan University	mottoeng	\
Shaw University	mottoeng	For Christ and Humanity
Soochow University	mottoeng	Unto A Full Grown Man
University of Sunderland	mottoeng	Sweetly absorbing knowledge
Shantou University	mottoeng	Aspiration, Knowledge, Perseverance, Achievement
Le Moyne College	mottoeng	Everything in the Lord Jesus
All Hallows College	mottoeng	Go and teach all nations
University of Montana	mottoeng	Light and Truth
Virginia Intermont College	mottoeng	Nothing without Guidance
University of Santiago, Chile	mottoeng	Work is Our Joy
La Salle University	mottoeng	Virtue, Knowledge
Drake University	mottoeng	Truth
University of Madras	mottoeng	\
Marist College	mottoeng	To Pray and To Work
University of Louisiana at Lafayette	mottoeng	Boldly, Happily, Faithfully
Gannon University	mottoeng	Health, Knowledge, Holiness
Ming Chuan University	mottoeng	Honesty, Modesty, Respect, Fortitude
University of Hawaii at Manoa	mottoeng	\
Erasmushogeschool Brussel	mottoeng	Partner of the Brussels University Association
University of Hawaii at Hilo	mottoeng	The flame of Hilo's lehua blossoms leaps triumphantly with pride
Tianjin University	mottoeng	Seeking Truth from Facts
Mines ParisTech	mottoeng	Theory and Practice
Concordia College	mottoeng	\
Franciscan University of Steubenville	mottoeng	Fortitude and Prudence
Ginling College	mottoeng	Public welfare
United States Army War College	mottoeng	Wisdom and strength for the future
University of Rostock	mottoeng	Tradition and Innovation
University of Cape Town	mottoeng	Good Hope
Loyola College, Chennai	mottoeng	Let your Light Shine
University of Colorado Colorado Springs	mottoeng	Let Your Light Shine
Adelphi University	mottoeng	Literal translation: \
Adelphi University	mottoeng	\
University of Buckingham	mottoeng	\
Union Theological Seminary	mottoeng	Unity, Truth, Love
York St John University	mottoeng	They may have life and have it more abundantly
Sonoma State University	mottoeng	Light of the Mind, Light of the World
California State University Maritime Academy	mottoeng	To Work or Fight We Are Ready
Bournemouth University	mottoeng	To Learn is to Change
University of Central Lancashire	mottoeng	\
University of Derby	mottoeng	Experience is the best teacher
University of Gloucestershire	mottoeng	In Spirit and Truth
University of Lincoln	mottoeng	Freedom through wisdom
Teesside University	mottoeng	\
Birkbeck, University of London	mottoeng	\
Bilkent University	mottoeng	Truth
Panjab University	mottoeng	Lead us unto the Light from Darkness
Luther College	mottoeng	To God alone be the Glory
Luther College	mottoeng	and The Word of the Lord endures forever
Edinburgh Napier University	mottoeng	Without knowledge, everything is in vain
Aristotle University of Thessaloniki	mottoeng	Sacrifice to the Muses and Charites
Hamline University	mottoeng	Divinity, Writing, Liberty
Xavier University of Louisiana	mottoeng	\
Dillard University	mottoeng	\
Union College	mottoeng	They shall be taught of God
National University of Kharkiv	mottoeng	To learn, to educate, to enlighten
Oklahoma City University	mottoeng	Truth, Church, and Knowledge
Hawaii Pacific University	mottoeng	Forward With Truth
Chaminade University of Honolulu	mottoeng	Life in [the] Word
University of Santo Tomas	mottoeng	Truth in Charity
Westchester Community College	mottoeng	\
National University of Malaysia	mottoeng	Inspiring Futures, Nurturing Possibilities
Quaid-i-Azam University	mottoeng	'And he to whom wisdom is granted receiveth indeed a benefit overflowing'
Communication University of China	mottoeng	Integrity, Professionalism, Erudition and Competence
Marquette University	mottoeng	God and the River
Marquette University	mottoeng	For the greater glory of God
University of Texas–Pan American	mottoeng	Education, the Guardian of Society
Spring Hill College	mottoeng	A spring of wisdom is he who was lifted up on the hill
University of Detroit Mercy	mottoeng	For the greater glory of God;
University of Detroit Mercy	mottoeng	Mary, Seat of Wisdom
Vaughn College of Aeronautics and Technology	mottoeng	Vision and Excellence
Washington & Jefferson College	mottoeng	\
University of Mainz	mottoeng	That they all may be one
Mercy College	mottoeng	In serving, to exhaust
Transylvania University	mottoeng	In That Light, We Pass On The Light
Xiamen University	mottoeng	Pursue Excellence, Strive for Perfection
University of Science, Malaysia	mottoeng	We Lead
Stranmillis University College	mottoeng	We learn by teaching
Sydney Missionary and Bible College	mottoeng	Light shines in darkness
National Institute of Technology Calicut	mottoeng	From Darkness, Lead us unto Light
Sewanee: The University of the South	mottoeng	Behold how good and how pleasant it is for brethren to dwell together in unity.
Scientific University of the South	mottoeng	You improve. The world improves.
Erskine College	mottoeng	Knowledge joined with Morals
McDaniel College	mottoeng	I call you out of darkness into light
National Taiwan Normal University	mottoeng	Sincerity, Justice, Diligence, and Simplicity
Hawaii Community College	mottoeng	To Seek Excellence
Windward Community College	mottoeng	Enlightening Koolau
Universidad Iberoamericana	mottoeng	The Truth shall set us free
Carroll College	mottoeng	Not For School, But For Life.
National Taipei University of Technology	mottoeng	Integrity•Simplicity•Professionalism•Diligence
Renison University College	mottoeng	One Sky Over All
Tallinn University of Technology	mottoeng	With wisdom and hands
Instituto Tecnológico Autónomo de México	mottoeng	\
New York Institute of Technology	mottoeng	Mind and Hand
Royal Military College Saint-Jean	mottoeng	Truth, Duty, Valour
University of Central Oklahoma	mottoeng	Where Movement Is
Knox College	mottoeng	Truth
Sungkyunkwan University	mottoeng	Humanity, Righteousness, Propriety, Wisdom
Trevecca Nazarene University	mottoeng	\
Bharathiar University	mottoeng	Educate to Elevate
DG Vaishnav College	mottoeng	May we meditate upon the Supreme Truth
Northumbria University	mottoeng	\
University of Chester	mottoeng	\
Midwestern State University	mottoeng	Through Knowledge to Excellence
Merrimack College	mottoeng	Through Knowledge to Wisdom
Dresden University of Technology	mottoeng	Knowledge builds bridges
Naval Postgraduate School	mottoeng	Excellence through Knowledge
Muskingum University	mottoeng	Everything which comes in threes is perfect
Moscow Institute of Physics and Technology	mottoeng	Dare to know
Lincoln University	mottoeng	To labor and study
Columbia College	mottoeng	Not who, but what
Scottish Church College	mottoeng	\
Claremont McKenna College	mottoeng	Civilization prospers with commerce
St. Norbert College	mottoeng	\
University of Richmond	mottoeng	Word of life and the light of knowledge
Ohio Wesleyan University	mottoeng	In Your Light We Shall See the Light
Rowan University	mottoeng	Education, hope of the world
Toyota Technological Institute	mottoeng	Respect the spirit of research and creativity, and always strive to stay ahead of the times.
Mount St. Mary's University	mottoeng	Our Hope
Savannah College of Art and Design	mottoeng	Art is long, life is short
Mount St. Mary's University	mottoeng	God, My Light
Savitribai Phule Pune University	mottoeng	\
Trinity Western University	mottoeng	A Mighty Fortress Is Our God
Carroll University	mottoeng	For Christ and Learning
Beloit College	mottoeng	True knowledge with pure faith
Shakespeare Institute	mottoeng	\
Ursinus College	mottoeng	On the Firm Foundation of God
Taylor University	mottoeng	Light and Faith''
Federal University of Rio de Janeiro	mottoeng	\
Mary Baldwin University	mottoeng	\
Bandung Institute of Technology	mottoeng	Progress in Harmony
University of Texas at Arlington	mottoeng	\
Saint Joseph's College	mottoeng	Divinity, Morality, Knowledge
Stellenbosch University	mottoeng	A sound education strengthens the spirit
Lewis University	mottoeng	Sign of Faith
Beijing Normal University	mottoeng	Learn, so as to instruct others; Act, to serve as example to all.
Fuzhou University	mottoeng	Míng dé zhì chéng bó zì yuǎn zhì
Fujian Agriculture and Forestry University	mottoeng	excellent virtue, true wisdom, successful learning, innovation
Jimei University	mottoeng	Sincerity and Fortitude
Quanzhou Normal University	mottoeng	Perfect education in Quanzhou with strong mind and heart.
Northeast Normal University	mottoeng	Be diligent and creative in studies, be exemplary in virtue
Southeast University	mottoeng	Strive for Perfection
Dalian University of Technology	mottoeng	Unity, Enterprise, Pragmatism and Originality
Dalian University	mottoeng	Civilization Self-Improvement Truth-Seeking and Originality
Shanghai International Studies University	mottoeng	Integrity, vision, academic excellence
Shanghai University of Finance and Economics	mottoeng	Strive for Virtue and Knowledge, Assist in Economy and Governance
East China University of Science and Technology	mottoeng	Diligence, Factuality, Aspiration and Virtue
Beijing University of Chemical Technology	mottoeng	Integrity, Knowledge, Sharing & Works
University of Science and Technology Beijing	mottoeng	Seeking Truth and Endorse Innovation
Beijing Jiaotong University	mottoeng	Knowledge and Action
Chongqing Technology and Business University	mottoeng	Moral, Knowledgeable, Honest and Innovative
University of Science and Technology of China	mottoeng	Being both responsible and professional, integrating theory with practice
Dongbei University of Finance and Economics	mottoeng	Broaden Intellectual Horizon and Contribute to Social Well-being
Taiyuan University of Technology	mottoeng	Pursue Practicality, Create Originality
Shanxi University	mottoeng	Be true，be kind，seeking perfection.
Shanghai University of Engineering Science	mottoeng	Diligence, Adherence to Fact, Innovation, Devotion
Shanghai University	mottoeng	The movement of heaven is full of power. Thus the superior man makes himself strong and untiring.
Shanghai University	mottoeng	Be concerned about the affairs of state before others, and enjoy comfort after others.
Shanghai University of International Business and Economics	mottoeng	Learned tolerance, integrity and pragmatism
Tianjin University of Technology	mottoeng	Focusing on Morals and Capability, Pursuing Truth and Innovation
China Foreign Affairs University	mottoeng	Unswerving Loyalty, Mastery of Policies, Professional Competency, Observance of Discipline
Beijing Institute of Clothing Technology	mottoeng	meticulousness, diligence, faithfulness, creativity
Capital University of Economics and Business	mottoeng	\
University of Macau	mottoeng	Humanity, integrity, propriety, wisdom and sincerity
Banaras Hindu University	mottoeng	\
Thiel College	mottoeng	Light of the World, Word of God
Northeastern University	mottoeng	Self-discipline, seeking and acting for truth.
Angelo State University	mottoeng	Let there be light
Virginia Tech Corps of Cadets	mottoeng	That I may serve
Marian University	mottoeng	Seat of Wisdom
University of Tampa	mottoeng	To be, rather than to seem to be
Ottawa University	mottoeng	The Truth Will Set You Free
Chinese Culture University	mottoeng	Temperament, Simplicity, Strength, and Tenacity
Taipei Medical University	mottoeng	Honesty
National Chengchi University	mottoeng	Harmony, Independence, Balance, and Preeminence
Shih Hsin University	mottoeng	Master virtue and wisdom; practice hands and mind
National Taipei University	mottoeng	Searching for the truth and serving the people
Shih Chien University	mottoeng	Knowledge is the beginning of practice. Doing is the completion of knowing.
Huafan University	mottoeng	Virtue, knowledge, ability and compassion
University of Texas at San Antonio	mottoeng	A cultivated mind is the guardian genius of democracy
Silliman University	mottoeng	\
Radboud University Nijmegen	mottoeng	Happily in God's name
Fu Jen Catholic University	mottoeng	Truth, Goodness, Beauty, Sanctity
Beijing International Studies University	mottoeng	Integrity, Diligency,
Beijing International Studies University	mottoeng	Verity, Competency
University of South Carolina	mottoeng	Learning humanizes character and does not permit it to be cruel
College of Engineering, Guindy	mottoeng	Work conquers all
Central Queensland University	mottoeng	Forever learning.
Wrexham Glyndŵr University	mottoeng	Confidence through Education
Glendon College	mottoeng	For future generations\n    Pour les générations futures
University of Paderborn	mottoeng	The University of the Information Society
Wofford College	mottoeng	Shines with untarnished honor
University of Tennessee at Chattanooga	mottoeng	We shall achieve
Jacksonville University	mottoeng	Let There Be Light
Elon University	mottoeng	Intellectual and spiritual light
Valparaiso University	mottoeng	In Thy light we see light
University of Cádiz	mottoeng	No Further Beyond
Dow University of Health Sciences	mottoeng	Prevention Is Better than Cure..
Universidad del Turabo	mottoeng	Thinking is Creating the Light of Life
University of Mysore	mottoeng	Nothing is Equal to Knowledge
Mount Royal University	mottoeng	\
Indian Institute of Management Lucknow	mottoeng	Better management towards better nation
Patrick Henry College	mottoeng	For Christ and for Liberty
Islamia College University	mottoeng	O' God, Increase my Knowledge
Islamia College University	mottoeng	Creating new leadership...
Buckinghamshire New University	mottoeng	\
Ateneo de Davao University	mottoeng	Strong in Faith
Wuhan University	mottoeng	Improve Oneself, Promote Perseverance, Seek Truth and Make Innovations
Universidad del Sagrado Corazón	mottoeng	I will give glory to Him who gives me wisdom
Alpen-Adria-Universität Klagenfurt	mottoeng	Through hardships to the stars
Indian Institute of Management Calcutta	mottoeng	Knowledge for the benefit of all
R.V. College of Engineering	mottoeng	Light the lamp of Knowledge
Gordon College	mottoeng	Jesus Christ, Son of God, Savior
Open University Malaysia	mottoeng	University for All: Opening Minds, Transforming Lives
Texas Lutheran University	mottoeng	The truth of Christ sets people free
Centre College	mottoeng	Learning is the Light of the Mind
National University of San Marcos	mottoeng	University of Peru,
National University of San Marcos	mottoeng	Dean of America
Hollins University	mottoeng	Lift thine eyes
Ponce Health Sciences University	mottoeng	We should learn as long as we may live
Madan Mohan Malaviya University of Technology	mottoeng	\
University of Asia and the Pacific	mottoeng	\
National Institute of Technology, Karnataka	mottoeng	Work is worship
Gustavus Adolphus College	mottoeng	Strength Comes To Us From Heaven
AGH University of Science and Technology	mottoeng	\
University of Houston System	mottoeng	In Time
National Institute of Technology, Warangal	mottoeng	One who works, shall succeed
Augustana University	mottoeng	The Word of God endures forever
International Islamic University Malaysia	mottoeng	The Garden of Knowledge and Virtue
Finlandia University	mottoeng	The Lord is my Light
Lenoir–Rhyne University	mottoeng	The truth shall set you free
Southwestern University	mottoeng	Not Who But What
Huazhong University of Science and Technology	mottoeng	Virtue, Knowledge, Truth, Originality
Aquinas College	mottoeng	nothing but You, Lord
Elmhurst College	mottoeng	In your light we shall see light
Anna Maria College	mottoeng	Light and Truth
Wuhan University of Technology	mottoeng	Sound in Morality, Broad in Learning and Pursuing Excellence
University of Botswana	mottoeng	Education is a Shield
California Miramar University	mottoeng	\
National Research Nuclear University MEPhI	mottoeng	The one who continues to walk will finish the road.
University of Jamestown	mottoeng	Light and Truth
Johnson University Florida	mottoeng	Strong in the Scriptures
University of Johannesburg	mottoeng	Service Through Knowledge
University of the West Indies	mottoeng	A Light Rising From The West
Collège Jean-de-Brébeuf	mottoeng	I chose the path of truth
Claremont Graduate University	mottoeng	\
Rhodes University	mottoeng	Strength, courage, truth
Indian Institute of Engineering Science and Technology, Shibpur	mottoeng	Arise, Awake, Obtaining worthy Teachers, Know the truth
Hsuan Chuang University	mottoeng	Virtue, Knowledge, Diligence and Perseverance
National Chiao Tung University	mottoeng	Learn New Knowledge and Reach Far; Honor the Truth and Work Hard
Simón Bolívar University	mottoeng	\
Manhattan College	mottoeng	Sign of the Faith
University of Tabriz	mottoeng	Refinements and Education
Keiser University-Latin American Campus	mottoeng	Purity, Truth, Wisdom
Wesleyan College	mottoeng	Knowledge and devotion
Upsala College	mottoeng	Truth Conquers All
Goucher College	mottoeng	Grace and Truth
Notre Dame of Maryland University	mottoeng	We Pursue Truth
National University of Colombia	mottoeng	Search for the truth among the rooms of the academy
Capitol Technology University	mottoeng	\
Pontifical Catholic University of Valparaíso	mottoeng	\
Vanier College	mottoeng	God's will be done
Saint Mary's College	mottoeng	Our only hope
Sapienza University of Rome	mottoeng	The future has passed here
JSS Science and Technology University	mottoeng	Work is worship
Peter A. Allard School of Law	mottoeng	Let justice be done though the heavens fall
West Virginia University at Parkersburg	mottoeng	The Highest Good
Dr. B. R. Ambedkar National Institute of Technology Jalandhar	mottoeng	Hail Sarasvati
Dominican University of California	mottoeng	Truth is a Flaming Torch
West Virginia State University	mottoeng	Truth is the Light of the World
Visvesvaraya National Institute of Technology	mottoeng	Excellence in action is yoga.
Roger Williams University	mottoeng	Truth is Mighty
Alverno College	mottoeng	In Holiness and Learning
Sophia University	mottoeng	Light of Truth
Visvesvaraya Technological University	mottoeng	Above all, be human
Pohang University of Science and Technology	mottoeng	Integrity, Creativity, and Aspiration
Ansan University	mottoeng	Truth,Liberty,Faithfulness
Northwest University	mottoeng	Fairness, Integrity, Diligence and Simplicity
University of Tarapacá	mottoeng	University of Truth
University of La Serena	mottoeng	Your State University in the Coquimbo Region
University of Concepción	mottoeng	For the free development of the spirit.
University of Magallanes	mottoeng	Knowledge in the South
University of the Bío Bío	mottoeng	The University of the region of Bio - Bio
Pacific University	mottoeng	For Christ and His Kingdom
Saint Mary's University of Minnesota	mottoeng	Virtue and Knowledge
Yong In University	mottoeng	Contribute to society by cultivating a strong sense of individual justice and morality
Chapman University	mottoeng	Christ and Church
York College of Pennsylvania	mottoeng	To Serve Is to Live
University of San Agustin	mottoeng	Virtue and Science
Catholic University of Korea	mottoeng	Love Truth Service
Sardar Patel University	mottoeng	Character and Conduct are the Fruits of Learning
Aalto University School of Arts, Design and Architecture	mottoeng	For useful arts
Rikkyo University	mottoeng	For God and Country
Westmont College	mottoeng	Christ Holding Preeminence
Sweet Briar College	mottoeng	She who has earned the rose may bear it
Chestnut Hill College	mottoeng	Faith, Charity, Knowledge
Chittagong College	mottoeng	Education is Power
Chosun University	mottoeng	Character Education,
Chosun University	mottoeng	Practical Education,
Chosun University	mottoeng	Specific Education for Talented Students
Manhattan School of Music	mottoeng	Those who excel, thus reach the stars.
Semmelweis University	mottoeng	Protecting And Serving Life
China Europe International Business School	mottoeng	China Depth, Global Breadth
Payame Noor University	mottoeng	Education for all, anywhere and anytime
St. Xavier's College, Kolkata	mottoeng	Nothing Beyond
College of St. Scholastica	mottoeng	\
Dong-ah Institute of Media and Arts	mottoeng	Be the Shining Star in the Field of Broadcasting and Arts
Dankook University	mottoeng	Self-reliance
Dankook University	mottoeng	Independence
Dankook University	mottoeng	National salvation
Dongguk University	mottoeng	Steady one's clean mind, Behave truly and reliably, Love people with benevolence, Save mankind from agony
National Taiwan Ocean University	mottoeng	Honesty, Simplicity, Fraternity, Perseverance
Silver Lake College	mottoeng	\
National Chung Hsing University	mottoeng	Honesty, Simplicity, Advancement, Diligence
High Point University	mottoeng	Nothing Without Divine Guidance
Anderson University	mottoeng	To nourish humanity through the cross
Oxford College of Emory University	mottoeng	The wise heart seeks knowledge &#91;Proverbs 18:15&#93;
University of Natural Resources and Life Sciences, Vienna	mottoeng	University of Life
Hood College	mottoeng	With Heart and Mind and Hand
General Theological Seminary	mottoeng	\
Presbyterian College	mottoeng	While We Live, We Serve
Carlow University	mottoeng	To the Eternal, not the Perishable''
University of Delhi	mottoeng	\
University of Deusto	mottoeng	\
Marine Institute of Memorial University of Newfoundland	mottoeng	\
University of Kerala	mottoeng	Karmani Vyajyate Pradnya
Phillips University	mottoeng	Truth conquers all things
Federal University of Paraná	mottoeng	Science and Work
Indian Institute of Management Bangalore	mottoeng	May our study be brilliant and effective
San Sebastian College – Recoletos de Manila	mottoeng	Love and Knowledge
Qingdao University of Science and Technology	mottoeng	Develop virtue, be diligent in study, have a broad mind, pursue innovation
Franklin Pierce University	mottoeng	Come Out Into the Light
Biocomplexity Institute of Virginia Tech	mottoeng	That I May Serve
Qingdao University	mottoeng	Morality Erudition Truth Innovation
Foundation University	mottoeng	Truth
King's Inns	mottoeng	we shall not be changed
Tokyo Woman's Christian University	mottoeng	Whatsoever Things Are True
St. Stephen's College, Delhi	mottoeng	\
Paris 8 University	mottoeng	World University
Young Harris College	mottoeng	Here Youth is Inspired
Federal University of Ceará	mottoeng	The more united the virtues, the stronger
Ceará State University	mottoeng	Illumination for your way
Novosibirsk State University	mottoeng	We will not make you smarter, we will teach you how to think!
University of St. Francis	mottoeng	Holiness First and Then Learning
Erasmus University Rotterdam	mottoeng	'Make it happen'
University of Colombo	mottoeng	Wisdom Enlightens
Universidad de las Américas Puebla	mottoeng	The love for wisdom will enlarge us
Chowan University	mottoeng	Light and Truth
Taras Shevchenko National University of Kyiv	mottoeng	Utility Honor and Glory
Mahidol University	mottoeng	Do unto others as you would have others do unto you
University of Allahabad	mottoeng	\
University of the Punjab	mottoeng	Faith, Unity, Discipline
Meiji University	mottoeng	Rights, Liberty, Independence and Self-government
Texas Wesleyan University	mottoeng	Knowledge and Vital Piety
St. Xavier's College, Mumbai	mottoeng	Encourage to fly
Universidad de Guanajuato	mottoeng	The Truth Shall Make You Free
University of Oldenburg	mottoeng	Open for new ways
Winthrop University	mottoeng	Truth with liberty
National University of Kyiv-Mohyla Academy	mottoeng	Time is running, Academy is eternal
Maharashtra Institute of Technology	mottoeng	\
Prince Sultan University	mottoeng	Excellence in higher education
National Kaohsiung Normal University	mottoeng	Sincerity, Reverence, Greatness and Profundity
Helderberg College	mottoeng	We learn to serve others
Westminster College, Oxford	mottoeng	Through Virtue and Faith
County College of Morris	mottoeng	Dare to know
University College Utrecht	mottoeng	Sun of Righteousness, shine upon us
Concordia University	mottoeng	The Cross of Christ is Light to Me
Catholic Pacific College	mottoeng	Sift everything, hold on to what is good.
Bluefield College	mottoeng	God, Country, Light
Universidad Autónoma de Nuevo León	mottoeng	Encouraging the flame of truth
Korea University	mottoeng	\
McKendree University	mottoeng	The Disciplines of the Arts, of Morals and of Religion
St Mary's University, Twickenham	mottoeng	Show Thyself a Mother\
Government Engineering College, Thrissur	mottoeng	Perfection in skill through practice
Eastern Nazarene College	mottoeng	\
Eastern Nazarene College	mottoeng	and the Life\
Knox College, Toronto	mottoeng	The word gives light
Federal University of Santa Catarina	mottoeng	Arts and Science
Konstfack	mottoeng	\
Basser College, University of New South Wales	mottoeng	Knowledge
H. Sophie Newcomb Memorial College	mottoeng	\
Mahasarakham University	mottoeng	Public Devotion Is a Virtue of the Learned
University of Hamburg	mottoeng	for Research, Teaching and Education
Edgewood College	mottoeng	Heart Speaks to Heart
University of Technology, Malaysia	mottoeng	In the Name of God for Mankind
St. Mary's Seminary and University	mottoeng	Apostolic and public
Federal University of Juiz de Fora	mottoeng	Spread the Light.
Federal University of Paraíba	mottoeng	Knowledge Builds
Newman University, Wichita	mottoeng	The charity of Christ urges us
Ohio Dominican University	mottoeng	To contemplate truth and to share with others the fruits of this contemplation
Universiti Putra Malaysia	mottoeng	With Knowledge We Serve
University of Karachi	mottoeng	O my Lord! Advance me in Knowledge
San Beda College	mottoeng	Faith, Knowledge, Virtues
Harrisburg Area Community College	mottoeng	Knowledge Restores Truth
Cégep de Saint-Laurent	mottoeng	An institution with a soul
University of the Western Cape	mottoeng	Look Ahead
Tyndale University College and Seminary	mottoeng	Servants of Christ
University of Khartoum	mottoeng	God - Truth - Our Country - Humanity
University of Malta	mottoeng	\
Marymount Manhattan College	mottoeng	Direct Us By Thy Light
Westminster Choir College	mottoeng	Let us be judged by our deeds
Dar ul-Funun	mottoeng	Mighty is he who has knowledge
Dar ul-Funun	mottoeng	By knowledge the old hearts grow young again
Guangzhou University	mottoeng	Encyclopaedic Studying;
Guangzhou University	mottoeng	Sincere Practice;
Guangzhou University	mottoeng	Trend Tide and Welcome Wave
Brno University of Technology	mottoeng	Have the courage to be wise
Southwestern College	mottoeng	There is Light
St. Mary's University, Calgary	mottoeng	In Your Light We Shall See Light
Ewha Womans University	mottoeng	Knowledge·Goodness·Beauty
Hiwassee College	mottoeng	Founded in Faith. Forged in Excellence
Pontifical North American College	mottoeng	\
Bashkir State University	mottoeng	First among Equals.
Columbia College Chicago	mottoeng	To be, rather than to seem
Aquinas College	mottoeng	Truth and Love
Judson University	mottoeng	Christ, the Light of the World
Albright College	mottoeng	Truth and Justice
Saint Anselm College	mottoeng	\
Burapha University	mottoeng	Gaining Intellectual Knowledge Brings Happiness.
Andrews University	mottoeng	Body, Mind, Spirit
Langara College	mottoeng	Knowledge is Freedom
Benedictine University	mottoeng	That in all things God may be glorified
École nationale de l'aviation civile	mottoeng	The aeronautical reference
Yuan Ze University	mottoeng	Sincerity, Diligence, Thrift, Prudence
Farmer School of Business	mottoeng	To Accomplish Rather Than To Be Conspicuous
Lyceum of the Philippines University	mottoeng	Truth and Courage, For God and Country
South Texas College of Law	mottoeng	Let Justice and Truth Prevail
University of Belgrano	mottoeng	\
University of Piura	mottoeng	The universal study of knowledge in Piura
Ghulam Ishaq Khan Institute of Engineering Sciences and Technology	mottoeng	رَبِّ زدْنيِ عِلْماً
Ghulam Ishaq Khan Institute of Engineering Sciences and Technology	mottoeng	O my Lord! Advance me in Knowledge
National Agrarian University	mottoeng	For a comprehensive and sustainable agricultural development
Institut d'études politiques de Lyon	mottoeng	Under the guidance of valor, accompanied by good fortune
University of Évora	mottoeng	Honest study mixed with long experience
University of Washington Bothell	mottoeng	\
Universidad Autónoma de Santo Domingo	mottoeng	Dean of the New World
Universidade Aberta	mottoeng	In any place of the World
Universidade Nova de Lisboa	mottoeng	All the city divided against itself will not remain
University of Stuttgart	mottoeng	Science for the People, People for the Science
National Louis University	mottoeng	Wisdom Dignity Judgement
Sardar Vallabhbhai National Institute of Technology, Surat	mottoeng	Charioteer of Science
North Eastern Regional Institute of Science and Technology	mottoeng	\
Indian Institute of Management Kozhikode	mottoeng	Diligence leads to Excellence
Lithuanian University of Health Sciences	mottoeng	Health for the Fatherland
Henan University	mottoeng	To illustrate illustrious virtue; to renovate the people; and to rest in the highest excellence
Portuguese Air Force Academy	mottoeng	And no less by arms than by letters
Military Academy	mottoeng	It is sweet and honorable to die for the Fatherland
Naval School	mottoeng	The talent of doing well
Belmont Abbey College	mottoeng	That in all things God may be glorified
University of Valladolid	mottoeng	Knowledge built its house
Ateneo de Zamboanga University	mottoeng	In the Service of God and Country
Feng Chia University	mottoeng	Loyalty, diligence, sincerity and perseverance
Campbell University	mottoeng	To the stars through difficulties
Franklin & Marshall College	mottoeng	Light and Law
VIT University	mottoeng	A place to learn; a chance to grow.
Visva-Bharati University	mottoeng	Where the world makes a home in a single nest
Tennessee Wesleyan University	mottoeng	Light and Truth
Immaculata University	mottoeng	Knowledge Flourishes in Virtue
Indian Institute of Management Indore	mottoeng	Achievement is Rooted in Management
Neumann University	mottoeng	To Live the Truth in Love
College of Saint Rose	mottoeng	In Thy Light We Shall See Light
Dominican University	mottoeng	Love and Truth
Gardner–Webb University	mottoeng	For God and Humanity
National Institute of Technology, Kurukshetra	mottoeng	Hard Work and Consistent Efforts
Malaviya National Institute of Technology, Jaipur	mottoeng	Diligence leads to Excellence
Park University	mottoeng	“Faith and Work”
Central Philippine University	mottoeng	\
Alagappa University	mottoeng	Excellence in action
All India Institute of Medical Sciences Delhi	mottoeng	\
University of Yangon	mottoeng	There's no friend like wisdom
Russian State University for the Humanities	mottoeng	Centuries-old Tradition, Contemporary Technology
Lviv University	mottoeng	Educated citizens - glory of the Motherland
National Chung Cheng University	mottoeng	To innovate with earnestness; be virtuous with altruism
University of Great Falls	mottoeng	In Thy Light We See Light
École de l'air	mottoeng	\
Indian Institute of Technology	mottoeng	\
Stonehill College	mottoeng	Light and Hope
Ural State Technical University	mottoeng	\
Louisiana Scholars' College	mottoeng	\
ESIEE	mottoeng	Let's invent the future
ESIEE	mottoeng	Schools of technological innovation
Rutgers University–Camden	mottoeng	Sun of righteousness, shine upon the West also.
Rutgers University–Newark	mottoeng	Sun of righteousness, shine upon the West also.
Westminster College	mottoeng	Faith and Knowledge
Universidad Francisco Marroquín	mottoeng	The education and spreading of ethical, judicial, and economic principles of a society of free and responsible persons
Symbiosis Society	mottoeng	The world is one family
University of Dar es Salaam	mottoeng	Wisdom is Freedom
National Mineral Resources University	mottoeng	Diligence in conducting the affairs of the Fatherland and love for the good thereof
University of Wisconsin–La Crosse	mottoeng	Mind and Body
Royal College of Physicians of Ireland	mottoeng	By reason and experience
Indian Institute of Technology	mottoeng	Education is Character
University of Arkansas at Little Rock	mottoeng	Culture, Truth, Knowledge
University of Peshawar	mottoeng	O' God, Increase my Knowledge
Lagos State University	mottoeng	For Truth and Service
University of Medicine, Mandalay	mottoeng	Service, Sympathy, Humanity
University of Medicine 1, Yangon	mottoeng	Service, Sympathy, Humanity
National College of Business and Arts	mottoeng	Educating Globally Competitive Filipinos
San Sebastián University	mottoeng	Believe, create, undertake
Universidad La Salle	mottoeng	Remain Undivided
St. Berchmans College	mottoeng	Charity or Love of one's Fellow men is true Nobility.
Andhra University	mottoeng	\
Cégep de l'Outaouais	mottoeng	It's a lot more than just a CEGEP
University of Cape Coast	mottoeng	Truth, Our Guide
Charité	mottoeng	Research, Teaching, Healing, Helping
Lucian Blaga University of Sibiu	mottoeng	Mind moves matter
Western New England University	mottoeng	Knowledge Integrity Service
Damascus University	mottoeng	And say: My Lord, increase me in knowledge .
National Defence Academy	mottoeng	Service Before Self
Pontifical Bolivarian University	mottoeng	Integral education for social and human transformation
Cégep de Matane	mottoeng	Share our passions!
Marietta College	mottoeng	Light and truth
Bahria University	mottoeng	Discovering Knowledge
University of Music and Performing Arts, Vienna	mottoeng	Tradition and Innovation
University of the Highlands and Islands	mottoeng	University-level study in the Highlands and Islands
University of Port Elizabeth	mottoeng	Unyielding Faith
St. Francis College	mottoeng	My God, My All
Punjabi University	mottoeng	Education Empowers
Instituto Superior de Engenharia de Coimbra	mottoeng	Innovation Success Entrepreneurship Creativity
Kwame Nkrumah University of Science and Technology	mottoeng	The knot of wisdom is untied only by the wise
Newman University, Birmingham	mottoeng	From the shadow to the truth
University of Worcester	mottoeng	Aspire to Inspire
Kannur University	mottoeng	tamasomā jyotir gamaya From darkness, lead me to light
Guru Gobind Singh Indraprastha University	mottoeng	Cleave the darkness and light through knowledge.
Tunghai University	mottoeng	Truth, Faith, Deeds
Providence Christian College	mottoeng	In Christ all things new
University of Law	mottoeng	May we learn the laws and ordinances
AFDA, The South African School of Motion Picture Medium and Live Performance	mottoeng	Our actions create us
National University of La Plata	mottoeng	For science and the motherland
University of Natal	mottoeng	Star of the morning
Wycliffe College, Toronto	mottoeng	\
Huron University College	mottoeng	True Religion and Sound Learning
Johnson C. Smith University	mottoeng	Let There Be Light
Velammal Engineering College	mottoeng	Dedication, Determination and Distinction
Sogang University	mottoeng	Be obedient to the truth
Istanbul Bilgi University	mottoeng	We do not learn for the school, but for life
National University of Rosario	mottoeng	Educating thoughtful men
Mackenzie Presbyterian University	mottoeng	Tradition and Pioneering in Education
National University of Costa Rica	mottoeng	The truth makes us free
Kenyatta University	mottoeng	Knowledge Is A Source of Strength
China University of Geosciences	mottoeng	Being austere and simple, keeping on practice and acting for truth
University of the Cloister of Sor Juana	mottoeng	To know in order to value. To value in order to choose.
SCU Leavey School of Business	mottoeng	For the Greater Glory of God
Santa Clara University School of Engineering	mottoeng	For the Greater Glory of God
Cebu Doctors' University	mottoeng	\
ICESI University	mottoeng	\
Anton de Kom University of Suriname	mottoeng	Creating and sharing knowledge in sustainable partnership
Motilal Nehru National Institute of Technology Allahabad	mottoeng	Success comes through hard work
National Institute of Technology, Durgapur	mottoeng	Work Maketh a Man
Beijing University of Technology	mottoeng	Taking persistence in pursuit as the substance, taking innovation everyday as the way
Catholic University of Ireland	mottoeng	[Our Lady] Seat of Wisdom, Pray for Us
University of Kelaniya	mottoeng	Self-purification is by insight
National Law University, Jodhpur	mottoeng	knowledge is empowerment
Amarillo College	mottoeng	The College of Surpassing
Mahatma Gandhi University	mottoeng	Knowledge makes one immortal
Chicago Medical School	mottoeng	Life in Discovery
Indian Military Academy	mottoeng	Valour and Wisdom
Birla Institute of Technology, Mesra	mottoeng	Learning is that which Liberates
Kasturba Medical College, Manipal	mottoeng	Inspired by Life
Indian Council of Agricultural Research	mottoeng	\
China Medical University	mottoeng	Compassion, Prudence, Diligence, Integrity
King Edward Medical University	mottoeng	Aim high
University of Monterrey	mottoeng	The man is only realized at the service of the man
St. Augustine's Seminary	mottoeng	May Love, Like the Sun, Reign Alone
Bolivarian Military University of Venezuela	mottoeng	History, Constitution, Defense
Islamic Azad University	mottoeng	Iranian Aspirations for Globalization
Sri Venkateswara College	mottoeng	Truth through self-education
Queens University of Charlotte	mottoeng	Not to be served but to serve
Amsterdams Lyceum	mottoeng	Literal: Rather perish than despair
Universidad de Zamboanga	mottoeng	\
National Institute of Technology, Srinagar	mottoeng	Lead me from Darkness to Light
Fr. Conceicao Rodrigues College of Engineering	mottoeng	\
International University in Geneva	mottoeng	provide the highest quality education for student success in business and related careers
Sindh Madressatul Islam University	mottoeng	Enter To Learn Go Forth to Serve
Sant'Anna School of Advanced Studies	mottoeng	Committed to excellence
Holy Family University	mottoeng	I am bound by my responsibilities
University of Pittsburgh at Bradford	mottoeng	Truth and Virtue
New England College	mottoeng	\
University of Winchester	mottoeng	Wisdom and Knowledge
Holkar Science College	mottoeng	Lead me from Darkness to Light
Jawaharlal Institute of Postgraduate Medical Education and Research	mottoeng	Truth Cures
Camborne School of Mines	mottoeng	The glory of work  play  \
University of Calicut	mottoeng	Nirmāya karmana sree
University of Pittsburgh at Greensburg	mottoeng	Truth and Virtue
Army Burn Hall College	mottoeng	To what heights can I not rise?
District University of Bogotá	mottoeng	Where there is truth there is freedom
National Institute of Technology, Silchar	mottoeng	May our education be brilliant and radiant
Aletheia University	mottoeng	Pious, solid, hard-working, serving, scientific, healthy, progressive
Cardinal Stritch University	mottoeng	To value the better things
Notre Dame de Namur University	mottoeng	\
Edward Waters College	mottoeng	Academic, Spiritual, Physical
Veer Narmad South Gujarat University	mottoeng	Truth, Knowledge, Infinity
Philadelphia College of Osteopathic Medicine	mottoeng	The Mind and the Hand
National University of Cuyo	mottoeng	Life is in the wingbeat of the spirit
Bethlehem University	mottoeng	Remain Undivided
Louisiana College	mottoeng	God, Truth, Country
Ranchi University	mottoeng	\
Emilio Aguinaldo College	mottoeng	Virtue, Excellence, Service
VNR Vignana Jyothi Institute of Engineering and Technology	mottoeng	\
Emmanuel College	mottoeng	God With Us
Lesley University	mottoeng	I Had Perished Had I Not Persisted
Irvine Valley College	mottoeng	“From possibility to actuality”
St. Thomas College, Thrissur	mottoeng	The Truth Will Set You Free
St. John's University, Shanghai	mottoeng	Light and Truth
Jiwaji University	mottoeng	Education brings Aplomb and Glory
Pontifical Catholic University of São Paulo	mottoeng	Wisdom and Science will be increased
Brevard College	mottoeng	Learn in Order to Serve
Dr. A.P.J. Abdul Kalam Technical University	mottoeng	Excellence in action is yoga
University of Hyderabad	mottoeng	\
University of Duisburg-Essen	mottoeng	open-minded
Daytona State College	mottoeng	Knowledge is power
Indonesian State College of Accountancy	mottoeng	\
Instituto Tecnológico de Buenos Aires	mottoeng	To the light peacefully I go
Jaypee Institute of Information Technology	mottoeng	Education,  Enlightenment, Empowerment
Barton College	mottoeng	They shall have the light of life
Mehran University of Engineering and Technology	mottoeng	Nurturing the Engineering Graduates with enhanced Perception and Wide Perspective
University of Balochistan	mottoeng	O' God, Increase my Knowledge
Sardar Bahadur Khan Women's University	mottoeng	O' God, Increase my Knowledge
Gomal University	mottoeng	University at Glance
Pakistan Military Academy	mottoeng	Men at their Best
University of Malakand	mottoeng	University at Glance...'
Ave Maria University	mottoeng	From the Heart of the Church
Ave Maria University	mottoeng	The Splendor of Truth
Islamia Science College	mottoeng	\
Colegio de Santo Tomas – Recoletos	mottoeng	Charity and Knowledge
University of Washington Tacoma	mottoeng	Let there be light
Industrial University of Santander	mottoeng	\
Kookmin University	mottoeng	3.0
École pour l'informatique et les techniques avancées	mottoeng	Computer science and information technology
Aurora University	mottoeng	\
William Peace University	mottoeng	To be, rather than to seem
St. Augustine's University	mottoeng	The truth will set you free
University of Chichester	mottoeng	By teaching, we learn
Universidad de Sta. Isabel	mottoeng	Where Love is Service
Texas College	mottoeng	\
Pontifical Catholic University of Rio de Janeiro	mottoeng	With wings, nothing is heavy
Shenzhen University	mottoeng	Independent, Self-discipline, Self-improvement
Shenzhen University	mottoeng	Be down-to-earth and constantly strive for self-perfection
S. P. Jain Institute of Management and Research	mottoeng	Knowledge is Nectar
Piedmont Technical College	mottoeng	Gateway to success
Cheung Sha Wan Catholic Secondary School	mottoeng	Self-strengthening and Continuous Improvement
Saint Francis de Sales Seminary	mottoeng	\
Southwestern University of Finance and Economics	mottoeng	To persistently strive for the benefit of people and society
College of Mount Saint Vincent	mottoeng	\
Mount Saint Mary College	mottoeng	Teach Me the Truth
University of Mannheim	mottoeng	Truth in everything should be the supreme law
Bangkok University	mottoeng	Knowledge with Virtue
Acton School of Business	mottoeng	Acton's mission is to prepare talented and dedicated students for extraordinary lives as principled entrepreneurs.
National University of Tucumán	mottoeng	Feet on the ground, eyes on the sky
Guru Nanak Dev University	mottoeng	The Lamp of Guru’s wisdom Illuminates and Enlightens
Universidad Autónoma Agraria Antonio Narro	mottoeng	Earth is The Mother Who Feeds
Tehran University of Medical Sciences	mottoeng	The way to the future
University of Hagen	mottoeng	Knowledge Itself Is Power
Maulana Azad National Institute of Technology	mottoeng	Knowledge is greatest jewel.
Pannalal Girdharlal Dayanand Anglo Vedic College	mottoeng	From Ignorance Lead me to Truth
University of Pittsburgh at Johnstown	mottoeng	Truth and Virtue
Angelicum College	mottoeng	Charity, Justice and Fortitude
William Woods University	mottoeng	Love Conquers All
Western University of Health Sciences	mottoeng	To Teach, To Heal, Together
Central University of Finance and Economics	mottoeng	Loyalty, Unity, Truth, Innovation
James Cook University Singapore	mottoeng	\
Universidade do Vale do Paraíba	mottoeng	Science and Work
Universidad de San Carlos de Guatemala	mottoeng	Go forth and teach everyone
Marywood University	mottoeng	Holiness, Knowledge, Health
Bahçeşehir University	mottoeng	A world university in the heart of Istanbul
Alvernia University	mottoeng	To Learn, To Love, To Serve
Symbiosis Law School	mottoeng	The world is one family
King Mongkut's University of Technology Thonburi	mottoeng	\
University of N'Djamena	mottoeng	Here and anywhere on Earth
Lasell College	mottoeng	\
Marymount California University	mottoeng	Direct Us by Thy Light
Avila University	mottoeng	With the help of God there is nothing to fear.
St. Bridget College	mottoeng	\
University of Bahrain	mottoeng	\
Sanata Dharma University	mottoeng	Excellent and Humanist
American University of Rome	mottoeng	\
Black cadets at the United States Coast Guard Academy	mottoeng	The sea yields to knowledge
Rush University	mottoeng	Minister through scientific knowledge
Universidad San Francisco de Quito	mottoeng	Study, Progress, Work
Guangdong University of Foreign Studies	mottoeng	Moral integrity, exemplary behaviour, and conversance with both Eastern and Western learning
Methodist University	mottoeng	Truth and Virtue
Cégep Limoilou	mottoeng	The Cégep Limoilou, the Cégep in town
Ural State University	mottoeng	Beware the man of one book
University of Swaziland	mottoeng	The Scripture Is The Pillar Of The Nation
Federal University of Pernambuco	mottoeng	Fearless Virtue
Cégep de Baie-Comeau	mottoeng	Where I live!
Collège d'Alma	mottoeng	An interesting life
Cégep de la Gaspésie et des Îles	mottoeng	A great natural environment in which to study
Cégep de La Pocatière	mottoeng	Come for a change of air
Cégep régional de Lanaudière	mottoeng	Together we will go  now!
Cégep de Lévis-Lauzon	mottoeng	The passion for learning,
Cégep de Lévis-Lauzon	mottoeng	or The passion for knowledge
Collège Édouard-Montpetit	mottoeng	Never too big to know you
Bangladesh Military Academy	mottoeng	Ever High is My Head
Clearwater Christian College	mottoeng	Prepared in mind and soul
Holy Names University	mottoeng	Honor, Nobility, Virtue.
Chung Hua University	mottoeng	Diligence, Simplicity, Truthfulness, Justness
Universidad Anáhuac México Sur	mottoeng	Defeat Evil with Good
Tomsk Polytechnic University	mottoeng	Knowledge, freedom, and prosperity
University of Peradeniya	mottoeng	Knowledge is the Eye Unto All
Southern New Hampshire University	mottoeng	\
Saint Francis of Assisi College System	mottoeng	Faith And Humility
University of Seoul	mottoeng	Truth, Creation, Public Service
Santo Domingo Institute of Technology	mottoeng	Accept the Challenge
Mar Baselios College of Engineering and Technology	mottoeng	Leading to the Heights of Excellence
Sri Venkateswara University	mottoeng	\
Tamil Nadu Theological Seminary	mottoeng	The Way, The Truth, The Life
Saint Louis University	mottoeng	\
Elms College	mottoeng	\
Bay Path University	mottoeng	Seize the Day
Murray College	mottoeng	Faith, Unity, Discipline
Gujarat University	mottoeng	Diligence leads to Excellence
Rajiv Gandhi School of Intellectual Property Law	mottoeng	Perfection in action is Yoga
Marymount University	mottoeng	Direct Us by Thy Light
Safdarjung Hospital	mottoeng	Body is indeed the primary instrument of dharma
Pabna Cadet College	mottoeng	Perseverance is Success
Lyceum-Northwestern University	mottoeng	Technology, Art, Science
Zhejiang University of Technology	mottoeng	Good Virtue and Robust Practice, from I Ching
Daugavpils University	mottoeng	Through knowledge you win
Collège des Ingénieurs	mottoeng	Learning Through Action
Cégep Beauce-Appalaches	mottoeng	Superior Training. Passion ... Action!
University of Faisalabad	mottoeng	O my Lord! Advance me in Knowledge
Geneva School of Diplomacy and International Relations	mottoeng	To Govern is to Serve
Adolfo Ibáñez University	mottoeng	The Truth Set Us Free
Kuyper College	mottoeng	Pray and work
Università Cattolica del Sacro Cuore	mottoeng	In the heart of reality
National Institute of Technology, Hamirpur	mottoeng	There is no substitute for hard work.
Technological University of the Philippines	mottoeng	Foundation of the Nation
Nikola Vaptsarov Naval Academy	mottoeng	We are children of the sea
New Bulgarian University	mottoeng	Do not fear variety
Colégio Militar	mottoeng	One for all and all for one
Cedar Crest College	mottoeng	Divinity, Liberty and Knowledge
Don Bosco Technical College	mottoeng	Come Up to a Higher Place
College of the Holy Spirit of Tarlac	mottoeng	Truth in Love
Pachaiyappa's College	mottoeng	\
Northwestern Polytechnical University	mottoeng	Loyalty, Integrity, Courage, and Perseverance
University of Naples Federico II	mottoeng	For the inculcation of the sciences and the dissemination of knowledge
Hochschule Wismar	mottoeng	Being Shrewd
Adventist University of France – Collonges	mottoeng	Teach to serve
Management Development Institute	mottoeng	Perfection in action is Yoga
St Joseph's College, Darjeeling	mottoeng	Lift up your heart
Regional Science High School for Region 1	mottoeng	\
New Asia College	mottoeng	Sincerity and intelligence
Gwynedd Mercy University	mottoeng	Truth and Mercy
St. Joseph's College	mottoeng	Speaking the wonderful works of God
Laguna College	mottoeng	Knowledge, Country, Liberty
Columbia College	mottoeng	Valiantly bear the cross
National University of Córdoba	mottoeng	Proclaim my name before the people
Tezpur University	mottoeng	Specialized Knowledge Promotes Creativity
University of Split	mottoeng	Meet, Learn, Explore, Study
Khalsa College, Amritsar	mottoeng	With God's Grace
Guru Nanak Khalsa College of Arts, Science & Commerce	mottoeng	\
Regional Institute of Management and Technology	mottoeng	\
Institut International de Lancy	mottoeng	Work and succeed together
Athenaeum of Ohio	mottoeng	To advance in wisdom, age and grace
University of Liberia	mottoeng	Light out of darkness
University of National and World Economy	mottoeng	The Spirit Makes The Power
University of the Faroe Islands	mottoeng	Gentle elves set light to lead the Faroes on the starry way from age to age
Gandhara University	mottoeng	Knowledge is Vision
Pontificia Universidad Católica Madre y Maestra	mottoeng	Truth and Science
University of Craiova	mottoeng	Life without literature is death
University of Toronto Mississauga	mottoeng	So much has been entrusted to us
Voorhees College	mottoeng	In vain without god
Xiangtan University	mottoeng	Knowledge, Action and Virtue
South Ural State University	mottoeng	I shall either find a way or make one
Favaloro University	mottoeng	Humanistic formation - Scientific rigor - International prestige
Hakuoh University	mottoeng	Further beyond
Underwood International College	mottoeng	The truth will set you free
San Sebastian College–Recoletos de Cavite	mottoeng	Love and Zeal for the Knowledge of Truth
Colegio San Agustin – Biñan	mottoeng	Virtue and Science
Shengda Economics, Trade and Management College of Zhengzhou	mottoeng	Be thrift, be simple, be independent
Marian University	mottoeng	As a lily among thorns
Federal University of Bahia	mottoeng	Virtue of the Spirit
Morris College	mottoeng	\
Darul Huda Islamic University	mottoeng	“Verily on Us is the guidance.”
Federal Center for Technological Education of Rio de Janeiro	mottoeng	A look to the future: Technological Federal University of Rio de Janeiro
Cégep de l'Abitibi-Témiscamingue	mottoeng	Craftsman of the future
Sree Kerala Varma College	mottoeng	Pure be My Life for Ever
Tamkang University	mottoeng	Simplicity Truthfulness Firmness Perseverance
De La Salle Andres Soriano Memorial College	mottoeng	To God Through Faith, Morals, and Culture
University of St. La Salle	mottoeng	Religion, Morals, Culture
Bundelkhand Institute of Engineering & Technology	mottoeng	Let noble thoughts flow into my mind from all directions
Lyle School of Engineering	mottoeng	The Truth Shall Set You Free
Colegio Bilingue Real	mottoeng	Serve, to be great.
Sant Longowal Institute of Engineering and Technology	mottoeng	Excellence in action is yoga
College of Saints John Fisher & Thomas More	mottoeng	\
Rosemont College	mottoeng	Lift your eyes to the hills
Cox School of Business	mottoeng	The Truth Shall Set You Free
Colegio San Agustin – Bacolod	mottoeng	Virtue and Science
MacEwan University	mottoeng	Through learning we flourish
Kaunas University of Technology	mottoeng	Knowledge, ability, strength
University of Nueva Caceres	mottoeng	\
Sam Higginbottom Institute of Agriculture, Technology and Sciences	mottoeng	Serve the land and feed the hungry
Holy Apostles College and Seminary	mottoeng	They are like stars
Mahatma Gandhi Kashi Vidyapith	mottoeng	Knowledge Imparts Immortality
Kansas Wesleyan University	mottoeng	Victory not without Toil
Utkal University	mottoeng	Seek The Highest Truth
Khulna University of Engineering & Technology	mottoeng	Oh Lord! Bestow me with Knowledge
Yantai University	mottoeng	Be trustworthy, be down-to-earth, be fond of learning, and practice earnestly
Chung Chi College	mottoeng	In Pursuit of Excellence
United College	mottoeng	Make one's virtues shine and renew the people
Polytechnic University of Nicaragua	mottoeng	Serving the community
Federal Urdu University	mottoeng	Inspiring Achievement
KIIT University	mottoeng	Knowledge is that which liberates
Ateneo de Tuguegarao	mottoeng	I Believe in the Lord
K. N. Toosi University of Technology	mottoeng	The Oldest Technical University of Iran
University of Health Sciences	mottoeng	God and Country
St. Joseph's College, Tiruchirappalli	mottoeng	For the Good & the True
King's University College	mottoeng	Christ is the Way the Truth and the Life
Islamic Azad University Dental Branch of Tehran	mottoeng	Iranian aspirations for globalization
Indian Institute of Information Technology and Management, Gwalior	mottoeng	Knowledge is elixir for the world
Thomas More College of Liberal Arts	mottoeng	\
Mid West Business Institute	mottoeng	Leading through Learning
Wilfrid Laurier University	mottoeng	Truth conquers all
Ispahani Public School & College	mottoeng	Enter to learn, leave to serve
Australian Lutheran College	mottoeng	Pray and Work
Miriam College	mottoeng	\
Indian Institute of Technology Madras	mottoeng	\
St. Xavier's College, Mapusa, Goa	mottoeng	Formation for Transformation
Virginia Tech School of Public and International Affairs	mottoeng	That I May Serve
Konkuk University	mottoeng	Sincerity ,
Konkuk University	mottoeng	Fidelity ,
Konkuk University	mottoeng	Righteousness
Cuttington University	mottoeng	With Holiness and Wisdom
Yunnan University	mottoeng	Perfection in Moral Integrity, Excellence in Scholarly Attainments, and Greatness in Career Pursuits
Dedman School of Law	mottoeng	The Truth Shall Set You Free
Andrés Bello Catholic University	mottoeng	To make known the manifold wisdom of God
St. Xavier's College, Maitighar	mottoeng	Dedicated to Excellence, Leadership and Service
PSG College of Arts and Science	mottoeng	Knowledge, Love and Work
Government Law College, Mumbai	mottoeng	Let No Evil Enter
Nantong University College of Medicine	mottoeng	Bridging China And The West,Striving For The Best
Sikkim Manipal University	mottoeng	'Inspired Learning'
Satyawati College	mottoeng	\
Christian Medical College, Ludhiana	mottoeng	Gold, Frankincense and Myrrh
National University of the Littoral	mottoeng	Inextinguishable light
Transbaikal State University	mottoeng	We do not learn for the school, but for life
Telecom & Management SudParis	mottoeng	Moving forward, together
Manuel L. Quezon University	mottoeng	\
Tzu Chi University	mottoeng	Kindness, Compassion, Joy, and Unselfish Giving
National Institute of Science Education and Research	mottoeng	Knowledge Imparts Immortality
University Institute of Engineering and Technology, Kanpur	mottoeng	\
Holy Angel University	mottoeng	Praise God Always
University of Pittsburgh at Titusville	mottoeng	Truth and Virtue
Maejo University	mottoeng	Hard Work Never Kills Anyone
University of Auckland Law School	mottoeng	By natural ability and hard work
Gauhati University	mottoeng	Achievement through Learning/Knowledge
International Buddhist College	mottoeng	For the Good of the Many
University of Education	mottoeng	Truth, The Ultimate Virtue
Stratford University	mottoeng	Knowledge is power
Ukrainian Catholic University	mottoeng	Know thyself
Maulana Azad Medical College	mottoeng	\
Saint Joseph University	mottoeng	For the greater glory of God
Holy Name University	mottoeng	\
City College of New York	mottoeng	Look behind, look here, look ahead
Macdonald Campus	mottoeng	Mastery for Service
New York University	mottoeng	To persevere and to excel
New Design University	mottoeng	Standard is dangerous
McGill University	mottoeng	By work, all things increase and grow
Université de Montréal	mottoeng	It shines by faith and knowledge
University of Toronto	mottoeng	As a tree through the ages
Queen's University	mottoeng	Wisdom and knowledge shall be the stability of thy times
Jaypee University of Engineering and Technology	mottoeng	Education, Enlightenment, Empowerment
University of Negros Occidental – Recoletos	mottoeng	Love and Knowledge
Kabarak University	mottoeng	Education in Biblical Perspective
Pondicherry University	mottoeng	From Darkness, towards the Light!
Gheorghe Asachi Technical University of Iași	mottoeng	Knowledge itself is power
National Taiwan University of Science and Technology	mottoeng	Precision in Work, Sincerity in Attitude
Randolph College	mottoeng	Life More Abundant
Universiti Sultan Zainal Abidin	mottoeng	Knowledge for the Benefit of Humanity
Fordham University School of Law	mottoeng	In the Service of Others
St. Clair County Community College	mottoeng	Such is the path to knowledge
Periyar University	mottoeng	Wisdom Maketh World
Universidad Metropolitana	mottoeng	Teaching the Way
St. Vincent Ferrer Seminary	mottoeng	Being human through knowledge and reason that leads to faith.
Pontificio Collegio Filippino	mottoeng	\
Universidad Americana	mottoeng	Academic Excellence
University of Tripoli	mottoeng	He has taught man that which he knew not
Shahed University	mottoeng	University of Merits
Trinity University of Asia	mottoeng	For God and Country
Faculdade de Ciências e Tecnologia da Universidade Nova de Lisboa	mottoeng	Any city divided against itself will not last
Devi Ahilya Vishwavidyalaya	mottoeng	\
Tata Institute of Social Sciences	mottoeng	Re-Imagining Futures
University of Paris III: Sorbonne Nouvelle	mottoeng	Here and anywhere on Earth
Royal Holloway, University of London	mottoeng	To be, rather than to seem
Sri Sri University	mottoeng	Learn - Lead - Serve
Symbiosis Institute of Geoinformatics	mottoeng	The world is one family
Mariano Marcos State University	mottoeng	\
Telecom SudParis	mottoeng	Moving forward, together
Rutgers School of Business – Camden	mottoeng	Sun of righteousness, shine upon the West also.
Telecom Business School	mottoeng	Managing through Technology
Saint Joseph's College of Maine	mottoeng	“Courage and Hope”
University of Guelph	mottoeng	\
Medical Universities	mottoeng	Service, Sympathy, Humanity
Polytechnic University of the Philippines Bataan	mottoeng	Light of the Nation
State University of New York Upstate Medical University	mottoeng	Let knowledge grow from more to more; and so be human life enriched
Chaudhary Charan Singh Haryana Agricultural University	mottoeng	Agriculture is supreme wealth
Jagannath University	mottoeng	Education, Faith, Discipline
Mahatma Phule Krishi Vidyapeeth	mottoeng	\
Rajendra Agricultural University	mottoeng	Lead me from darkness to light
Fazl Ali College	mottoeng	Second to None in Academics
Uganda Martyrs University	mottoeng	In Virtue and Wisdom Lead the World
Polytechnic University of the Philippines Taguig	mottoeng	Light of the Nation
St. Paul University Manila	mottoeng	\
Senate of Serampore College	mottoeng	The wise will possess glory
American University of Kuwait	mottoeng	Learn • Think • Become
Estonian Aviation Academy	mottoeng	With efforts to heights
St. John's Seminary	mottoeng	God is love
Lake Erie College of Osteopathic Medicine	mottoeng	We Care for the Whole Person
Services Institute of Medical Sciences	mottoeng	In Thy light shall we see light
National Formosa University	mottoeng	Integrity, Righteousness, Spirit, Diligence
University of Lübeck	mottoeng	Focus on Life
Bogor Agricultural University	mottoeng	Searching and Serving The Best
Immanuel College	mottoeng	Ever Higher
Muzaffarpur Institute of Technology	mottoeng	Work is above everything else
Ho Chi Minh City University of Technology and Education	mottoeng	Comprehensive development, sustainability and international integration
National Kaohsiung First University of Science and Technology	mottoeng	Dedication, camaraderie, excellence, and innovation
Yangon Institute of Economics	mottoeng	Stamina, Genius; Loyalty, Oath
Harbin University of Science and Technology	mottoeng	Unity of knowledge Hiroatsu distant
Paris School of Economics	mottoeng	Economics serving society
University of Medicine 2, Yangon	mottoeng	Service, Sympathy, Humanity
University of Mount Olive	mottoeng	A Christian College for Men and Women
Los Andes Peruvian University	mottoeng	Towards Academic Excellency
University of Brunei Darussalam	mottoeng	Towards Human Perfection
Yunnan University of Finance and Economics	mottoeng	Innovation
Assumption University	mottoeng	Work Conquers All
José Matías Delgado University	mottoeng	Everything with Honor
National Institute of Technology, Tiruchirappalli	mottoeng	Truth Alone Triumphs
Washington and Lee University School of Law	mottoeng	\
Hans Raj College	mottoeng	From darkness, lead me to light.
National Research University – Higher School of Economics	mottoeng	“Not for the school but for life we study”
Lake Forest College	mottoeng	And the truth shall set you free
Shaw College	mottoeng	Cultivate virtue, go more deeply into what I have learned
Father Saturnino Urios University	mottoeng	\
Brandenburg University of Technology	mottoeng	Engineering Solutions for a Sustainable Future
Medical University of Varna	mottoeng	Your success is our goal!
Johns Hopkins School of Nursing	mottoeng	Forever Watchful
Regional Science High School for Region 2	mottoeng	\
Saint Joseph's College of Quezon City	mottoeng	\
St. Joseph Seminary	mottoeng	The Sower Went Out
Chaoyang University of Technology	mottoeng	Diligence, Character and Action
Jain Vishva Bharati University	mottoeng	Right conduct is the essence of right knowledge
Baguio Central University	mottoeng	Liberty, Justice, Truth, Equality
Caucasus University	mottoeng	For a great future
University of British Columbia Okanagan	mottoeng	\
Chhatrapati Shahu Ji Maharaj University	mottoeng	\
Veer Bahadur Singh Purvanchal University	mottoeng	\
Chaudhary Charan Singh University	mottoeng	Where that supreme treasure of Truth resides
University of Pennsylvania School of Design	mottoeng	Laws without morals are in vain
University of Balamand	mottoeng	And you know what is right
Samrat Ashok Technological Institute	mottoeng	Excellence in action is yoga.
Saint Mary's College of Quezon City	mottoeng	The fear of the Lord is the beginning of wisdom.
Zhongnan University of Economics and Law	mottoeng	Learned, Rational, Virtuous, Devoted
Polytechnic University of the Philippines Quezon City	mottoeng	Light of the Nation
Asian Social Institute	mottoeng	An Asian Graduate School with a Difference
Polytechnic University of the Philippines San Pedro	mottoeng	Light of the Nation
Tulane University Law School	mottoeng	\
Notre Dame of Dadiangas University	mottoeng	School: Education Towards Excellence and Human Integrity
Notre Dame of Dadiangas University	mottoeng	Marist: All to Jesus through Mary
Virginia Tech Corporate Research Center	mottoeng	That I May Serve
University of Selangor	mottoeng	Towards Excellence
Pontifical Catholic University of Rio Grande do Sul	mottoeng	Leading to the truth
Kharkiv National University of Economics	mottoeng	We teach to learn, to think, to work.
Ateneo de Naga University	mottoeng	First, the Kingdom of God
Universidad de Especialidades Espíritu Santo	mottoeng	Not going forward, is going backwards
Jawaharlal Nehru Technological University, Anantapur	mottoeng	excellence in action is yoga
Universidad Tecnológica de Santiago	mottoeng	Knowledge and Experience
Virginia Tech Foundation	mottoeng	That I May Serve
Namibia University of Science and Technology	mottoeng	Technology and development
South China Normal University	mottoeng	Foster the spirit of working hard;
South China Normal University	mottoeng	Pursue studies with utmost rigour;
South China Normal University	mottoeng	Seek truth from facts to blaze new trails;
South China Normal University	mottoeng	And be a model of virtue for others.
Royal Naval College	mottoeng	We are and hope to become
Manila Central University	mottoeng	Solidarity in Science
Jinnah University for Women	mottoeng	Enter to learn and go to serve
Lady Hardinge Medical College	mottoeng	\
Yokohama City University	mottoeng	Emphasis on education, student-centeredness, and local contribution
Northcentral University	mottoeng	One-to-One Education By Experience
University of Siegen	mottoeng	Creating a humane future
EAFIT University	mottoeng	Inspire Create Transform
University of Nottingham Ningbo China	mottoeng	\
University of Sri Lanka	mottoeng	Knowledge is the eye unto all.
Keshav Mahavidyalaya	mottoeng	\
North College Thessaloniki	mottoeng	\
Cégep de Saint-Jérôme	mottoeng	With a program that inspires you,  you have all you need to succeed!
Mater Dei College	mottoeng	Wisdom , Love , Prayer
Chien Hsin University of Science and Technology	mottoeng	A Better Tomorrow for Chien Hsin
Sher-e-Bangla Agricultural University	mottoeng	Research, Education, Extension
National Taiwan University of Arts	mottoeng	Truth, Goodness, and Beauty
Dr. NTR University of Health Sciences	mottoeng	\
University of Saint Mary	mottoeng	Virtue and Science
University of Saint Mary	mottoeng	Be Inspired.
Cégep de Rimouski	mottoeng	Learn Enjoy Live Achieve
Newbold College	mottoeng	Life Changing - Faith Affirming
Agro ParisTech	mottoeng	\
Philadelphia University	mottoeng	The Way To The Future
Maharshi Dayanand University	mottoeng	\
Loyola College of Culion	mottoeng	Strong in Faith
Symbiosis International University	mottoeng	The world is one family
Tamil University	mottoeng	Whatever you think, think it in a big way
Lumière University Lyon 2	mottoeng	The knowledge between pages
Columban College	mottoeng	\
Calcutta School of Music	mottoeng	Teaching of music and nurturing talent.
Collegio Borromeo	mottoeng	Humility
University of Huelva	mottoeng	Dare to Know
Kuvempu University	mottoeng	\
National University of Equatorial Guinea	mottoeng	University for all, even the lesser people
St. Joseph's College, Bangalore	mottoeng	Faith and Toil
Zeppelin University	mottoeng	Bridging Business Culture and Politics
Beykent University	mottoeng	The right choice for a professional life
Nippon Sport Science University	mottoeng	Rich and Powerful Lives Based on Physical Education
Ross University School of Medicine	mottoeng	Dedicated to the science of healing
Colegio de San Lorenzo	mottoeng	In the Service of the Lord
Defence Services Academy	mottoeng	Triumphant Elites of the Future
Cavite National Science High School	mottoeng	\
Dumaguete Science High School	mottoeng	\
Birla Institute of Technology and Science, Pilani – Goa Campus	mottoeng	\
Birla Institute of Technology and Science, Pilani – Goa Campus	mottoeng	''
Cor Jesu College	mottoeng	\
Andrés Bello National University	mottoeng	Tradition and Modernity
Guru Nanak Dev Engineering College, Ludhiana	mottoeng	Contemplate and reflect upon knowledge, and you will become a benefactor to others.
Orfalea College of Business	mottoeng	To Learn by Doing
Aditya College	mottoeng	May learning illuminates us both, the teacher and the taught.
Ningbo University	mottoeng	\
University of Valle	mottoeng	The best for the best
Federal University of ABC	mottoeng	Cutting Edge University For The 21st Century
California Southern University	mottoeng	Knowledge conquers all
Han Chiang High School	mottoeng	Knowledge and obedience are very important
China Pharmaceutical University	mottoeng	Be proficient and benefit others
Bapuji Institute of Engineering & Technology	mottoeng	enlightenment only in the work
National University of Engineering	mottoeng	Leader in Science and Technology
University of Commercial Sciences	mottoeng	People who succeed
Sardar Raja College of Engineering	mottoeng	Love and Serve Mankind through Education
Virginia Tech Institute for Policy and Governance	mottoeng	That I May Serve
Indian Institute of Science Education and Research, Mohali	mottoeng	In Pursuit of Knowledge
I-Shou University	mottoeng	Pragmatism and Innovation
Nizhyn Gogol State University	mottoeng	By work and diligence
Mahatma Gandhi Antarrashtriya Hindi Vishwavidyalaya	mottoeng	Knowledge Peace Friendship
Punjab University College of Information Technology	mottoeng	Leading the Nation in IT Education
Dow International Medical College	mottoeng	Prevention Is Better than Cure..
Sokoine University of Agriculture	mottoeng	Land is Treasure
St. Joseph's College of Commerce	mottoeng	Faith and Toil
Supélec	mottoeng	A \
Jawaharlal Nehru National College of Engineering	mottoeng	Truth alone triumphs
School of Geodesy and Geomatics, Wuhan University	mottoeng	Work hard, Get along well, Aspire after truth and Blaze new trails
University of Nariño	mottoeng	We possess as much as we know
Vivekananda Degree College	mottoeng	Only the learning that liberates is true
Deen Dayal Upadhyaya College	mottoeng	Truth Alone Triumphs
Universidad Autónoma de Yucatán	mottoeng	Light, Science and Truth
St. Mary's College of Meycauayan	mottoeng	The fear of the Lord is the beginning of wisdom
European University at Saint Petersburg	mottoeng	Bringing the Best Together
Universidad Autónoma de San Luis Potosí	mottoeng	\
Topiwala National Medical College	mottoeng	May we be free from disease through education
Hunan Agricultural University	mottoeng	Integrity Industry Verity and Innovation
Southern Leyte State University	mottoeng	Knowledge. Service. Innovation.
Rutgers University – New Brunswick	mottoeng	Sun of righteousness, shine upon the West also.
Taylor College and Seminary	mottoeng	For God and Truth
Institute of Management Development and Research, Pune	mottoeng	\
National Ilan University	mottoeng	Studying diligently, practicing with earnestness, developing a respectful attitude toward professionalism
Cagayan de Oro College	mottoeng	\
Paulo Freire University	mottoeng	Education for life
Nicaraguan University of Science and Technology	mottoeng	Decide your future
San Carlos Seminary	mottoeng	Humility
Universiti Sains Islam Malaysia	mottoeng	Knowledgeable, Disciplined and Devout
Universiti Malaysia Terengganu	mottoeng	Ocean of Discoveries For Global Sustainability
Universiti Malaysia Kelantan	mottoeng	Entrepreneurship Is Our Thrust
Universiti Malaysia Sarawak	mottoeng	Contemporary & Forward Looking
Universiti Malaysia Sabah	mottoeng	Strive to Excel
National Kaohsiung Marine University	mottoeng	loyalty, trustworthiness, industriousness and bravery
National Kaohsiung University of Hospitality and Tourism	mottoeng	Perfect, Honest, Diligent, Modest
National Kaohsiung University of Applied Sciences	mottoeng	Altruism, Perseverance, Competence, and Diligence
Aquinas University	mottoeng	In a Life of Truth and of Love out of Gratitude
Jinggangshan University	mottoeng	spirit of education
St. Theresa's Medical University	mottoeng	Study depends on the good will of the student, a quality which cannot be secured by compulsion
National University of the Northeast	mottoeng	Quality, Excellence and Pertinence
Universidad Nueva Esparta	mottoeng	Passion for the future
Universidad Alejandro de Humboldt	mottoeng	A Dynamic Approach in Higher Education
Doshisha Women's College of Liberal Arts	mottoeng	I am the true vine
St. Paul University Quezon City	mottoeng	The charity of Christ urges us
Universiti Utara Malaysia	mottoeng	Scholarship, Virtue, Service
Holy Child Academy	mottoeng	Light and way of life
Japanese Red Cross Toyota College of Nursing	mottoeng	Together, for Humanity
University of the Immaculate Conception	mottoeng	The fear of the Lord is the Beginning of Wisdom.
Chihuahua Institute of Technology	mottoeng	Technology for the aggrandizement of Mexico
University of Al-Qadisiyah	mottoeng	My Lord Giveth Thy Knowledge
Federal University of Uberlândia	mottoeng	Committed to provide free and high quality public education
Udayanath College of Science and Technology	mottoeng	Academic Excellence
Riverside College, Bacolod	mottoeng	Light and Charity
Anaheim University	mottoeng	Unity through Diversity
Federal University of Technology – Paraná	mottoeng	Technology and Humanism
Asian College of Technology	mottoeng	Wisdom is Power
Wadi International University	mottoeng	Your gateway to success
University of the Visayas	mottoeng	\
Royal Danish Naval Academy	mottoeng	Neither rashly nor timidly
Central University of Nicaragua	mottoeng	Thinking about your future
Collège Notre Dame de Jamhour	mottoeng	For the greater glory of God
Rutgers School of Engineering	mottoeng	Sun of righteousness, shine upon the West also
Ohalo College	mottoeng	Expanding Horizons
Ayya Nadar Janaki Ammal College	mottoeng	For God and Country
Shanghai Finance University	mottoeng	Display honesty and cultivate virtue, foster ambition and contribute to society
Cégep de Victoriaville	mottoeng	Your Choices for your life
National Defence University of Malaysia	mottoeng	Duty, Honour, Integrity
Hansung University	mottoeng	Truth and Virture
National University of Río Cuarto	mottoeng	To believe... To create... To grow...
Aichi Shukutoku University	mottoeng	Living with Diversity
Saku University	mottoeng	Autonomy, Creativity and Friendship
Shoin University	mottoeng	\
Ningxia University	mottoeng	Truth and innovation through virtuous and diligent study
Tama Art University	mottoeng	Freedom and Will
Health Sciences University of Hokkaido	mottoeng	Intellectual, moral and physical education
King Saud bin Abdulaziz University for Health Sciences	mottoeng	A university for a nation's health.
Federal University for Latin American Integration	mottoeng	A University without Boundaries
Jiangxi Agricultural University	mottoeng	\
Harvard University	mottoeng	Truth
Goa Medical College	mottoeng	Truth is Eternal and Beautiful
Collège International Marie de France	mottoeng	Together, a world to discover
FH Aachen	mottoeng	Good in practice. And in theory.
Anglian College London	mottoeng	Knowledge is Power
Saint Columban College	mottoeng	For God and country
Rajiv Gandhi Institute of Technology, Mumbai	mottoeng	Knowledge is the ultimate aim
University of Medicine, Magway	mottoeng	Service, Sympathy, Humanity
National Aviation University	mottoeng	Live! Win! Create!
RMIT University Vietnam	mottoeng	(Literally, 'a campus of the Royal Melbourne Institute of Technology')
George Washington University School of Business	mottoeng	In God Our Trust
Scuola Superiore Studi Pavia IUSS	mottoeng	Dare to know
Ghislieri College	mottoeng	Knowledge and morals are the perfection of the human mind.
Amrita School of Engineering	mottoeng	The earnest aspirant gains supreme wisdom
Ajay Binay Institute of Technology	mottoeng	\
Instituto Social Militar Dr. Dámaso Centeno	mottoeng	\
Southwestern University	mottoeng	Science Integrity Fidelity
Imam Hossein University	mottoeng	Making skilled manpower
Immaculate Heart of Mary Seminary	mottoeng	Behold How Good
Morningside College	mottoeng	Scholarship, Virtue, Service
Lee Woo Sing College	mottoeng	Wisdom, Humanity, Integrity, Harmony
Wu Yee Sun College	mottoeng	Scholarship and Perseverance
Anugrah Narayan College, Patna	mottoeng	Education is the greatest enligtenment
Northeast Forestry University	mottoeng	Promoting excellent learning and noble virtue
York Time Institute	mottoeng	Time Devours All
Hajvery University	mottoeng	Unveiling the Veiled
Durango Institute of Technology	mottoeng	The Technique at the Service of the Country
Autonomous University of Tamaulipas	mottoeng	Truth, Beauty, Probity
Chapingo Autonomous University	mottoeng	To teach the exploitation of the land, not the exploitation of the men.
Autonomous University of Tlaxcala	mottoeng	Social justice through culture
Polytechnic University of the Philippines	mottoeng	Light of the Nation
Autonomous University of Baja California Sur	mottoeng	Wisdom as goal, fatherland as destiny
Irish Baptist College	mottoeng	Lord I Follow
University of Mindanao	mottoeng	Truth Conquers All
Northwest A&F University	mottoeng	Be honest, modest, brave and resolute
Providence University	mottoeng	Virtue with Knowledge
Royal Danish Military Academy	mottoeng	With wisdom and weapons
Royal Danish Air Force Officers School	mottoeng	Strength through knowledge
Kazimierz Pułaski University of Technology and Humanities in Radom	mottoeng	To the dignified future
Carteret Community College	mottoeng	Education For Life
University of Maryland, College Park	mottoeng	Strong deeds, gentle words
SGTB Khalsa College	mottoeng	Look Forward
Indian Institute of Technology Ropar	mottoeng	Guide in the Right Direction
Asia University	mottoeng	Health, Care, Innovation, Excellence
Begum Rokeya University	mottoeng	Knowledge is Power
St. Xavier's Technical Institute	mottoeng	The Joy of Excellence in a World of High Technology
Indian Institute of Technology Indore	mottoeng	Knowledge is for the well-being of everyone
Indian Institute of Technology Jodhpur	mottoeng	You are the entire knowledge and science
Enverga University	mottoeng	For God and Country
Saint Michael College of Caraga	mottoeng	\
Technological University of Panama	mottoeng	On the way to excellence by means of continuous improvement
Soochow University	mottoeng	Unto A Full Grown Man
La Salette of Roxas College	mottoeng	For God and Country
Imam Khomeini International University	mottoeng	Scientific development, Islamic awakening
Dr. Babasaheb Ambedkar Technological University	mottoeng	Development through Technology
National Power Training Institute	mottoeng	Together In Pursuit Of Excellence
Wuhan University School of Medicine	mottoeng	Strength through self-renewal, strive to persevere, aspire for the truth, toil to discover.
Beacon College	mottoeng	Illuminating the Life Abundant
Islamic Azad University of Parand	mottoeng	Iranian Aspirations for Globalization
Sinte Gleska University	mottoeng	Reenforcing our foundation for the people to go forward in the Lakota Way.
Konark Institute of Science and Technology	mottoeng	\
Ardhi University	mottoeng	Research. Education. Consultation.
Konkuk University Law School	mottoeng	Sincerity ,
Konkuk University Law School	mottoeng	Fidelity ,
Konkuk University Law School	mottoeng	Righteousness
Hunan Institute of Engineering	mottoeng	Perseverance and Initiative
Université de Montréal Faculty of Law	mottoeng	We will defend our rights
Skolkovo Moscow School of Management	mottoeng	Helping successful people become more successful.
Skolkovo Moscow School of Management	mottoeng	Developing people able to develop themselves and the world.
National University of Defense Technology	mottoeng	Excel in Virtue and Knowledge; Strengthen the Armed Forces and the Nation
Changchun University of Science and Technology	mottoeng	Virtuous, Learned, Truthful, Innovative
The Islamic College	mottoeng	Higher Education in an Islamic Environment
University of Haifa	mottoeng	Academic excellence with a personal touch
Willingdon College	mottoeng	DES:Union is strength
University of Borås	mottoeng	Science for the professions
Chang Gung University	mottoeng	Diligence, Perseverance, Frugality and Trustworthiness
Siena College	mottoeng	Developing Leaders Capable of Extraordinary Achievement
American International College	mottoeng	\
Virginia Tech College of Agriculture and Life Sciences	mottoeng	That I May Serve
Mzumbe University	mottoeng	Let us Study for the Development of the People
Abasyn University	mottoeng	Passion to Design Future....
Longyan University	mottoeng	Hou Yu xue Min Yu De
Don Bosco College, Canlubang	mottoeng	Born For Greater Things
Regional Science High School III	mottoeng	\
Naogaon Government College	mottoeng	Knowledge is power
St. Aloysius College	mottoeng	Shine to Enkindle
Hubei Institute of Fine Arts	mottoeng	Uphold morals, Devoted to study, Quick in action and Aspire to beauty
Lycée privé Sainte-Geneviève	mottoeng	To Serve
Jiangsu University	mottoeng	Be erudite, practical and virtuous
University of Cauca	mottoeng	he who has to die give his light to posterity
University of Sucre	mottoeng	'We walk toward excellence'
Islamic Azad University of Ahar	mottoeng	Iranian aspirations for globalization
National University of Colombia at Medellín	mottoeng	Search for the truth in the academy classrooms
National University of Colombia at Palmira	mottoeng	Search for the truth in the academy classrooms
Comanche Nation College	mottoeng	Come Study With Us
National University of Colombia at Leticia	mottoeng	Search for the truth in the academy classrooms
National University of Colombia at San Andrés	mottoeng	Search for the truth in the academy classrooms
National University of Colombia at Manizales	mottoeng	Search for the truth in the academy classrooms
National University of Colombia at Arauca	mottoeng	Search for the truth in the academy classrooms
Academy of Christian Humanism University	mottoeng	University to think
Dayeh University	mottoeng	Using the hands and mind together; dedicated and gregarious
Polytech Group	mottoeng	We meet the challenges of tomorrow
Graduate School of Chinese Academy of Social Sciences	mottoeng	Inquire for truth, inspect to thoughts; insight through misleadings, involve with virtues
Indian Institute of Science Education and Research, Bhopal	mottoeng	Eat nectar through knowledge, i.e. be immortal through knowledge
University of Quindío	mottoeng	Challenges, dreams and commitments
Labette Community College	mottoeng	Where It's All About You!
Helsinki Metropolia University of Applied Sciences	mottoeng	Expertise and insight for the future
New College Berkeley	mottoeng	Let Us Walk in the Newness of Life
Sri Pratap College	mottoeng	Fly high and higher
Lunghwa University of Science and Technology	mottoeng	Diligence, Dedication, Honesty, and Simplicity
Wake Forest University School of Law	mottoeng	For Humanity
Quaid-e-Awam University of Engineering, Science and Technology	mottoeng	To provide quality and state-of-the-art education
Keiser University	mottoeng	Purity, Truth, Wisdom
National Pingtung University of Science and Technology	mottoeng	Benevolent and True
Chung Shan Medical University	mottoeng	Honesty, Love, Excellence, Diligence
North Lakhimpur College	mottoeng	Let  noble thoughts come from all directions
Yenepoya University	mottoeng	O Lord! Increase me in knowledge
Duisenberg School of Finance	mottoeng	For leaders in finance
Holy Cross of Davao College	mottoeng	From Faith to Truth
National Penghu University of Science and Technology	mottoeng	Innovation, Practicality, Modesty, Love-caring
Central University of Rajasthan	mottoeng	Education for Sustainable Development
Indian Naval Academy	mottoeng	\
EU Business School	mottoeng	One University, One Network
University of Pamplona	mottoeng	The doors are open for all, but above all the heart is.
Popular University of Cesar	mottoeng	Education and Future
Belarusian State Medical University	mottoeng	Art and humanity, work and knowledge
Technological University of the Mixteca	mottoeng	Work and Wisdom gave us Freedom
University of Cundinamarca	mottoeng	From the shadows to the light
Technological University of Pereira	mottoeng	Science and Technology at the service of Humanity, tutelage by freedom
University of Magdalena	mottoeng	A university for all
Binalbagan Catholic College	mottoeng	\
Pangasinan State University	mottoeng	Vision, Commitment, and Engagement
Baylor University	mottoeng	For Church, For Texas.
Mount Carmel College, Bangalore	mottoeng	To Jesus through Mary
RCSI-Bahrain	mottoeng	Scholarship and Dexterity
University of the City of Manila	mottoeng	\
University of Pangasinan	mottoeng	Fatherland, Virtue, Science
University of Puthisastra	mottoeng	Honor Self, Respect Others, Develop Society
Birla Institute of Technology, Patna	mottoeng	Learning is that which Liberates
Ecole Polytechnique de l'Université d'Orléans	mottoeng	Let's meet the challenges of tomorrow
Colegio de Dagupan	mottoeng	God's Given Gifts Developed by Man
Institut Galilée	mottoeng	And yet it moves
Acharya Jagadish Chandra Bose College	mottoeng	Education for All
SBS Sarajevo Business School	mottoeng	\
Universidad Católica Santa María La Antigua	mottoeng	Give me understanding to live
G. B. Pant University of Agriculture and Technology	mottoeng	\
Muhimbili University of Health and Allied Sciences	mottoeng	Education. Treatment. Research.
University of Petroleum and Energy Studies	mottoeng	\
University of Luzon	mottoeng	Skills and Values
National University %22Yaroslav the Wise Law Academy of Ukraine%22	mottoeng	Long live the law
Solvay Brussels School of Economics and Management	mottoeng	The School's regime is severe
JNTUA College of Engineering, Pulivendula	mottoeng	Efforts are skillfulness in action
Northwestern University in Qatar	mottoeng	Whatsoever things are true
University of Pretoria	mottoeng	With zeal and perseverance I strive towards the goal
Universidad Intercontinental	mottoeng	\
Universidad del Desarrollo	mottoeng	University of Excellence
ESME-Sudria	mottoeng	For more than a century, the ESME-Sudria has been training engineers in the fields of Energy, Electronics, Telecommunications, Mathematics and Computer Engineering
Dominican College of Tarlac	mottoeng	Faith, Country, Wisdom
Sido Kanhu Murmu University	mottoeng	Ability to separate milk from water
University of Wisconsin–Madison	mottoeng	\
University of Wisconsin–Madison	mottoeng	\
Bhim Rao Ambedkar College	mottoeng	Shine in your own Glory
St. Pius X Seminary	mottoeng	To restore all things in Christ
Indian School, Salalah	mottoeng	From Darkness to Light
Universidad Del Pacífico – Ecuador	mottoeng	Forming Entrepreneurs with an International Vision
Bangor University	mottoeng	\
Polytechnic University of the Philippines Santo Tomas	mottoeng	Light of the Nation
Capitol University	mottoeng	\
Cégep de Sorel-Tracy	mottoeng	Have success in your heart
Zhengzhou College of Economics	mottoeng	Behave admirably, empathetically, creatively and know thyself
Government Engineering College, Kozhikode	mottoeng	Trust. Pride. Decisiveness.
University of Missouri–St. Louis	mottoeng	The Welfare of the People
University of Missouri	mottoeng	Let the Welfare of the People be the Supreme Law
Our Lady of Caysasay Academy	mottoeng	Truth and Love
National Pedagogic University	mottoeng	Educating Educators
Nueva Granada Military University	mottoeng	Science, Country, Family
Hrodna State University	mottoeng	High-quality education, research, modern technologies - for good of a person, society and nation.
EPSCI	mottoeng	Acting As Pioneers
Gautam Buddha University	mottoeng	Character, Creativity, Competence
National Yunlin University of Science and Technology	mottoeng	Sincerity, Honor, Perseverance, Originality
Ashworth College	mottoeng	To enrich with knowledge
Ramjas College	mottoeng	knowledge has no comparison
Academy of Public Administration	mottoeng	Knowledge for efficient governance!
National Mining University of Ukraine	mottoeng	National Mining University – Moving with the Times
St. Joseph's College of Balanga	mottoeng	\
Alexandru Ioan Cuza University	mottoeng	Through freedom to truth
Wannan Medical College	mottoeng	Professional and Kind, Factualistic and Strong
New England College of Business and Finance	mottoeng	\
Imago Dei College	mottoeng	Let the Reader Understand
University of Jaffna	mottoeng	Discernment is wisdom
National United University	mottoeng	Honesty, Respect, Diligence and Creativity
Aklan Catholic College	mottoeng	For God and Country
National University of Northwestern Buenos Aires	mottoeng	Science and education for social development and regional growth
University of New England College of Osteopathic Medicine	mottoeng	\
Western University College of Podiatric Medicine	mottoeng	To Teach, To Heal, Together
St. Andrew’s College of Arts, Science and Commerce	mottoeng	\
Islamic Azad University of Mahshahr	mottoeng	Seek knowledge from the cradle to the grave
Newport International University	mottoeng	Dedicated to Global Education
Sunchon National University	mottoeng	\
University of Nottingham	mottoeng	\
Sirimavo Bandaranaike Vidyalaya	mottoeng	Learn, Achieve and Bliss.
Quirino State University	mottoeng	A Bastion of Higher Learning in Northern Luzon
Don Honorio Ventura Technological State University	mottoeng	School of Arts and Trades
National Institute of Communicable Diseases	mottoeng	Body is indeed the primary instrument of dharma
IESEG School of Management	mottoeng	Moving forward in a changing world...
HKBP Nommensen University	mottoeng	For God and Country
San Beda College Alabang	mottoeng	Faith, Knowledge, and Virtue
Czech Technical University in Prague	mottoeng	Knowledge is power
HNU College of Law	mottoeng	\
Military Academy	mottoeng	Honor is our property
Birla Institute of Technology and Science, Pilani – Hyderabad Campus	mottoeng	\
Birla Institute of Technology and Science, Pilani – Hyderabad Campus	mottoeng	''
Vimala College	mottoeng	Truth and Love
Faculty of Theology and Religious Studies, Catholic University of Leuven	mottoeng	\
Wuhan Institute of Technology	mottoeng	Unity, Rigour, Diligence and Seeking truth
Yala Technical College	mottoeng	Discipline Knowledge Development
Universidad Francisco de Vitoria	mottoeng	\
Universal Research Group	mottoeng	Gateway to new horizons in Clinical Research.
Jawaharlal Nehru Government Engineering College	mottoeng	\
Central University of Haryana	mottoeng	\
Central University of Kerala	mottoeng	Knowledge is Eternal
Institut Polytechnique des Sciences Avancées	mottoeng	The air, the space, the IPSA
University of Cambridge	mottoeng	Literal: From here, light and sacred draughts
University of Cambridge	mottoeng	Non-literal: From this place, we gain enlightenment and precious knowledge
Sabena Flight Academy	mottoeng	One step ahead
University of Lomé	mottoeng	Faith in the future of the human race
Bost University	mottoeng	Quality is our Priority
University of Miami School of Business Administration	mottoeng	Great is the truth
Holy Trinity University	mottoeng	In The Service of Truth
Ryerson University	mottoeng	With Mind and Skill
MVJ College of Engineering	mottoeng	Engineered for tomorrow...
National Quemoy University	mottoeng	Real knowledge, strong performance, for the good of the world
Universidad Autónoma del Estado de México	mottoeng	Fatherland, Science and Work
Central University of Chile	mottoeng	Independence, Pluralism, Commitment
Angelicum School Iloilo	mottoeng	Truth, Charity, Justice, and Fortitude
European University of Tirana	mottoeng	Quality Sets Us Apart
Abbey Community College	mottoeng	Promoting Spirit and Mind
Universidad Autónoma de Ciudad Juárez	mottoeng	For a scientific life, for a vital science
St. Paul University Iloilo	mottoeng	\
Universidad Anáhuac Cancún	mottoeng	Overcome Evil with Good
Pandit Deendayal Petroleum University	mottoeng	The Reservoir of Knowledge
University of Seychelles	mottoeng	The Future In Your Hands
Escuela Normal Superior Moíses Sáenz Garza	mottoeng	In the vocation of the teacher and in the nobility of the youth, we trust
CITY College, International Faculty of the University of Sheffield	mottoeng	Know your opportunity
Narayana Engineering College	mottoeng	Hard work is the key to success
Catholic University of Salvador	mottoeng	True
Sumy State University	mottoeng	Qualitative education – secure future
Catholic University of Pernambuco	mottoeng	Truth and Life
University of Itaúna	mottoeng	A great university
University of Science and Technology, Sana'a	mottoeng	And say: My Lord, increase me in knowledge .
Catholic University of Santos	mottoeng	Expand the space for the good
Catholic University of Petrópolis	mottoeng	Not be extinguished
Hubei University of Technology	mottoeng	for Morals and Knowledge; for Truth and Innovation
Salve Regina University	mottoeng	Mary, Our Hope
Zunyi Medical College	mottoeng	Be Virtue-conscious, Be Diligent, Be Truth-seeking and Be Practical.
Government Engineering College, Rewa	mottoeng	May our knowledge become brilliant
Colegio de Santa Ana	mottoeng	\
Universidade Feevale	mottoeng	Knowledge to innovate the world
Shree Hareshwar Education Society	mottoeng	There is nothing pure than knowledge
Federal University of Sergipe	mottoeng	Flowing Growth
Coleman University	mottoeng	\
Casa del Niño Jesus de Pagbilao	mottoeng	God Is My Light
Mount St. Joseph University	mottoeng	\
Indian Institute of Management Ranchi	mottoeng	Working to bring change towards success, not only for one’s self, but also for the community.
Unidad Académica Campesina-Carmen Pampa	mottoeng	Learning is metanoia
Christ the King College	mottoeng	The fear of the Lord is the beginning of wisdom
Tanzania Public Service College	mottoeng	Training For Improved Performance
Augustine Institute	mottoeng	You Have Made Us for Yourself
Rajiv Gandhi Proudyogiki Vishwavidyalaya	mottoeng	Consciousness is the Ultimate
Sushila Devi Bansal College of Technology, Indore	mottoeng	Ever Moving Forward
Department of Management Studies, IIT Roorkee	mottoeng	Nothing Is Possible Without Hard Work
Saint Louis College La Union	mottoeng	\
Indian Institute of Management Rohtak	mottoeng	'Management through knowledge and values'
DAV Public School Nerul	mottoeng	Lead from the darkness to the light
Bukovinian State Medical University	mottoeng	Salus populi – suprema lex
Adam Smith School of Economics and Finance	mottoeng	\
Concordia College	mottoeng	\
College of Management Academic Studies	mottoeng	There is a way to success
National University of Tainan	mottoeng	Mercy, Intelligence, Sincerity, Justice
Frederick Community College	mottoeng	Let us move forward with progress
Saint John's School, San Pedro de la Paz	mottoeng	To Find the Way of Truth
Volga State University of Technology	mottoeng	Traditions, quality, perspective
St. John's College De La Salle	mottoeng	Sign of the Faith
Grenfell Campus	mottoeng	Launch forth into the deep
Imus Institute of Science and Technology	mottoeng	Knowledge and Virtue
Campus of the University of Montana	mottoeng	Light and Truth
University of Tennessee	mottoeng	You will know the truth and the truth shall set you free.
St. Stephen's Church, Delhi	mottoeng	Serving humanity in the service of God
Arulmigu Meenakshi Amman College of Engineering	mottoeng	Truth alone Triumphs
Instituto Tecnológico de Oaxaca	mottoeng	Proprietary Technology and Economic Independence
Fordham Graduate School of Arts and Sciences	mottoeng	Wisdom and Learning
Faculty of Philology and Pedagogics of Kazimierz Pułaski University of Technology and Humanities in Radom	mottoeng	The limits of my language mean the limits of my world
Inatel	mottoeng	Train Humanity in Engineering
International House, University of Wollongong	mottoeng	Let harmony prevail
Borys Grinchenko Kyiv University	mottoeng	Education is essence of the Time!
Laguna College of Business and Arts	mottoeng	\
Garrett College	mottoeng	Experience. Explore. Excel.
CECyT	mottoeng	Technology to meet the needs of the Nation
University of Barisal	mottoeng	Knowledge is power
Menéndez Pelayo International University	mottoeng	\
IMS Engineering College	mottoeng	Do your duty and be detached from its outcome
Pope John Paul II College of Education	mottoeng	Let Your Light Shine
Presidents of the University of Montana	mottoeng	Light and Truth
Toulouse School of Economics	mottoeng	At the heart of economics
Kolej Universiti Islam Antarabangsa Selangor	mottoeng	The Catalyst of Knowledge Tradition
Acharya Pathasala Public School	mottoeng	Awake Arise! Stop not till the goal is reached
Katholieke Universiteit Leuven	mottoeng	Seat of Wisdom
Katholieke Universiteit Leuven	mottoeng	or Seat of Knowledge
Indian Institute of Management Kashipur	mottoeng	Imparting Knowledge to make a better India
Durham University	mottoeng	\
State University of Semarang	mottoeng	Healthy, Excellent, Prosperous
Anahuac Mayab University	mottoeng	Overcome Evil with Good
Valencian International University	mottoeng	Your on-line audiovisual university
Arunai University	mottoeng	The One who Works is the Greatest Man.
St. Joseph's School, Karwar	mottoeng	Knowledge is Truth
College of the Muscogee Nation	mottoeng	Preserving the Past, Cultivating Futures.
Loyola University Chicago	mottoeng	For the greater glory of God
Seoul National University of Science and Technology	mottoeng	Your Future, Our Vision
Jaipur Engineering College	mottoeng	Knowledge leads to Happiness
Hang Seng Management College	mottoeng	To study extensively and behave earnestly
S.H. Ho College	mottoeng	Culture, Morals, Devotion, Trustworthiness
Monterrey Center for Higher Learning of Design	mottoeng	My Ideas Are the Future
Medical Colleges of Northern Philippines	mottoeng	I will serve God and Country.
Universidad Mayor	mottoeng	For Entrepreneurial Spirits
Saint Mary's Academy of San Nicolas, Cebu City	mottoeng	\
Christelijke Hogeschool Ede	mottoeng	\
Govt. M.A.O College Lahore	mottoeng	Allah has increased him abundantly in knowledge and stature.
Omer Halisdemir University	mottoeng	Towards New Horizons With the Illumination of the Science
GSS Institute of Technology	mottoeng	\
Ağrı İbrahim Çeçen University	mottoeng	To Search, To Discover, To Serve
SIES College of Arts, Science & Commerce	mottoeng	Rise With Education
SIES College of Commerce and Economics	mottoeng	Rise With Education
Lala Lajpat Rai Institute of Engineering and Technology	mottoeng	Work Works
English and Foreign Languages University	mottoeng	words illumine everything
Collège Montmorency	mottoeng	Achieve
Concordia University of Edmonton	mottoeng	The fear of the Lord is the beginning of wisdom
Indian Institute of Information Technology, Allahabad	mottoeng	Knowledge is Power
Sultan Idris Education University	mottoeng	Knowledge is the Beacon of Pure Character
Walchand College of Engineering, Sangli	mottoeng	Success depends on quality
Canterbury Christ Church University	mottoeng	The truth shall set you free
Government Engineering College, Trivandrum	mottoeng	Speak the truth, Lead a righteous life
Fontbonne University	mottoeng	Virtue and Knowledge
Universiti Teknologi MARA	mottoeng	Endeavour, Religious, Dignified
Briar Cliff University	mottoeng	Mother of Grace, Love
Instituto Politécnico Nacional	mottoeng	Technology to meet the needs of the Nation
National Yang-Ming University	mottoeng	benevolent mind and art, putting knowledge into practice
University of San Francisco	mottoeng	Traditional: For City and University
University of San Francisco	mottoeng	Current Motto: Change the World From Here
Nanjing University	mottoeng	Sincerity with Aspiration, Perseverance and Integrity
Nanjing University	mottoeng	or
Nanjing University	mottoeng	Sincerity, Simplicity, Sturdiness, Greatness, ''Endeavor to Learn, Urge to Act
Kerala Veterinary and Animal Sciences University	mottoeng	Ideas in action
Debrecen Reformed Theological University	mottoeng	Praying and Working
Cégep de Sherbrooke	mottoeng	Creator of dreams
Southland College	mottoeng	\
Colombo Institute of Research & Psychology	mottoeng	\
Latvia University of Agriculture	mottoeng	For the Growth of the Fatherland
Associated Students of the University of Hawaii	mottoeng	Unite to move forward
Krishna Institute of Technology	mottoeng	Knowledge gives Discipline
College of Science, Technology and Applied Arts of Trinidad and Tobago	mottoeng	Transforming Lives...One Student at a Time
Islamic Azad University Central Tehran Branch	mottoeng	Iranian Aspirations for Globalization
South Central University for Nationalities	mottoeng	Be a naturally easy-going person with serious belief and knowledge
Government Engineering College, Jhalawar	mottoeng	Knowledge is the Supreme Goal
Virginia Tech College of Architecture and Urban Studies	mottoeng	That I May Serve
Balasore College of Engineering and Technology	mottoeng	Where Aspiration Becomes Reality.
Muzaffarnagar Medical College	mottoeng	Health To All
Institut Pendidikan Guru Kampus Pendidikan Teknik	mottoeng	Try and serve
Jagannath Barooah College	mottoeng	The light that never fails
Centro de Estudios Superiores Royal	mottoeng	Serve, to be great.
Municipal College, Rourkela	mottoeng	Knowledge imparts Immortality
Santa Clara University College of Arts & Sciences	mottoeng	For the Greater Glory of God
National Chiayi University	mottoeng	Sincerity, Action, Innovation, and Service
Polytechnic University of the Philippines San Juan	mottoeng	Light of the Nation
Korea Naval Academy	mottoeng	Let us pursue the truth. Let us forsake falsehood. Let us sacrifice ourselves.
Andhra Pradesh Police Academy	mottoeng	Requisite Knowledge, Necessary Skills, Right Attitude
Beykent Educational Institutions	mottoeng	Future in the Light of Knowledge
Faculty of Sport and Tourism	mottoeng	Your choice changes everything
National Institute of Technology Goa	mottoeng	True Knowledge Liberates
Synergy Institute of Engineering & Technology	mottoeng	\
National Taipei University of Education	mottoeng	To love and to act
Wheaton College Men's Glee Club	mottoeng	\
Universidad del Noreste	mottoeng	For my country, science and progress
Royal University for Women	mottoeng	Where Women Excel
St. Mary's College of Baliuag	mottoeng	The fear of the Lord is the beginning of wisdom
Educacentre College	mottoeng	The French college in BC
Campuses of Arellano University	mottoeng	For God and Country
St. Thomas College, Palai	mottoeng	Life, Light, Love
Autonomous University of Baja California	mottoeng	For man's fulfillment
Ural Federal University	mottoeng	Think, act, achieve!
Sapahar Government College	mottoeng	Knowledge is power
UCL University Preparatory Certificate	mottoeng	Let all come who by merit deserve the most reward
New Shah Faiz Public School	mottoeng	Starting In The Name Of Allah
Regional Science High School for Region IX	mottoeng	\
St. Joseph College - Olongapo	mottoeng	Christ in the center
Stella Maris Polytechnic	mottoeng	Wisdom, Knowledge & Skills for Service
Catholic Distance University	mottoeng	Joy from the Truth
Galgotias College of Engineering and Technology	mottoeng	Lead me from darkness to light
National Institute of Technology, Arunachal Pradesh	mottoeng	Certainly there is no purifier in this world like Knowledge
Kamineni Institute of Medical Sciences	mottoeng	\
Institute of Management and Information Technology, Cuttack	mottoeng	Knowledge is elixir for the world
Indo Global Colleges	mottoeng	Education alone can give one a life with values
Beijing Information Science & Technology University	mottoeng	Diligence in learning, honor for life
Georgian International Academy	mottoeng	A New Life Begins!
Sagar College of Science	mottoeng	Best Science College in Balasore.
College of the Arts, Windhoek	mottoeng	\
Notre Dame of Midsayap College	mottoeng	Eternal Life
Notre Dame – RVM College of Cotabato	mottoeng	\
Aalim Muhammed Salegh College of Engineering	mottoeng	Oh Lord, Increase my knowledge
Rajasthan Pharmacy College	mottoeng	May All Be Disease-Free
Takoradi Polytechnic	mottoeng	Skills combined with Wisdom accelerates development
Higher Institute of Technology of Ivory Coast	mottoeng	The passion for excellence
University of Dhaka	mottoeng	Truth Will Prevail
Virginia Tech College of Science	mottoeng	That I May Serve
Jagadguru Rambhadracharya Handicapped University	mottoeng	The duty of service is most difficult.
Virginia Tech College of Liberal Arts and Human Sciences	mottoeng	That I May Serve
Universidad Empresarial de Costa Rica	mottoeng	Opportunity
Immaculate Conception Catholic School	mottoeng	\
The Priory Institute	mottoeng	To Praise, To Bless, To Preach
Sri Siddhartha Medical College	mottoeng	Let all be Happy and Prosperous
Universidad Rafael Belloso Chacín	mottoeng	We are Excellency
Virginia Tech College of Natural Resources and Environment	mottoeng	That I May Serve
University Institute of Technology, Burdwan University	mottoeng	Gateway to New Horizon of Excellence
Law School of the Aristotle University of Thessaloniki	mottoeng	Sacrifice to the Muses and Charites.
Sungkonghoe University	mottoeng	Openness, Service, Sharing
Universiti Teknologi MARA System	mottoeng	Endeavour, Religious, Dignified
Free University of Tbilisi	mottoeng	Science, Labour, Liberty
Fukuyama City University	mottoeng	Wisdom opens up tomorrow.
Hanoi University of Agriculture	mottoeng	Agriculture - farmers - rural
Government Arts College, Coimbatore	mottoeng	Dare to be wise
Polytechnic University of the Philippines – Nueva Ecija	mottoeng	Light of the Nation
Polytechnic University of the Philippines Pulilan	mottoeng	The People's University
Karabük University	mottoeng	Your Home for Contemporary Education
University of Toledo	mottoeng	Guide to the Present, Moulder of the Future
Lusíada University of Porto	mottoeng	The sun shines over everyone
Scuola Italiana Design	mottoeng	The School of Ideas
University of Swat	mottoeng	Aspiring for Quality Education with Relevance
Tân Tạo University	mottoeng	To the Stars through Knowledge
Martin Luther University of Halle-Wittenberg	mottoeng	Future with Tradition
University College of Engineering Tindivanam	mottoeng	Progress through Knowledge
Birla Institute of Technology and Science	mottoeng	Knowledge is Power Supreme
Shanghai Jiao Tong University	mottoeng	When you drink water, never shall you forget its source; love your motherland and add credit to your Alma Mater
University of Exeter	mottoeng	We follow the light
Jiangsu Second Normal University	mottoeng	advocating ethics, dedicating to work, seeking truth and blazing new trails
Navodaya Institute of Technology	mottoeng	A Gateway to success in future technology
Symbiosis School of Economics	mottoeng	\
Gobi Arts and Science College	mottoeng	Knowledge, Righteousness and Growth
Gwangju Health University	mottoeng	Find Your Future at GHU; High Five with GHU
Nanjing Ninghai Middle School	mottoeng	Honesty Diligence Courage
Maharaja Agrasen Institute of Management and Technology	mottoeng	the intricacies of actions are very mysterious
North Bennet Street School	mottoeng	An Education in Craftsmanship
St. John's Cathedral School	mottoeng	Spirit and Life
Harper Adams University	mottoeng	Useful and agreeable
Manuela Beltrán University	mottoeng	Education for the freedom and development
Amrita Vishwa Vidyapeetham	mottoeng	\
Dr. Ram Manohar Lohia Avadh University	mottoeng	Dedicated to Truth
Political Academy of the Socialist Party of Albania	mottoeng	People who get ahead in the world today are those that require such conditions or circumstances they want and if you do not find these favorable conditions make them yourself. You're one of them
A. D. Patel Institute of Technology	mottoeng	There is nothing in the world equal in purity to knowledge.
Dan Academic Center	mottoeng	The Industry's Academy
Polytechnic University of the Philippines Parañaque	mottoeng	The People's University
Virginia Tech College of Engineering	mottoeng	That I May Serve
Georgian Institute of Public Affairs	mottoeng	In this sign you will conquer
Dharmaram College	mottoeng	\
Panjab University Swami Sarvanand Giri Regional Centre, Hoshiarpur	mottoeng	Lead us unto the Light from Darkness
Sreegopal Banerjee College	mottoeng	sā vidyā yā vimuktaye\
Ishan Institute of Management & Technology	mottoeng	Knowledge is Elixir
R.P. Sharma Institute of Technology	mottoeng	Knowledge is only real beauty
Millia Institute of Technology	mottoeng	To impart world class technical education to the far eastern rural students.
Ibrahim Sultan Polytechnic	mottoeng	Global Knowledge Leader
University of the Gambia	mottoeng	Knowledge Truth Development
Service d'exploitation de la formation aéronautique	mottoeng	Professionalism & Excellence
Meenakshi College for Women	mottoeng	Fidelity, Faith, Fortitude
Anglo-European College of Chiropractic	mottoeng	\
Honder College of Inner Mongolia Normal University	mottoeng	Believe in yourself - must be successful!
Gandhi Medical College, Bhopal	mottoeng	Lead us from Untruth to Truth
Maakhir University	mottoeng	Education is a key to success
Minerva Schools at KGI	mottoeng	Critical Wisdom
Omsk Law Academy	mottoeng	Noblesse oblige
DHA Suffa University	mottoeng	With Enlightened Vista for Top Quality
St. Paul College, Pasig	mottoeng	\
Cooperative University of Colombia	mottoeng	«A University, an entire country»
Islamic Azad University of Zanjan	mottoeng	\
Central University of Jammu	mottoeng	knowledge refines, purifies and sharpens the mind
Aleemiyah Institute of Islamic Studies	mottoeng	\
Mediterranean Institute of Fundamental Physics	mottoeng	From doubt comes wisdom. Mind daring always.
ESIEE Amiens	mottoeng	Let's invent the future
ESIEE Paris	mottoeng	Schools of technological innovation
Toulouse Tech	mottoeng	Technology and Management grandes écoles network
Open University of Kaohsiung	mottoeng	Expertise, diligence, perseverance, pragmatism
Government Syed Hatem Ali College	mottoeng	More Light
Sikkim Manipal Institute of Technology	mottoeng	Excellence through Innovation
Cyprus Police Academy	mottoeng	Law Knowledge Morals
Afe Babalola University	mottoeng	Labor for service and Integrity
CAE Global Academy Phoenix	mottoeng	One step ahead
University Institute of Technology RGPV	mottoeng	Consciousness is the Ultimate
CAE Oxford Aviation Academy Douala	mottoeng	One step ahead
Greenwich University, Karachi	mottoeng	Work conquers all
Abra Valley Colleges	mottoeng	To Glorify no one but God
Sacred Heart Canossian School	mottoeng	the Way, the Truth and the Life
Campbell University School of Osteopathic Medicine	mottoeng	Mind Body Spirit
Union of Independent Grandes Écoles	mottoeng	Independence for excellence
Kish International Campus, University of Tehran	mottoeng	Rest not a moment from learning
Thirumalai Engineering College	mottoeng	The Right Place to Enrich your Career
Berchmans Institute of Management Studies	mottoeng	Charity or Love of one's fellow men is true nobility.
Istanbul Aydın University	mottoeng	Towards A Bright Future
Benazir Bhutto Shaheed University	mottoeng	Knowledge is Power
Green Park Educational Institutions	mottoeng	Hard work, Discipline, Wisdom
Qufu Normal University	mottoeng	Insatiable in learning, tireless in teaching
Escuela Bancaria y Comercial	mottoeng	The Business School of Mexico
International Design school for Advanced Studies, Hongik University	mottoeng	Once IDAS, Forever IDAS!
Krishnath College School	mottoeng	From darkness, lead me to light
Mahidol University International College	mottoeng	Do unto others as you would have others do unto you
Saint Ferdinand College	mottoeng	Pray and Work
Sichuan University of Science and Engineering	mottoeng	Aspiration together with Diligence, Morality in conformity with Truth.
Nova Scotia Agricultural College	mottoeng	\
All India Institute of Medical Sciences Bhopal	mottoeng	\
All India Institute of Medical Sciences Raipur	mottoeng	Health is Wealth and Happiness
Washington-Alexandria Architecture Center	mottoeng	That I May Serve
Catholic University of Cameroon, Bamenda	mottoeng	Faith and rationality
Holy Family Hospital	mottoeng	Serving humanity in the service of God
Islamic Azad University Medical Branch of Tehran	mottoeng	Iranian aspirations for globalization
CECOS University of Information Technology and Emerging Sciences	mottoeng	''Engineering Your Career\
Shaheed Benazir Bhutto Women University	mottoeng	Enlightment through Knowledge
Crescent Convent School	mottoeng	Starting In The Name Of Allah
Changsha University	mottoeng	Seek For Noble Mind, Profound Knowledge, Strong Physique and Consummate Skills.
Saint Paul University Surigao	mottoeng	Love, Truth and Knowledge
Centro Universitário das Faculdades Metropolitanas Unidas	mottoeng	1.262304E9
Iqra Institute for Higher Education	mottoeng	Baro saad u noolaatid
Filatov Institute of Eye Diseases and Tissue Therapy	mottoeng	Everyone should see the sun!
National University of Food Technologies	mottoeng	Faith, tradition, honor
National University	mottoeng	We live through learning
University of Saint Louis Tuguegarao	mottoeng	\
Kharkiv State University of Food Technology and Trade	mottoeng	The quality of the third millennium
Universiti Tenaga Nasional	mottoeng	Generates Professionals
Universiti Tenaga Nasional	mottoeng	Creative, Innovative & Energetic
Beuth University of Applied Sciences Berlin	mottoeng	Study the future
Universidad de la Comunicación	mottoeng	Though, Comprehension and Action
Rutgers Business School – Newark and New Brunswick	mottoeng	Sun of righteousness, shine upon the West also.
Government Post Graduate College	mottoeng	And He to Whom wisdom is granted receiveth indeed a benefit overflowing
Fisheries College and Research Institute	mottoeng	\
NETES Institute of Technology and Science Mirza	mottoeng	\
Missouri Photo Workshop	mottoeng	Show truth with a camera
Walther Theological Seminary	mottoeng	But we preach Christ crucified
Morthland College	mottoeng	Light, Service, and Truth
JNTUH College of Engineering Sultanpur	mottoeng	excellence in action is yoga
North East University	mottoeng	Education and Research for Innovation
Alkauthar Islamic University	mottoeng	Verily, We have granted you Al-Kawthar
Centurion University of Technology and Management	mottoeng	Connecting through knowledge
Mohammad Ali Jauhar University	mottoeng	Read! In the Name of your Lord, Who has created
Assam Don Bosco University	mottoeng	Seize the Day
Meycauayan College	mottoeng	\
Drexel University Sacramento	mottoeng	Science, Industry, Art
ENAC Alumni	mottoeng	Alumni association of the French Civil Aviation University
Taipei City University of Science and Technology	mottoeng	Loyalty, Trust, Sincerity, and Respect
University of the Punjab, Gujranwala	mottoeng	Faith, Unity, Discipline
Casa Del Niño Schools System	mottoeng	Power Truth Knowledge
Directorate of Medicinal and Aromatic Plants Research	mottoeng	Health for All
Biyani International Institute of Engineering & Technology	mottoeng	Where you can trust
Central Police University	mottoeng	Honesty
Persian Gulf International Education Center	mottoeng	Iranian aspirations for globalization
Ulsan College	mottoeng	Sincerity, Creativity, Service
AISSMS College of Polytechnic	mottoeng	No death to Truth
Sagar Institute of Science and Technology	mottoeng	Transmitting professionalism
Lyceum of the Philippines University-Cavite	mottoeng	Truth and Courage, For God and Country
Chuka University	mottoeng	Knowledge is wealth
Pakuan University	mottoeng	Excellent, Autonomous, and Strong character
Sree Vidyanikethan Educational Trust	mottoeng	The triple world  is one's own place.
Lyceum of the Philippines University-Laguna	mottoeng	Truth and Courage, For God and Country
Roorkee Institute of Technology	mottoeng	Knowledge is Everything
West China Medical Center of Sichuan University	mottoeng	Strength through self-renewal, strive to persevere, aspire for the truth, toil to discover.
AGSB University	mottoeng	Your Success is Our Success
University of the Punjab, Jhelum	mottoeng	Faith, Unity, Discipline
University of the Punjab, Khanspur	mottoeng	Faith, Unity, Discipline
Mount Carmel College of Baler	mottoeng	\
National Institute of Technology Sikkim	mottoeng	Keep Moving
Bonn-Rhein-Sieg University of Applied Sciences	mottoeng	International, innovative, networked and committed to the leitmotif of sustainability
SKBM Degree College	mottoeng	Starting In The Name Of Allah
Mwenge Catholic University	mottoeng	Light of the World
Moshi Co-operative University	mottoeng	Co-operative is Business
National Institute of Technology Uttarakhand	mottoeng	Knowledge is maintained through Practice and Hardship
Manipal University Jaipur	mottoeng	Inspired By Life
National Taichung University of Science and Technology	mottoeng	Broad, Dense, and Micro
Universidad Tecnológica de Tula-Tepeji	mottoeng	Developing future through science and culture
İzmir Kâtip Çelebi University	mottoeng	Embracing Diversity
Rajshahi University of Engineering & Technology	mottoeng	Heaven's Light is Our Guide
Central Mechanical Engineering Research Institute	mottoeng	Machine is our Incantation.
Central American University	mottoeng	We're UCA
St. Xavier's College, Patna	mottoeng	Let the streams of Gyan  Ganga keep on flowing
Autonomous University of Carmen	mottoeng	For the greatness of México .
Hunan First Normal University	mottoeng	If you want to be the teacher of the people, you must be the student of the people at first
Sibsagar College	mottoeng	We go in Quest of Light
Muhammadiyah University of Yogyakarta	mottoeng	Excellent and Islamic
UIET, Hoshiarpur	mottoeng	Lead us unto the Light from Darkness
École de design Nantes Atlantique	mottoeng	Design for Creative Innovation
Sacred Heart College Chalakudy	mottoeng	Light Shines in Darkness
San Jacinto Seminary	mottoeng	Holy, Science
Catholic University Redemptoris Mater	mottoeng	Seat of Wisdom
Popular University of Nicaragua	mottoeng	University is community
Oakland University William Beaumont School of Medicine	mottoeng	Seek virtue and knowledge
National Taiwan Sport University	mottoeng	Precision, Honesty, Frugality and Perseverance
Kainan University	mottoeng	Sincere, excellent, free, bold
MingDao University	mottoeng	Wisdom, Virtue, Honesty, Progress
Toko University	mottoeng	Science and technology, intelligence, creativity, honor
University of Kang Ning	mottoeng	Innovation, Creativity & Future-building!
Chang Gung University of Science and Technology	mottoeng	Diligence, Perseverance, Frugality and Trustworthiness
Central Taiwan University of Science and Technology	mottoeng	Loyalty, trust, sincerity, and respect
Universidad Tecnológica del Centro	mottoeng	The best starts here
University of Texas Rio Grande Valley	mottoeng	Cultivated mind is the guardian genius of democracy.
N. S. S. College, Pandalam	mottoeng	Knowledge indeed is superior to constant practice
Ming Chi University of Technology	mottoeng	Diligence, Perseverance, Frugality and Trustworthiness
Bulacan State University College of Business Administration	mottoeng	Work alone
University College Dublin	mottoeng	To the stars
Mohtarma Benazir Bhutto Shaheed Medical College	mottoeng	Serving with passion
Roorkee College of Engineering	mottoeng	Knowledge is Power Supreme
Lapland University of Applied Sciences	mottoeng	The Northern Factor
Santa Teresa College	mottoeng	\
Nantes-Atlantic National College of Veterinary Medicine, Food Science and Engineering	mottoeng	Health and food at the heart of life
AlMughtaribeen University	mottoeng	Name is specific, Acceptance is for all
Teikyo University of Japan in Durham	mottoeng	Learn that you may excel
Dali University	mottoeng	Dade Dudgeon learned to reason
AMU Malappuram Campus	mottoeng	Taught man what he did not know
Orenburg State University	mottoeng	Learning enlightens the mind
Gusa Regional Science High School	mottoeng	Knowledge And Virtue
Gusa Regional Science High School	mottoeng	Kaalaman At Kabutihan
ARMM Regional Science High School	mottoeng	\
Bicol Regional Science High School	mottoeng	\
Confederate States Naval Academy	mottoeng	With God Our Vindicator
PNTC Colleges	mottoeng	Virtue and Quality
Zhejiang International Studies University	mottoeng	striving for moral integrity and academic excellence
Aligarh Muslim University	mottoeng	Taught man what he knew not
Velammal Institute of Technology	mottoeng	Dedication, Determination and Distinction
Royal College of Ophthalmologists	mottoeng	So that all may see
MIMAROPA Regional Science High School	mottoeng	\
École de formation des sous-officiers de l'armée de l'air	mottoeng	Arm for the future
Murang'a University College	mottoeng	Innovation for Prosperity
Philtech Institute of Arts and Technology	mottoeng	Skilled Equipped Globally Competitive
Institut Latihan Perindustrian Kuala Lumpur	mottoeng	National Skilled Workforce Pioneer
Phnom Penh Institute of Technology	mottoeng	Deliver the Best and Unique Education, History Maker in Science and Engineering Education.
Technical and Vocational University	mottoeng	Beneficial knowledge
Amguri College	mottoeng	Vision is our Horizon
Our Lady of Good Counsel	mottoeng	Your youth will be renewed like the eagles
University of Texas at Brownsville	mottoeng	Cultivated mind is the guardian genius of democracy.
UiTM Perlis	mottoeng	Endeavour, God-Consciousness, Dignity
Indian Diamond Institute	mottoeng	Passion Technology Innovation
Maharaja Agrasen University Baddi	mottoeng	\
University of Vocational Technology	mottoeng	Life Long Learning for All!
Maharaja Agrasen University	mottoeng	\
Indian Institute of Soil Science	mottoeng	Agrisearch with a Human Touch
Ishan Institute of Architecture and Planning	mottoeng	Knowledge is Elixir
Pupilos do Exército	mottoeng	Willing is power
Universidad España	mottoeng	Truth in Science and Spirituality
Indian Institute of Sugarcane Research	mottoeng	An efficient, globally competitive and vibrant sugarcane agriculture
DAV Public School, Midnapore	mottoeng	Lead from the darkness to the light
Military Academy of the Bolivarian Aviation	mottoeng	Fortune helps the strong
Military Academy of the Bolivarian Navy	mottoeng	Independence and Socialist Fatherland... We will live and overcome.
National Guard Military Academy	mottoeng	''Honor is its emblem
Military Academy of Troop Officers	mottoeng	Home of the Troop Officers
Institute of Secretariat Training and Management	mottoeng	Efficiency and the Public Good
Indian Institute of Information Technology, Kalyani	mottoeng	The wealth of Knowledge is the greatest of all wealth
Gokhale Education Society's R. H. Sapat College of Engineering, Management Studies and Research	mottoeng	Value Embedded Quality Technical Education
Morarji Desai National Institute of Yoga	mottoeng	Health, Harmony and Happiness for all through Yoga
Donbas National Academy of Civil Engineering and Architecture	mottoeng	Teaching – Learning
Moda Domani Institute	mottoeng	The new business school specialized in the new worlds of luxury, design and fashion
Amrita School of Engineering, Bengaluru	mottoeng	The earnest aspirant gains supreme wisdom
Jinnah College for Women	mottoeng	O' Lord, Advance me in Knowledge
Peshawar Model Degree Colleges	mottoeng	O my Lord! Advance me in Knowledge
Saint Monica University	mottoeng	Service Without Limit
Johnson College Aizawl	mottoeng	First among equals
Universidad Peruana de Ciencias Aplicadas	mottoeng	Push yourself. Be creative. UPC.
Gusa Regional Science High School - X	mottoeng	Knowledge And Virtue
Gusa Regional Science High School - X	mottoeng	Kaalaman At Kabutihan
Nepalese Military Academy	mottoeng	Knowledge, Service,Leadership
ESIGELEC	mottoeng	\
National Institute Of Technology Sikkim	mottoeng	Keep Moving
The Islamia University of Bahawalpur Pakistan	mottoeng	Faith, Unity, Discipline
University of Gibraltar	mottoeng	Knowledge is the Key to Success
Shyam Shah Medical College	mottoeng	From death lead us to immortality
Bruce Hall	mottoeng	Happy is he who is able to discover the reason for things
Mangalam College of Engineering	mottoeng	Inspire, Imbibe, Innovate
Joypurhat Government College	mottoeng	Knowledge is power
D.A.V. College Lucknow	mottoeng	\
Kutafin Moscow State Law University	mottoeng	Not for school but for life.
Netaji Subhas Institute of Technology	mottoeng	May God bring holy thoughts to my mind from all directions
McNeilus Maranatha Christian College	mottoeng	Love Conquers All
Widya Mandala Catholic University	mottoeng	We do not learn for school, but for life
Rayagada Autonomous College, Rayagada	mottoeng	TRUTH -- PURITY -- BEAUTY
Women University Multan	mottoeng	Knowledge-Contemplation-Reflection
Shaheed Benazir Bhutto City University	mottoeng	Learning for Success
Shaheed Benazir Bhutto University of Veterinary and Animal Sciences	mottoeng	Knowledge is Power
Ali Institute of Education	mottoeng	Knowledge is Power
Habib University	mottoeng	Every Human Being’s worth is in their Yohsin
Qalandar Shahbaz University of Modern Sciences	mottoeng	Knowledge is Power
Hyderabad Institute of Arts, Science and Technology	mottoeng	Knowledge is Power
National University of Public Service	mottoeng	In Service of the Homeland
California Maritime Academy Corps of Cadets	mottoeng	To Work or Fight; We are Ready
Vilnius Gediminas Technical University	mottoeng	Dare to be wise
G.I. Rossolimo Boarding School Number 49	mottoeng	\
The Chinese University of Hong Kong, Shenzhen	mottoeng	Through learning and temperance to virtue
Zhejiang Wanli University	mottoeng	\
University of International Business and Economics	mottoeng	Erudition, Honesty, Endeavour, Perfection
IGlobal University	mottoeng	Transforming the World
G S Sanyal School of Telecommunications	mottoeng	Excellence in action is yoga.
Hitkarini College of Engineering and Technology	mottoeng	Always in motion for the good of all beings
Centre of Maritime Studies and Engineering	mottoeng	To sail is necessary, to live is not necessary
R.D. Engineering College Ghaziabad	mottoeng	Wisdom is nectar
Islamic Azad University of Tabriz	mottoeng	Iranian aspirations for globalization
Federal University of Vales do Jequitinhonha e Mucuri	mottoeng	Wisdom and Freedom
Nss College Rajakumari	mottoeng	Knowledge indeed is superior to constant practice
Nongtalang College	mottoeng	The Power of Education
Saint John's Senior Secondary School	mottoeng	Every project begins with the dream
Wiawso College of Education	mottoeng	With heart, hands and head
Yeshivat Makor Chaim	mottoeng	Believe that you can repair
Patuakhali Polytechnic Institute	mottoeng	Learning,Progress,Peace.
Jahanzeb College	mottoeng	He has taught man what he does not know
American College of the Building Arts	mottoeng	Learn or Leave
S.R. Institute of Management & Technology	mottoeng	Every Student of SR - becomes a Success Story
Dav public school kusmunda	mottoeng	Lead from the darkness to the light
College of the Immaculate Conception	mottoeng	\
Division of Health Sciences	mottoeng	\
National Institute of Management & Technology	mottoeng	Move Forward.
Directorate of Groundnut Research	mottoeng	\
Rai Sahab Bhanwar Singh College	mottoeng	Knowledge is the Supreme Goal
Bharathiyar College of Engineering and Technology	mottoeng	Prosperity Through Knowledge
Institute of Management Studies, Ranchi	mottoeng	\
Eastern Visayas Regional Science High School	mottoeng	\
Alabel National Science High School	mottoeng	\
Poltava State Medical and Dental University	mottoeng	\
Tezpur Medical College	mottoeng	\
St. Anthony's College	mottoeng	\
IAU College	mottoeng	\
Ispat Autonomous College, Rourkela	mottoeng	\
Agni College	mottoeng	Imparting knowledge. Inculcating Values
Gobindapur Sephali Memorial Polytechnic	mottoeng	Technology for Life
Symbiosis Centre for Management Studies	mottoeng	The world is one family
Bahia State University	mottoeng	For the betterment of man.
Dhar Polytechnic Mahavidhyalaya	mottoeng	Yoga and hard deeds will give you effective result
European University of the Atlantic	mottoeng	\
St. Paul's Catholic Seminary	mottoeng	You Are My Chosen Instrument
Our Lady of the Pillar Seminary	mottoeng	Peace, Truth, Freedom, Love, Justice
JSS College of Pharmacy	mottoeng	Work is Worship
Birla Institute of Technology, Jaipur	mottoeng	Learning is that which Liberates
Talimuddin Inter College	mottoeng	Taught man what he knew not.
University of Nueva Caceres - Bataan	mottoeng	\
Presidents of Montclair State University	mottoeng	Seize the day
Rangunia College	mottoeng	Education is Power
Jamia-tul-Madina	mottoeng	\
Sri Aurobindo College Evening	mottoeng	From darkness  lead me to Light
Universidad Autónoma de La Laguna	mottoeng	We Conquered the Desert, We Cultivate the Spirit
The University of Akron: School of Music	mottoeng	Let there be light
Bharata Mata College	mottoeng	For God and Country
Mar Thoma College	mottoeng	Education par Excellence and Educated for the Society
S. K. C. G. Autonomous College, Paralakhemundi	mottoeng	\
Universidad Autónoma del Carmen	mottoeng	For the Greatness of Mexico
Université Internationale de Rabat	mottoeng	\
Central Institute of Technology, Kokrajhar	mottoeng	\
Islamic Azad University of Astara	mottoeng	Iranian aspirations for globalization
Amar Singh College	mottoeng	LIGHT MORE LIGHT
St. Augustine University	mottoeng	“For Learning And Character”
UEI Global	mottoeng	Education to Employment
University of Sciences and Arts of Chiapas	mottoeng	For the culture of my race
Baoji University of Arts and Sciences	mottoeng	Expansion of knowledge, exploration of truth, aspiration for moral integrity, and acquisition of all-round abilities
Empresarial University of Costa Rica	mottoeng	Opportunity
Jhanji Hemnath Sarma College	mottoeng	We are the seekers of knowledge beyond the horizon.
Tuxtla Gutierrez Institute of Technology	mottoeng	Science and Technology with a Human Sense
Teknokrat	mottoeng	Discipline, Qualified, Creative, Innovative
The British College	mottoeng	Education Beyond Excellence
Palestine College of Nursing	mottoeng	We strive for the advancement of the nursing profession
District University IEEE Student Branch	mottoeng	Live the IEEE Experiencie
Dr. A. Q. Khan Institute of Computer Sciences and Information Technology	mottoeng	رَبِّ زدْنيِ عِلْماً
Dr. A. Q. Khan Institute of Computer Sciences and Information Technology	mottoeng	O my Lord! Advance me in Knowledge
Banaras Hindu University, South campus	mottoeng	Knowledge imparts immortality
Vallabhbhai Patel Chest Institute	mottoeng	\
Chavagnes Studium	mottoeng	\
Beacon Light English Model Secondary School	mottoeng	رَبِّ زدْنيِ عِلْماً
Beacon Light English Model Secondary School	mottoeng	O my Lord! Advance me in Knowledge
University of Medicine, Taunggyi	mottoeng	Service, Sympathy, Humanity
Vancouver Animation School	mottoeng	Your Education, Your Destination
Asian College	mottoeng	Developing Leaders in IT and Management
Fortress College	mottoeng	The heart of education is the education of the heart
Government Degree College, Bemina	mottoeng	\
Siberian State Transport University	mottoeng	Your Road to Life
Burrell College of Osteopathic Medicine	mottoeng	For the people and the future
Virginia Tech Carilion School of Medicine and Research Institute	mottoeng	That I May Serve
Government Degree College, Handwara	mottoeng	Knowledge is Power
Government Degree College, Pulwama	mottoeng	Seek Knowledge
Islamic Azad University West Tehran Branch	mottoeng	Iranian Aspirations for Globalization
Counter-Japanese Military and Political University	mottoeng	Unity, tense, serious, lively
Government Degree College, Bandipora	mottoeng	Light upon Light
University of Ibagué	mottoeng	Committed with regional development
National College of Arts	mottoeng	Seek excellence in your work, so you can be admired by the world
Polytechnic University of the Philippines System	mottoeng	Light of the Nation
Oregon Institute of Technology, Wilsonville	mottoeng	Through knowledge, light
Dr. Ram Manohar Lohia Institute of Medical Sciences	mottoeng	May All be Healthy
Sama College of Mashhad	mottoeng	whoever is diligent is Samaei
Imam Ali Officers' Academy	mottoeng	Faith, Discipline, Education
Tantur Ecumenical Institute	mottoeng	The Light of Christ shines for us.
Xavier Institute of Management & Research	mottoeng	Infinite Possibilities
St. Vincent College of Commerce	mottoeng	From the darkness
St. Vincent College of Commerce	mottoeng	lead me to light
Rashtriya Sanskrit Vidyapeetha	mottoeng	Lead me into light from darkness
Film School of the Aristotle University	mottoeng	Sacrifice to the Muses and Charites.
Daniel K. Inouye College of Pharmacy	mottoeng	Guardians of Health
The Eiffel School of Management	mottoeng	Dynamism, Rigor, Diversity
University of Education Lahore	mottoeng	Truth, The Ultimate Virtue
Loyola College, Mettala	mottoeng	Let your light shine forth
University College of Engineering, Panruti	mottoeng	Progress through Knowledge
University College of Engineering, Arni	mottoeng	Progress through Knowledge
KMM College of Arts and Science	mottoeng	Steer Towards The Right Direction
Belgorod Technological University	mottoeng	\
Universidad Iberoamericana León	mottoeng	Truth will set us Free
Pennell High School Bannu	mottoeng	Ever Onward
San Lorenzo College of Davao	mottoeng	I Would Rather Die A Thousand Deaths Than To Renounce My Faith
PLA Naval University of Engineering	mottoeng	Rigorous, Realistic, Hard work, Innovation
University of Bojnord	mottoeng	Rest not a moment from learning
Rangamati Science and Technology University	mottoeng	Education Harmony Progress
Albanian School of Magistrates	mottoeng	Education for Justice
Department of Library and Information Science	mottoeng	\
University of Batna 2	mottoeng	Stand and See
The North American Reformed Seminary	mottoeng	\
Indra English High School And Junior College	mottoeng	Lead from the darkness to the light
Bible University	mottoeng	\
Melikşah University	mottoeng	Assurance of The Future Together
Glorious National School of Saint Charles	mottoeng	A Carolino, a Knight
University of Northern New Jersey	mottoeng	Human, Science, Integrity
Ishan Institute of Law	mottoeng	Knowledge is Elixir
Ibero-American University of Torreón	mottoeng	The Truth Will Make Us Free.
Catholic Institute of West Africa	mottoeng	Always busy, Always at rest
Karnataka	mottoeng	Labour Is Dignity
Universiti Sultan Azlan Shah	mottoeng	Mercy to the World
Dibrugarh Govt. Boys' Higher Secondary School	mottoeng	Education is Knowledge, Knowledge is Amrita
School of Law, University of Mumbai	mottoeng	\
Universidad de Occidente	mottoeng	For the Culture of Liberty
Institute of Brunei Technical Education	mottoeng	Inspiring Bruneians Towards Excellence
Major Seminary of Bogotá	mottoeng	The beginning of wisdom is the fear of God
Atlantis University	mottoeng	Grow in wisdom
University of Mumbai, Thane Sub Campus	mottoeng	\
Perbanas Institute Jakarta	mottoeng	Envision your Future, Today
NES Ratnam College Of Arts, Science & Commerce	mottoeng	Learn, Live & Lead
Rajshahi Science & Technology University	mottoeng	Increase me in knowledge
Government Degree College, Battagram	mottoeng	Knowledge is Power
School of Library and Information Studies at the University of Alberta	mottoeng	Whatsoever things are true
Royal University of San Felipe	mottoeng	\
St. Xavier's College, Simdega	mottoeng	\
Department of Management Studies, IIT	mottoeng	Arise, Awake, strive for the highest and be in the fight
Motherhood University	mottoeng	\
