Ministry of Internal Affairs	nativenameA	Министерство внутренних дел Российской Федерации
Marrakesh Menara Airport	nativenameA	مطار مراكش المنارة
Dubai International Airport	nativenameA	مطار دبي الدولي
Baghdad International Airport	nativenameA	مطار بغداد الدولي
Incheon International Airport	nativenameA	인천국제공항
Kansai International Airport	nativenameA	関西国際空港
State Protection Authority	nativenameA	Államvédelmi Hatóság
Central Military Commission	nativenameA	中国共产党中央军事委员会
Central Military Commission	nativenameA	中华人民共和国中央军事委员会
White Guard	nativenameA	Skyddskår
Sheremetyevo International Airport	nativenameA	(Международный аэропорт Шереметьево)
Chiang Rai International Airport	nativenameA	ท่าอากาศยานแม่ฟ้าหลวง เชียงราย
Hat Yai International Airport	nativenameA	ท่าอากาศยานหาดใหญ่
Munich Airport	nativenameA	(Flughafen München)
Nagoya Airfield	nativenameA	名古屋飛行場
Kai Tak Airport	nativenameA	啟德機場
South Cariboo Regional Airport	nativenameA	(South Cariboo/108 Mile Airport)
Gimpo International Airport	nativenameA	김포국제공항
Gimpo International Airport	nativenameA	金浦國際空港
Mohammed V International Airport	nativenameA	مطار محمد الخامس الدولي
Gimhae International Airport	nativenameA	Gimhae Gukje Gonghang
Aberdeen Airport	nativenameA	(Port-adhair Obar Dheathain)
Chennai International Airport	nativenameA	சென்னை பன்னாட்டு வானூர்தி நிலையம்
SHIK	nativenameA	Sherbimi Informativ Shteteror
SHISH	nativenameA	Shërbimi Informativ Shtetëror
RAF Machrihanish	nativenameA	(Campbeltown Airport)
Fukuoka Airport	nativenameA	福岡空港
Campbeltown Airport	nativenameA	RAF Machrihanish
Kobe Airport	nativenameA	神戸空港
SMERSH	nativenameA	СМЕРШ
Asahikawa Airport	nativenameA	旭川空港
Yao Airport	nativenameA	八尾空港
Trivandrum International Airport	nativenameA	തിരുവനന്തപുരം അന്താരാഷ്ട്ര വിമാനത്താവളം
Luxembourg Findel Airport	nativenameA	(Aéroport de Luxembourg)
Hakodate Airport	nativenameA	函館空港
Guangzhou Baiyun International Airport	nativenameA	广州白云国际机场
Okadama Airport	nativenameA	札幌丘珠空港
Agadir–Al Massira Airport	nativenameA	مطار المسيرة
Kuwait International Airport	nativenameA	مطار الكويت الدولي
Bahrain International Airport	nativenameA	مطار البحرين الدولي
Sharjah International Airport	nativenameA	مطار الشارقة الدولي
Abu Dhabi International Airport	nativenameA	مطار أبوظبي الدولي
Al Ain International Airport	nativenameA	مطار العين الدولي
Fujairah International Airport	nativenameA	مطار الفجيرة الدولي
Ministry of Intelligence	nativenameA	وزارت اطّلاعات جمهوری اسلامی ایران
Toyama Airport	nativenameA	富山空港
CFB Borden	nativenameA	Borden Heliport
CFB Shearwater	nativenameA	12
Ministry of Digital Economy and Society	nativenameA	กระทรวงดิจิทัลเพื่อเศรษฐกิจและสังคม
Chōfu Airport	nativenameA	調布飛行場
Cairo International Airport	nativenameA	مطار القاهرة الدولي
Klagenfurt Airport	nativenameA	(Kärnten Airport)
Cochin International Airport	nativenameA	കൊച്ചി അന്താരാഷ്ട്ര വിമാനത്താവളം
Phnom Penh International Airport	nativenameA	(អាកាសយានដ្ឋានអន្តរជាតិភ្នំពេញ)
Security Service of Ukraine	nativenameA	/
Tehran Imam Khomeini International Airport	nativenameA	فرودگاه بین‌المللی امام خمینی  امام خمینی
Zvartnots International Airport	nativenameA	Զվարթնոց Միջազգային Օդակայան
Queen Alia International Airport	nativenameA	مطار الملكة علياء الدولي
Ras Al Khaimah International Airport	nativenameA	مطار رأس الخيمة الدولي
Villamor Air Base	nativenameA	Nichols Air Base
Naha Airport	nativenameA	那覇空港
Dewan Bahasa dan Pustaka	nativenameA	DBP
Ministry of Justice	nativenameA	Hōmu-shō
Doha International Airport	nativenameA	مطار الدوحة الدولي
CFB Valcartier	nativenameA	Base des Forces canadiennes Valcartier
Kerry Airport	nativenameA	Aerfort Chiarraí
Yangyang International Airport	nativenameA	양양국제공항
Yangyang International Airport	nativenameA	襄陽國際空港
Varna Airport	nativenameA	Летище Варна
General Security Directorate	nativenameA	مديرية الامن العامة
California Conservation Corps	nativenameA	Conservation Corps
Chernobyl Exclusion Zone	nativenameA	Державне агентство України з управління зоною відчуження
Monbetsu Airport	nativenameA	オホーツク紋別空港
Brunei International Airport	nativenameA	لاڤڠن تربڠ انتارابڠسا بروني
Presidential Security Service	nativenameA	Dae Tong Ryeong Gyeong Ho Shil
Hiroshima Airport	nativenameA	広島空港
Naval Air Facility Atsugi	nativenameA	厚木海軍飛行場
Surat Thani Airport	nativenameA	ท่าอากาศยานสุราษฎร์ธานี
Vikram Sarabhai Space Centre	nativenameA	विक्रम साराभाई अंतरिक्ष केंद्र
Roosevelt Field	nativenameA	Hempstead Plains Aerodrome
Bolivarian Intelligence Service	nativenameA	SEBIN
Committee on Public Information	nativenameA	Creel Committee
Naicho	nativenameA	内閣情報調査室
Kagoshima Airport	nativenameA	鹿児島空港
Lajes Field	nativenameA	(''Base Aérea Nº 4)
Taiwan Provincial Government	nativenameA	Táiwān Shěng Zhèngfǔ
CFB Shilo	nativenameA	ASU Shilo
Hong Kong Housing Authority	nativenameA	香港房屋委員會
Airport Authority Hong Kong	nativenameA	香港機場管理局
Central Election Commission	nativenameA	/
Kokura Airport	nativenameA	小倉空港
Foreign Intelligence Service of Ukraine	nativenameA	Служба зовнішньої розвідки України
Kitakyushu Airport	nativenameA	北九州空港
Ali Al Salem Air Base	nativenameA	قاعدة علي السالم الجوية
Daegu International Airport	nativenameA	Daegu Gukje Gonghang
Supreme People's Procuratorate	nativenameA	中华人民共和国最高人民检察院
Ministry of Finance	nativenameA	中華民國財政部
Ministry of Emergency Situations	nativenameA	Министерство по делам гражданской обороны, чрезвычайным ситуациям и ликвидации последствий стихийных бедствий
Sde Dov Airport	nativenameA	שדה דב
Sde Dov Airport	nativenameA	مطار سدي دوف
Shek Kong Airfield	nativenameA	石崗機場
King Abdulaziz International Airport	nativenameA	مطار الملك عبدالعزيز الدولي
Transportation Safety Board of Canada	nativenameA	Bureau de la sécurité des transports du Canada
Department of Health	nativenameA	衞生署
Education Bureau	nativenameA	教育局
Dalian Zhoushuizi International Airport	nativenameA	大连周水子国际机场
Gatineau-Ottawa Executive Airport	nativenameA	Ottawa/Gatineau Airport
Kalamata International Airport	nativenameA	«Καπετάν Βασίλης Κωνσταντακόπουλος»
Government Information Office	nativenameA	新聞局
Calicut International Airport	nativenameA	കോഴിക്കോട് അന്താരാഷ്ട്ര വിമാനത്താവളം
Gwangju Airport	nativenameA	Gwangju Gonghang
Cheongju International Airport	nativenameA	Cheongju Gukje Gonghang
Jeju International Airport	nativenameA	Jeju Gukje Gonghang
Koltsovo Airport	nativenameA	(Международный Аэропорт Кольцово)
Fundação Nacional do Índio	nativenameA	'National Indian Foundation
Malta International Airport	nativenameA	(Ajruport Internazzjonali ta' Malta)
Scottish Arts Council	nativenameA	Scots Airt Cooncil
Mehrabad International Airport	nativenameA	فرودگاه مهرآباد
RNZAF Base Auckland	nativenameA	Te kotahitanga o ngaa maahanga
RNZAF Base Ohakea	nativenameA	Defence Through Strength
Okayama Airport	nativenameA	岡山空港
Oxford Airport	nativenameA	(Kidlington Airport)
Home Affairs Department	nativenameA	民政事務總署
Leisure and Cultural Services Department	nativenameA	康樂及文化事務署
Salina Cruz Airport	nativenameA	Naval Air Station Salina Cruz
Agencja Bezpieczeństwa Wewnętrznego	nativenameA	Agencja Bezpieczeństwa Wewnętrznego
Atlanta South Regional Airport	nativenameA	Tara Field
King Fahd International Airport	nativenameA	مطار الملك فهد الدولي
Customs and Excise Department	nativenameA	香港海關
Urban Renewal Authority	nativenameA	市區重建局
Marine Department	nativenameA	海事處
Legal Department	nativenameA	律政署
Department of Justice	nativenameA	律政司
Singapore Civil Defence Force	nativenameA	சிங்கப்பூர் குடிமைத் தற்காப்புப் படை
Koevoet	nativenameA	Operation K
Takamatsu Airport	nativenameA	高松空港
Gloucestershire Airport	nativenameA	Staverton Airport
Agriculture, Fisheries and Conservation Department	nativenameA	漁農自然護理署
China Maritime Safety Administration	nativenameA	中华人民共和国海事局
Siem Reap International Airport	nativenameA	អាកាសយានដ្ឋានអន្តរជាតិសៀមរាប
Institute of Standards and Industrial Research of Iran	nativenameA	مؤسسهٔ استاندارد و تحقیقات صنعتی ایران
National Security Bureau	nativenameA	國家安全局
Nuuk Airport	nativenameA	Godthåb Lufthavn
New Ishigaki Airport	nativenameA	新石垣空港
Ishigaki Airport	nativenameA	石垣空港
Satish Dhawan Space Centre	nativenameA	సతీష్ ధావన్ స్పేస్ సెంటర్
Madrid–Torrejón Airport	nativenameA	Torrejón Air Base
Security Bureau	nativenameA	保安局
Fukue Airport	nativenameA	福江空港
Cornwall Airport Newquay	nativenameA	RAF St Mawgan
Ibrahim Nasir International Airport	nativenameA	(އިބްރާހިމް ނާސިރު ބައިނަލްއަޤުވާމީ ވައިގެ ބަނދަރު)
Pristina International Airport	nativenameA	(Aeroporti Ndërkombëtar i Prishtinës)
Sept-Îles Airport	nativenameA	Aéroport de Sept-Îles
Iraqi Special Security Organization	nativenameA	Al-Amn al-Khas
Shiraz International Airport	nativenameA	فرودگاه بین‌المللی شهید دستغیب شیراز
Home Affairs Bureau	nativenameA	民政事務局
Haeju Airport	nativenameA	해주공항
Isle of Man Airport	nativenameA	Purt Aer Vannin
Kyzyl Airport	nativenameA	Аэропорт Кызыл
Corfu International Airport	nativenameA	\
Wattay International Airport	nativenameA	ท่าอากาศยานนานาชาติวัตไต
Vladivostok International Airport	nativenameA	Международный аэропорт \
Food and Environmental Hygiene Department	nativenameA	食物環境衞生署
Tripoli International Airport	nativenameA	مطار طرابلس العالمي
Mont Tremblant International Airport	nativenameA	(Aéroport International de Mont-Tremblant)
International Airport Irkutsk	nativenameA	Международный
International Airport Irkutsk	nativenameA	Аэропорт Иркутск
Information and Security Service of the Republic of Moldova	nativenameA	SIS
Ministry of Culture	nativenameA	文化部
Kyiv International Airport	nativenameA	(Міжнародний аеропорт \
Hong Kong Trade Development Council	nativenameA	香港貿易發展局
Gostomel Airport	nativenameA	Аеропорт «Антонов»
Alicante–Elche Airport	nativenameA	(Aeropuerto de Alicante-Elche)
Agartala Airport	nativenameA	আগরতলা বিমানবন্দর
Minangkabau International Airport	nativenameA	باندار اينتيرنسيونال مينڠكاباو
South River-Sundridge District Airport	nativenameA	(Almaguin Highlands Air Park)
Chitose Air Base	nativenameA	千歳基地
RAAF Base Tindal	nativenameA	(Katherine Tindal Civilian Airport)
Niigata Airport	nativenameA	新潟空港
Fukushima Airport	nativenameA	福島空港
Akita Airport	nativenameA	秋田空港
Kushiro Airport	nativenameA	釧路空港
Wakkanai Airport	nativenameA	稚内空港
Japan Patent Office	nativenameA	特許庁
Ioannina National Airport	nativenameA	Κρατικός Αερολιμένας Ιωαννίνων
Home Team Academy	nativenameA	内政群英学院
Environmental Protection Department	nativenameA	環境保護署
Kangerlussuaq Airport	nativenameA	Kangerlussuaq Lufthavn
Antwerp International Airport	nativenameA	(Advanced Landing Ground  B-70)
Kruger Mpumalanga International Airport	nativenameA	KMI Airport
Kozani National Airport	nativenameA	Κρατικός Αερολιμένας Κοζάνης
Kozani National Airport	nativenameA	\
Newcastle Airport	nativenameA	(Williamtown Airport)
Jaipur International Airport	nativenameA	जयपुर अन्तर्राष्ट्रीय हवाई अड्डा
Hiroshima–Nishi Airport	nativenameA	広島西飛行場
Narsarsuaq Airport	nativenameA	Narsarsuaq Lufthavn
De Kooy Airfield	nativenameA	Den Helder Airport
Damascus International Airport	nativenameA	مطار دمشق الدولي
Astana International Airport	nativenameA	Халықаралық Астана Әуежайы
Ministry of Environment	nativenameA	환경부
Khartoum International Airport	nativenameA	مطار الخرطوم الدولي
Eshott Airfield	nativenameA	Bockenfield Aerodrome
Minsk-1 Airport	nativenameA	Аэрапорт Мінск-1
Nanki–Shirahama Airport	nativenameA	南紀白浜空港
StB	nativenameA	Štátna bezpečnosť
Alcides Fernández Airport	nativenameA	Acandí Airport
Skopje %22Alexander the Great%22 Airport	nativenameA	(Aerodrom ,,Aleksandar Veliki\
Badajoz Airport	nativenameA	Talavera la Real Air Base
Ministry of National Defense	nativenameA	國防部
Tokushima Airport	nativenameA	徳島阿波おどり空港
Almaty International Airport	nativenameA	(Халықаралық Алматы Әуежайы)
Mashhad International Airport	nativenameA	فرودگاه بین‌المللی شهید هاشمی‌نژاد مشهد
Ministry of Trade, Industry and Energy	nativenameA	산업통상자원부
Ministry of Strategy and Finance	nativenameA	企劃財政部
Ibiza Airport	nativenameA	(Aeroport d'Eivissa / Aeropuerto de Ibiza)
Ponikve Airport	nativenameA	Аеродром Ужице-Поникве
Mangla Airport	nativenameA	منگلا فوجی ہوائی اڈا
Ohrid %22St. Paul the Apostle%22 Airport	nativenameA	(Aerodrom ,,Sveti Apostol Pavle\
Batajnica Air Base	nativenameA	(Аеродром Батајница)
General Intelligence Directorate	nativenameA	دائرة المخابرات العامة
Morava Airport	nativenameA	(Aеродром Морава)
Maharana Pratap Airport	nativenameA	महाराणा प्रताप हवाई अड्डा
Kapino Polje Airport	nativenameA	Аеродром Капино поље
Fik Airfield	nativenameA	מנחת פיק
Ministry of Culture, Sports and Tourism	nativenameA	문화체육관광부
Osmani International Airport	nativenameA	ওসমানী আন্তর্জাতিক বিমানবন্দর
Yonaguni Airport	nativenameA	与那国空港
Gomel Airport	nativenameA	Аэропорт Гомель
St Mary's Airport, Isles of Scilly	nativenameA	(Scilly Isles/St Mary's Airport)
Bor Airport	nativenameA	Aerodrom Bor
Information Services Department	nativenameA	政府新聞處
Sjenica Airport	nativenameA	Аеродром Сјеница
Novi Sad Airport	nativenameA	(Аеродром Ченеј)
Sary-Arka Airport	nativenameA	аэропорт Сары-Арка
Dolac Airport	nativenameA	Аеродром Долац
Trstenik Airport	nativenameA	Аеродром Трстеник
Mira Airport	nativenameA	(Аеродром Мира)
Marin County Airport	nativenameA	451
Central Weather Bureau	nativenameA	中央氣象局
SS Main Economic and Administrative Office	nativenameA	SS-WVHA
Žabljak Airport	nativenameA	Аеродром Жабљак
Economic Analysis and Business Facilitation Unit	nativenameA	經濟分析及方便營商處
Columbia Gorge Regional Airport	nativenameA	The Dalles Municipal Airport
Odessa International Airport	nativenameA	(Міжнародний аеропорт \
Al Mukhabarat Al A'amah	nativenameA	Al Mukhabarat Al A'amah as-Suʿūdiyyah
Sremska Mitrovica Airport	nativenameA	(Аеродром Сремска Митровица)
Subotica Airport	nativenameA	(Aerodrom Subotica)
Ulcinj Airport	nativenameA	Аеродром Улцињ
Smederevska Palanka Airport	nativenameA	(Аеродром Смедеревска Паланка)
Paraćin Airport	nativenameA	Аеродром Давидовац
Simferopol International Airport	nativenameA	(Міжнародний аеропорт \
RAF Croft	nativenameA	90
Izumo Airport	nativenameA	出雲空港
State Border Guard Service of Ukraine	nativenameA	/
Ministry of National Defense	nativenameA	국방부
Rene Mouawad Air Base	nativenameA	مطار الرئيس الشهيد رينيه معوض
Israel Securities Authority	nativenameA	רשות ניירות ערך
Petropavlovsk-Kamchatsky Airport	nativenameA	Аэропорт Елизово
Civil Airport Harni	nativenameA	સિવિલ એરપોર્ટ હરની
Ali Air Base	nativenameA	Ali Air Base
Ministry of Health and Welfare	nativenameA	보건복지부
Dong Hoi Airport	nativenameA	Cảng hàng không Đồng Hới
Council of Indigenous Peoples	nativenameA	原住民族委員會
Ivano-Frankivsk International Airport	nativenameA	(Міжнародний аеропорт \
Bhuj Rudra Mata Air Force Base	nativenameA	भुज रुद्र माता एयर फोर्स बेस
Rivne International Airport	nativenameA	Міжнародний аеропорт «Рівне»
Hamad International Airport	nativenameA	مطار حمد الدولي
Krasnodar International Airport	nativenameA	Международный аэропорт Краснодар
Lisičji Jarak Airport	nativenameA	Аеродром Лисичји Јарак
Royal Society of Thailand	nativenameA	Ratchabandittayasapha
Narimanovo Airport	nativenameA	Аэропорт Нариманово
Hurghada International Airport	nativenameA	مطار الغردقة الدولي
Mangalore International Airport	nativenameA	ಮಂಗಳೂರು ಅಂತರರಾಷ್ಟ್ರೀಯ ವಿಮಾನ ನಿಲ್ದಾಣ
Singapore Prison Service	nativenameA	新加坡监狱署
Earls Colne Airfield	nativenameA	USAAF Station AAF-358
Wickenby Aerodrome	nativenameA	Wickenby Airport
Hucknall Aerodrome	nativenameA	Rolls-Royce Flight Test Establishment
Netherthorpe Airfield	nativenameA	100
Election Commission of Thailand	nativenameA	คณะกรรมการการเลือกตั้ง
Tabriz International Airport	nativenameA	فرودگاه بین‌المللی شهید مدنی تبریز
Ministry of Defence	nativenameA	रक्षा मंत्रालय
Podgorica Airbase	nativenameA	Аеродром Голубовци
Trang Airport	nativenameA	ท่าอากาศยานตรัง
Sultan Syarif Kasim II International Airport	nativenameA	بندر اودارا اينترنسيونل سلطان شريف قاسم ٢
Shirak Airport	nativenameA	Շիրակ Օդանավակայան
CFB Winnipeg	nativenameA	(1 Canadian Air Division/Canadian NORAD Region)
Aurangabad Airport	nativenameA	औरंगाबाद विमानतळ
Kadapa Airport	nativenameA	కడప విమానాశ్రయం
Air Force Academy, Dundigul	nativenameA	Indian Air Force Academy
Gaya Airport	nativenameA	गया अंतर्राष्ट्रीय हवाई अड्डा
Rajahmundry Airport	nativenameA	రాజమండ్రి విమానాశ్రయము
Tirupati Airport	nativenameA	తిరుపతి విమానాశ్రయము
Vijayawada Airport	nativenameA	విజయవాడ విమానాశ్రయము
Security and Intelligence Division	nativenameA	保安与情报司
Pasighat Airport	nativenameA	पासीघाट हवाई अड्डे
Dimapur Airport	nativenameA	दीमापुर हवाई अड्डा
State Administration of Foreign Exchange	nativenameA	国家外汇管理局
Lilabari Airport	nativenameA	লীলাবাৰী বিমানবন্দৰ
Jorhat Airport	nativenameA	যোৰহাট বিমানবন্দৰ
Dibrugarh Airport	nativenameA	ডিব্ৰুগড় বিমানবন্দৰ
Silchar Airport	nativenameA	শিলচর বিমানবন্দর
Tezpur Airport	nativenameA	तेजपुर सैनिक हवाईअड्डा
Purnea Airport	nativenameA	पूर्णियाँ हवाई अड्डा
Aleppo International Airport	nativenameA	(مطار حلب الدولي)
Ministry of Science and Technology	nativenameA	科技部
Oran Es Sénia Airport	nativenameA	مطاز احمد بن بلة -وهران
Komatsu Airport	nativenameA	Komatsu Airport
Swami Vivekananda Airport	nativenameA	स्वामी विवेकानंद हवाई अड्डा, रायपुर
Ministry of Security and Public Administration	nativenameA	안전행정부
Transport Department	nativenameA	運輸署
Office of the Ombudsman	nativenameA	申訴專員公署
Audit Commission	nativenameA	審計署
Sulaimaniyah International Airport	nativenameA	مطار السليمانية الدولي
Amman Civil Airport	nativenameA	مطار عمان المدني
Yakutsk Airport	nativenameA	/
People's Militias	nativenameA	Lidové milice
Mysore Airport	nativenameA	ಮೈಸೂರು ವಿಮಾನ ನಿಲ್ದಾಣ
Hong Kong Correctional Services	nativenameA	懲教署
Department of Information and Public Relations	nativenameA	PRD
Pevek Airport	nativenameA	Аэропорт Певек
Dikson Airport	nativenameA	Аэропорт Диксон
Provideniya Bay Airport	nativenameA	Аэропорт «Бухта Провидения»
Barnaul Airport	nativenameA	Аэропорт Барнаул
Ignatyevo Airport	nativenameA	Аэропорт Игнатьево
Bratsk Airport	nativenameA	Аэропорт Братск
Chulman Airport	nativenameA	Аэропорт Нерюнгри
Cheboksary Airport	nativenameA	Международный Аэропорт Чебоксары
Kemerovo International Airport	nativenameA	Международный Аэропорт Кемерово
Pobedilovo Airport	nativenameA	Аэропорт Победилово
Kotlas Airport	nativenameA	Аэропорт Котлас
Magnitogorsk International Airport	nativenameA	Международный аэропорт Магнитогорск
Nalchik Airport	nativenameA	Аэропорт Нальчик
Naryan-Mar Airport	nativenameA	Аэропорт Нарьян-Мар
Nizhnevartovsk Airport	nativenameA	Аэропорт Нижневартовск
Spichenkovo Airport	nativenameA	Аэропорт Спиченково
Strigino International Airport	nativenameA	Международный аэропорт Стригино
Orsk Airport	nativenameA	Аэропорт Орск
Omsk Tsentralny Airport	nativenameA	Аэропорт Центральный
Petrozavodsk Airport	nativenameA	Аэропорт Петрозаводск
Polyarny Airport	nativenameA	Аэропорт Полярный
Pskov Airport	nativenameA	Аэропорт Псков
Rostov-on-Don Airport	nativenameA	Международный аэропорт Ростов-на-Дону
Kurumoch International Airport	nativenameA	Международный аэропорт «Курумоч»
Beslan Airport	nativenameA	Аэропорт Беслан
Volgograd International Airport	nativenameA	Международный Аэропорт Волгоград
Voronezh International Airport	nativenameA	Международный аэропорт Воронеж-Чертовицкое
Ostrov Bolshevik	nativenameA	о́стров Большеви́к
Chekurovka	nativenameA	Чекуровка
Dudinka Airport	nativenameA	Аэропорт \
Valek Airport	nativenameA	Аэропорт Валек
Igarka Airport	nativenameA	Аэропорт \
Salekhard Airport	nativenameA	Аэропорт Салехард
Mezen Airport	nativenameA	Аэропорт Мезень
Pechora Airport	nativenameA	Аэропорт Печора
Turukhansk Airport	nativenameA	Аэропорт \
Seymchan Airport	nativenameA	Аэропорт Сеймчан
Kogalym International Airport	nativenameA	(Международный аэропорт Когалым)
Nyagan Airport	nativenameA	Аэропорт Нягань
Kyzyl-Syr Airport	nativenameA	Аэропорт Кызыл-Сыр
Tura Airport	nativenameA	Аэропорт \
Nefteyugansk Airport	nativenameA	Аэропорт Нефтеюганск
Podkamennaya Tunguska Airport	nativenameA	Аэропорт «Подкаменная Тунгуска»
Jakkur Aerodrome	nativenameA	ಜಕ್ಕೂರು ಏರೋಡ್ರೋಮ್
Yelahanka Air Force Station	nativenameA	ಯಲಹಂಕ ಏರ್ ಫೋರ್ಸ್ ಸ್ಟೇಷನ್
State Security Investigations Service	nativenameA	مباحث أمن الدولة
Severo-Eniseysk Airport	nativenameA	Аэропорт Северо-Енисейск
Severouralsk Airport	nativenameA	Аэропорт Североуральск
Pushkin Airport	nativenameA	Аэропорт Пушкин
Rzhevka Airport	nativenameA	Аэропорт Ржевка
Vologda Airport	nativenameA	Аэропорт Вологда
Berezniki Airport	nativenameA	Аэропорт Березники
Kondinskoye Airport	nativenameA	Аэропорт Кондинское
Bhavnagar Airport	nativenameA	ભાવનગર હવાઇ-મથક
Magadan-13 Airport	nativenameA	Аэропорт Магадан-13
Palana Airport	nativenameA	Аэропорт Палана
Kandla Airport	nativenameA	કંડલા એરપોર્ટ
Staroselye Airport	nativenameA	Аэропорт Староселье
Boguchany Airport	nativenameA	Аэропорт Богучаны
Mama Airport	nativenameA	Аэропорт Мама
Nikolskoye Airport	nativenameA	Аэропорт Никольское
Tunoshna Airport	nativenameA	(Международный аэропорт Ярославль )
Velikiye Luki Airport	nativenameA	Аэропорт Великие Луки
Semyazino Airport	nativenameA	Аэропорт Семязино
Ivanovo Yuzhny Airport	nativenameA	Аэропорт Южный
Yoshkar-Ola Airport	nativenameA	Якшар-Хала Аэропорт
Neftekamsk Airport	nativenameA	Аэропорт Нефтекамск
Izhevsk Airport	nativenameA	Аэропорт Ижевск
Uktus Airport	nativenameA	Аэропорт Уктус
Charbatia Air Base	nativenameA	चारबतिया हवाई अड्डा
Zheleznogorsk Airport	nativenameA	Аэропорт Железногорск
Orenburg Tsentralny Airport	nativenameA	Аэропорт Центральный
Saratov Tsentralny Airport	nativenameA	Аэропорт Центральный
Vitebsk Vostochny Airport	nativenameA	/
Zhukovsky International Airport	nativenameA	Международный аэропорт Жуковский
Borisoglebskoye Airfield	nativenameA	\
Begishevo Airport	nativenameA	Аэропорт Бегишево
Kurgan Airport	nativenameA	Аэропорт Курган
Nizhneangarsk Airport	nativenameA	Аэропорт Нижнеангарск
Smolensk South Airport	nativenameA	Смоленск-Южный
Tretyakovo Airport	nativenameA	Аэропорт Третьяково
Protasovo	nativenameA	Протасово
Turlatovo Airport	nativenameA	Аэропорт Турлатово
Kaluga	nativenameA	Аэропорт Калуга
Saransk Airport	nativenameA	Аэропорт Саранск
Oktyabrsky Airport	nativenameA	Аэропорт Октябрьский
Bugulma Airport	nativenameA	Аэропорт Бугульма
Oryol Yuzhny Airport	nativenameA	Аэропорт Южный
Lipetsk Airport	nativenameA	Аэропорт Липецк
Biysk Airport	nativenameA	Аэропорт Бийск
Kursk Vostochny Airport	nativenameA	Аэропорт Восточный
Pridacha Airport	nativenameA	Аэропорт Придача
Rubtsovsk Airport	nativenameA	Аэропорт Рубцовск
Gorno-Altaysk Airport	nativenameA	Аэропорт Горно-Алтайск
Kiev Chaika Airfield	nativenameA	Аеродром Київ Чайка
Aktobe Airport	nativenameA	Международный аэропорт Актобе
Krasnokamensk Airport	nativenameA	Аэропорт Краснокаменск
Horodok	nativenameA	Авіабаза «Городок»
Oregon Department of Human Services	nativenameA	ODHS
Khmelnytskyi Airport	nativenameA	Міжнародний аеропорт Хмельницький
Agatti Aerodrome	nativenameA	അകത്തി  വിമാനത്താവളം
Technical Education and Skills Development Authority	nativenameA	TESDA
Madurai Airport	nativenameA	மதுரை வானூர்தி நிலையம்
Mazar-e Sharif International Airport	nativenameA	میدان هوائی مزار شریف
Ministry of Communications and Information Technology	nativenameA	دمخابیراتو وزارت
Sahnewal Airport	nativenameA	साहनेवाल हवाई अड्डे
Ministry of Overseas Indian Affairs	nativenameA	प्रवासी भारतीय मामलों के मंत्रालय
Karnal Airport	nativenameA	Karnal Aviation Club
Bar Council of India	nativenameA	भारतीय विधिज्ञ परिषद
Ministry for Food, Agriculture, Forestry and Fisheries	nativenameA	농림수산식품부
Hrodna Airport	nativenameA	Аэропорт Гродно
Mogilev Airport	nativenameA	Аэропорт Могилёв
Korea Deposit Insurance Corporation	nativenameA	예금보험공사
Uzhhorod International Airport	nativenameA	(Міжнародний аеропорт \
Khon Kaen Airport	nativenameA	ท่าอากาศยานขอนแก่น
Lampang Airport	nativenameA	ท่าอากาศยานลำปาง
Trat Airport	nativenameA	ท่าอากาศยานตราด
Noto Airport	nativenameA	能登空港
Ghadames Airport	nativenameA	90
Al Abraq International Airport	nativenameA	مطار الأبرق الدولي
Nador International Airport	nativenameA	Anafag n Ennaḍor Aɛarwi
Nador International Airport	nativenameA	مطار الناظور العروي
Rabat–Salé Airport	nativenameA	مطار الرباط سلا
Lindi Airport	nativenameA	Kikwetu Airport
Alexandroupoli Airport	nativenameA	Κρατικός Αερολιμένας Αλεξανδρούπολης \
Astypalaia Island National Airport	nativenameA	Κρατικός Αερολιμένας Αστυπάλαιας
Ikaria Island National Airport	nativenameA	Κρατικός Αερολιμένας Ικαρίας
Kasos Island Public Airport	nativenameA	Δημοτικός Αερολιμένας Κάσου
Karpathos Island National Airport	nativenameA	Κρατικός Αερολιμένας Καρπάθου
Kastellorizo Airport	nativenameA	Δημοτικός Αερολιμένας Καστελλόριζου
Kastoria National Airport	nativenameA	Κρατικός Αερολιμένας Καστοριάς, Αριστοτέλης
Cephalonia International Airport	nativenameA	Κρατικός Αερολιμένας Κεφαλονιάς \
Kithira Island National Airport	nativenameA	Κρατικός Αερολιμένας Κυθήρων \
Kos Island International Airport	nativenameA	(Κρατικός Αερολιμένας Κω, Ιπποκράτης)
Milos Island National Airport	nativenameA	Κρατικός Αεροδρόμιο Μήλου
Mykonos Island National Airport	nativenameA	Κρατικός Αερολιμένας Μυκόνου
Naxos Island National Airport	nativenameA	Κρατικός Αερολιμένας Νάξου
Paros National Airport	nativenameA	Κρατικός Αερολιμένας Πάρου
Mytilene International Airport	nativenameA	Κρατικός Αερολιμένας Μυτιλήνης \
Sitia Public Airport	nativenameA	Δημοτικός Αερολιμένας Σητείας «Βιτσέντζος Κορνάρος»
Skyros Island National Airport	nativenameA	Κρατικός Αερολιμένας Σκύρου
Skiathos Island National Airport	nativenameA	Κρατικός Αερολιμένας Σκιάθου «Αλέξανδρος Παπαδιαμάντης»
Santorini	nativenameA	Κρατικός Αερολιμένας Σαντορίνης
Gorgan Airport	nativenameA	فرودگاه گرگان
Albenga Airport	nativenameA	Clemente Panero Airport
El Hierro Airport	nativenameA	Aeropuerto de los Cangrejos
Kryvyi Rih International Airport	nativenameA	(\
Luhansk International Airport	nativenameA	\
Ahvaz International Airport	nativenameA	فرودگاه بین‌المللی اهواز
Ilam Airport	nativenameA	New airport of Ilam
Kish International Airport	nativenameA	فرودگاه بین المللی کیش
Ramsar International Airport	nativenameA	فرودگاه بین المللی رامسر
Rasht Airport	nativenameA	فرودگاه رشت
Dasht-e Naz Airport	nativenameA	فرودگاه دشت  ناز ساری
Zahedan Airport	nativenameA	فرودگاه بین‌المللی زاهدان
Honda Airport	nativenameA	ホンダエアポート
Dawadmi Domestic Airport	nativenameA	(Dawadmi Airport)
Jizan Regional Airport	nativenameA	(King Abdullah bin Abdulaziz Airport)
Hakka Affairs Council	nativenameA	客家委員會
Ministry of Science and Technology	nativenameA	과학기술부
Nanning Wuxu International Airport	nativenameA	''
Shantou Waisha Airport	nativenameA	汕头外砂机场
Lengpui Airport	nativenameA	लेंगपुई हवाई अड्डा
Civil Aerodrome Khajuraho	nativenameA	खजुराहो हवाई अड्डे
Kolhapur Airport	nativenameA	कोल्हापूर विमानतळ
Jamnagar Airport	nativenameA	જામનગર વિમાનમથક
Jodhpur Airport	nativenameA	जोधपुर हवाई अड्डा
Civil Service Bureau	nativenameA	公務員事務局
Ministry of Defence	nativenameA	Wasaaradda Gaashaandhiga
Porbandar Airport	nativenameA	Pōrabandara ērapōrṭa
Tuticorin Airport	nativenameA	தூத்துக்குடி விமான நிலையம்
Temindung Airport	nativenameA	Aéroport Temindung
Amami Airport	nativenameA	奄美空港
Aomori Airport	nativenameA	青森空港
Iwami Airport	nativenameA	石見空港
Hanamaki Airport	nativenameA	花巻空港
Hachijojima Airport	nativenameA	八丈島空港
Kōchi Airport	nativenameA	高知空港
Kumejima Airport	nativenameA	久米島空港
Kumamoto Airport	nativenameA	Kumamoto Kūkō
Matsumoto Airport	nativenameA	松本空港
Matsuyama Airport	nativenameA	Matsuyama kūkō
Memanbetsu Airport	nativenameA	女満別空港
Miyakejima Airport	nativenameA	三宅島空港
Miyako Airport	nativenameA	宮古空港
Miyazaki Airport	nativenameA	宮崎空港
Saga Airport	nativenameA	佐賀空港
Shonai Airport	nativenameA	庄内空港
Oshima Airport	nativenameA	大島空港
Rishiri Airport	nativenameA	Rishiri Island Airport
Tokachi–Obihiro Airport	nativenameA	とかち帯広空港
Nakashibetsu Airport	nativenameA	中標津空港
Yamagata Airport	nativenameA	山形空港
Yamaguchi Ube Airport	nativenameA	山口宇部空港
Tottori Airport	nativenameA	鳥取空港
Tottori Airport	nativenameA	Tottori Kūkō
Tokunoshima Airport	nativenameA	徳之島空港
Miho–Yonago Airport	nativenameA	美保飛行場
Atyrau Airport	nativenameA	Международный аэропорт Атырау
Kostanay Airport	nativenameA	Международный аэропорт Костанай
Shymkent International Airport	nativenameA	Халықаралық Шымкент Әуежайы
Gunsan Airport	nativenameA	Gunsan Gonghang
Pohang Airport	nativenameA	Pohang Gonghang
Wonju Airport	nativenameA	Wonju Gonghang
Ulsan Airport	nativenameA	Ulsan Gonghang
Sacheon Airport	nativenameA	Sacheon Gonghang
Narathiwat Airport	nativenameA	ท่าอากาศยานนราธิวาส
King Abdulaziz Naval Base	nativenameA	قاعدة الملك عبدالعزيز البحرية
China Insurance Regulatory Commission	nativenameA	中国保险监督管理委员会
RAF Lindholme	nativenameA	90
Ibaraki Airport	nativenameA	百里飛行場/百里基地
Shizuoka Airport	nativenameA	静岡空港
Hauptamt Volksdeutsche Mittelstelle	nativenameA	VoMi
RoAF 95th Air Base	nativenameA	Baza Aeriana 95 Bacău
Muan International Airport	nativenameA	무안국제공항
Muan International Airport	nativenameA	務安國際空港
Ministry of External Affairs	nativenameA	विदेश मंत्रालय
Ministry of Law and Justice	nativenameA	विधि एवं न्‍याय मंत्रालय
National Development and Reform Commission	nativenameA	中华人民共和国国家发展和改革委员会
Nakhon Ratchasima Airport	nativenameA	ท่าอากาศยานนครราชสีมา
Changzhou Benniu Airport	nativenameA	Chángzhōu Bēnniú Jīchǎng
Plovdiv Airport	nativenameA	Krumovo Airport
Ministry of Finance	nativenameA	वित्त मंत्रालय
Ministry of Foreign Affairs	nativenameA	外交部
National Directorate of Security	nativenameA	ریاست امنیت ملی
Ministry of Foreign Affairs	nativenameA	외교부
Khost Airfield	nativenameA	دخوست هوائی ډګر
Ministry of Education	nativenameA	Jiàoyùbù
Ministry of Justice	nativenameA	法務部
Ministry of Interior	nativenameA	''Ministarstvo unutrašnjih poslova
Ministry of Interior	nativenameA	Republike Srpske''
Kerala Police Academy	nativenameA	കേരള പോലീസ് അക്കാദമി
Hunsdon Airfield	nativenameA	90
Čačak Airport	nativenameA	(Аеродром Чачак)
Food and Health Bureau	nativenameA	食物及衞生局
Securities and Futures Commission	nativenameA	證券及期貨事務監察委員會
Nadirgul Airfield	nativenameA	నాదర్‌గుల్ విమాన క్షేత్రము
Financial Supervisory Commission	nativenameA	金融監督管理委員會
Kruševac Airport	nativenameA	Аеродром Коширско поље
Kostolac Airport	nativenameA	(Аеродром Костолац)
Nerlerit Inaat Airport	nativenameA	Constable Pynt Lufthavn
Gorna Oryahovitsa Airport	nativenameA	Летище Горна Оряховица
Aswan International Airport	nativenameA	مطار أسوان الدولي
Kikinda Airport	nativenameA	Aerodrom Drahslerov Salaš
Bela Crkva Airport	nativenameA	Aerodrom Bela Crkva
Brege Airport	nativenameA	(Aеродром Бреге)
Smederevo Airport	nativenameA	(Аеродром Смедерево)
Grozny Airport	nativenameA	Аэропорт «Грозный»
Beirut–Rafic Hariri International Airport	nativenameA	مطار بيروت رفيق الحريري الدولي
Bojnik Airport	nativenameA	(Аеродром Бојник)
Civil Aviation Department	nativenameA	民航處
Aktau Airport	nativenameA	Международный аэропорт Актау
Nazran Airport	nativenameA	Аэропорт Назрань
Zemun Polje Airport	nativenameA	Aеродром 13. Maj-Земун Поље
Hesa Air Base	nativenameA	فرودگاه هسا
Progar Airport	nativenameA	(Аеродром Прогар)
Požarevac Airport	nativenameA	(Аеродром Пожаревац)
Banjički Vis Military Base	nativenameA	(Аеробаза Бањички Вис)
Kibrit Air Base	nativenameA	RAF Kabrit
Iki Airport	nativenameA	壱岐空港
Mongolian and Tibetan Affairs Commission	nativenameA	蒙藏委員會
Cardiff Heliport	nativenameA	Cardiff Heliport
National Synchrotron Radiation Research Center	nativenameA	國家同步輻射研究中心
Iruma Air Base	nativenameA	入間基地
Raja Haji Fisabilillah Airport	nativenameA	بانداراينتيرناتيونالراحاحاخيفيسابيليللاح
National Office of Statistics	nativenameA	الديوان الوطني للإحصائيات
State Administration of Taxation	nativenameA	国家税务总局
Ajman International Airport	nativenameA	مطار عجمان الدولي
Public Security Intelligence Agency	nativenameA	公安調査庁
Moneygall Aerodrome	nativenameA	Moneygall Airstrip
Yoron Airport	nativenameA	与論空港
Asayish	nativenameA	Encumena Asayîşa Herêma Kurdistanê
Kerama Airport	nativenameA	慶良間空港
Aguni Airport	nativenameA	粟国空港
Minami-Daito Airport	nativenameA	南大東空港
Tarama Airport	nativenameA	多良間空港
Hateruma Airport	nativenameA	波照間空港
Kitadaito Airport	nativenameA	北大東空港
Shimojishima Airport	nativenameA	下地島空港
Security Police	nativenameA	警備部警護課
Kikai Airport	nativenameA	喜界空港
New Tanegashima Airport	nativenameA	新種子島空港
Oki Airport	nativenameA	隠岐空港
RAF Milltown	nativenameA	90
Okinoerabu Airport	nativenameA	沖永良部空港
Yakushima Airport	nativenameA	屋久島空港
Television and Entertainment Licensing Authority	nativenameA	影視及娛樂事務管理處
Nowy Targ Airport	nativenameA	Lotnisko Nowy Targ
Tokyo Metropolitan Police Department Public Security Bureau	nativenameA	警視庁公安部
Stara Zagora Airport	nativenameA	Летище Стара Загора
Czech Statistical Office	nativenameA	ČSÚ
Ministry of the Interior	nativenameA	행정자치부
Ali-Sabieh Airport	nativenameA	مطار علي سايبه
Singapore Customs	nativenameA	Kastam Singapura
Sialkot Cantonment Airport	nativenameA	سیالکوٹ فوجی ہوائی اڈا
Okushiri Airport	nativenameA	奥尻空港
El Loa Airport	nativenameA	El Loa Airdrome
Sports Administration	nativenameA	體育署
Shimla Airport	nativenameA	शिमला विमानपत्तन
Akola Airport	nativenameA	Shivani Airport
RAF Wickenby	nativenameA	Wickenby Airport
Rome Viterbo Airport	nativenameA	Viterbo Air Force Base
Flanders International Airport	nativenameA	(Kortrijk/Wevelgem Airport)
Sisimiut Airport	nativenameA	Sisimiut Lufthavn
Land, Public works and Transport Bureau	nativenameA	土地工務運輸局 / Direcção dos Serviços de Solos, Obras Públicas e Transporte
Office of the Telecommunications Authority	nativenameA	電 訊 管 理 局
Board of Intermediate and Secondary Education, Hyderabad	nativenameA	BISE Hyderabad
Patiala Airport	nativenameA	Civil Aerodrome Patiala
Defense Intelligence Headquarters	nativenameA	情報本部
Palmyra Airport	nativenameA	90
Ministry of Foreign Affairs	nativenameA	وزارة الشؤون الخارجية
Yeouido Airport	nativenameA	Yeouido Bihaengjang
Ministry of Economic Affairs	nativenameA	經濟部
National Communications Commission	nativenameA	國家通訊傳播委員會
RAF St Angelo	nativenameA	90
Andravida Air Base	nativenameA	ΑΒ Ανδραβίδας
Ministry of Defence	nativenameA	กระทรวงกลาโหม
General Intelligence Directorate	nativenameA	إدارة المخابرات العامة
Tachikawa Airfield	nativenameA	立川飛行場
Financial Services Commission	nativenameA	금융위원회
Financial Supervisory Service	nativenameA	금융감독원
Ministry of Defence of Bosnia and Herzegovina	nativenameA	Министарство одбране
Ministry of Defence of Bosnia and Herzegovina	nativenameA	Босне и Херцеговине
Sedes Airport	nativenameA	Αεροδρόμιο Σέδες
Air Force Intelligence Directorate	nativenameA	إدارة المخابرات الجوية
Tripoli Airport	nativenameA	Αεροδρόμιο Τριπόλεως
Tatoi Airport	nativenameA	Αεροδρόμιο Τατοϊου
Agra Airport	nativenameA	Kheria Air Force Station
Interstate Aviation Committee	nativenameA	Межгосударственный авиационный комитет
Porto Cheli Airport	nativenameA	Αεροδρόμιο Πόρτο Χέλι
Larissa National Airport	nativenameA	Αεροδρόμιο Λάρισσας “Θεσσαλία”
Board of Intermediate and Secondary Education, Lahore	nativenameA	BISE Lahore
Bamyan Airport	nativenameA	میدان هوایی بامیان
Farah Airport	nativenameA	د فراه هوائی ډګر
Julius Kühn-Institut	nativenameA	Bundesforschungsinstitut für Kulturpflanzen
Salem Airport	nativenameA	சேலம் விமான நிலையம்
Rayak Air Base	nativenameA	قاعدة رياق الجوية
Security Information Agency	nativenameA	Bezbednosno-informativna agencija
Civil Engineering and Development Department	nativenameA	土木工程拓展署
Office of the Prime Minister	nativenameA	สำนักนายกรัฐมนตรี
Ministry of Foreign Affairs	nativenameA	กระทรวงการต่างประเทศ
Ministry of Interior	nativenameA	กระทรวงมหาดไทย
RAF Lympne	nativenameA	HMS Buzzard
RAF Lympne	nativenameA	HMS Daedalus II
Ruse Airport	nativenameA	Летище Русе
Ministry of Commerce	nativenameA	กระทรวงพาณิชย์
Beirut Air Base	nativenameA	قاعدة بيروت الجوية
Ministry of Tourism and Sports	nativenameA	กระทรวงการท่องเที่ยวและกีฬา
Taipei City Government	nativenameA	Táiběi Shì Zhèngfǔ
Ministry of Natural Resources and Environment	nativenameA	กระทรวงทรัพยากรธรรมชาติและสิ่งแวดล้อม
Ministry of Industry	nativenameA	กระทรวงอุตสาหกรรม
Ministry of Agriculture and Cooperatives	nativenameA	กระทรวงเกษตรและสหกรณ์
Ministry of the Interior	nativenameA	內政部
Ministry of Justice	nativenameA	กระทรวงยุติธรรม
Pathankot Airport	nativenameA	ਪਠਾਨਕੋਟ ਹਵਾਈ ਅੱਡਾ
National Fire Agency	nativenameA	消防署
Central Election Commission	nativenameA	中央選舉委員會
Ministry of Health and Welfare	nativenameA	衛生福利部
Vellore Airport	nativenameA	வேலூர் விமான நிலையம்
Fair Trade Commission	nativenameA	公平交易委員會
Consumer Protection Committee	nativenameA	行政院消費者保護會
Central Field	nativenameA	硫黄島飛行場
Aviation Safety Council	nativenameA	飛航安全調查委員會
Construction and Planning Agency	nativenameA	營建署
Council for Economic Planning and Development	nativenameA	經濟建設委員會
State Electricity Regulatory Commission	nativenameA	国家电力监管委员会
State Oceanic Administration	nativenameA	国家海洋局
State Administration of Cultural Heritage	nativenameA	国家文物局
Legislative Affairs Office	nativenameA	国务院法制办公室
Development Research Center of the State Council	nativenameA	国务院发展研究中心
Qaarsut Airport	nativenameA	Uummannaq/Qaarsut Airport
Maniitsoq Airport	nativenameA	Maniitsoq Lufthavn
Tourism Bureau	nativenameA	觀光局
Upernavik Airport	nativenameA	Upernavik Lufthavn
Hong Kong Observatory	nativenameA	香港天文台
Paamiut Airport	nativenameA	Paamiut Lufthavn
Public Construction Commission	nativenameA	公共工程委員會
Atomic Energy Council	nativenameA	原子能委員會
Assessment and Evaluation Commission	nativenameA	مفوضية التقيم و التقدير
Maleme Airport	nativenameA	Αεροδρόμιο Μάλεμε
Bureau of Indian Standards	nativenameA	भारतीय मानक ब्यूरो
Creative Scotland	nativenameA	Alba Chruthachail
Quang Tri Airport	nativenameA	Sân bay Quảng Trị
Tabing Airport	nativenameA	باندارتابڠ
Xinjin Airport	nativenameA	新津机场
Guanghan Airport	nativenameA	广汉机场
Brest Airport	nativenameA	Аэропорт Брест
Volos Army Airport	nativenameA	Κρατικός Αερολιμένας Βόλου/Νέας Ιωνίας
Directorate General of Civil Aviation	nativenameA	नागर विमानन महानिदेशालय
Cerklje ob Krki Airport	nativenameA	Letališče Cerklje
Hamamatsu Air Base	nativenameA	浜松基地
Shizuhama Air Base	nativenameA	静浜基地
Teniente R. Marsh Airport	nativenameA	Aeropuerto Teniente Rodolfo Marsh
KGB	nativenameA	Комитет государственной безопасности
KGB	nativenameA	КГБ СССР
Macao Meteorological and Geophysical Bureau	nativenameA	Direcção dos Serviços Meteorológicos e Geofisicos
Macao Meteorological and Geophysical Bureau	nativenameA	澳門地球物理暨氣象局
Mauritanian Post Company	nativenameA	La Société Mauritanienne des Postes
Poste Maroc	nativenameA	Poste Maroc
Pinang Kampai Airport	nativenameA	بانداراقيناغكمقاي
Xi'an Xiguan Airport	nativenameA	西安西关机场
Maykop Airport	nativenameA	Аэропорт «Майкоп»
Tokachi Airfield	nativenameA	十勝飛行場
Kasuminome Air Field	nativenameA	霞目飛行場
Nyutabaru Air Base	nativenameA	新田原基地
Ozuki Air Field	nativenameA	小月飛行場
Matsushima Air Field	nativenameA	松島飛行場
Kōnan Airport	nativenameA	岡南飛行場
Kasumigaura Air Field	nativenameA	霞ヶ浦飛行場
Kisarazu Air Field	nativenameA	木更津飛行場
Gifu Air Field	nativenameA	岐阜飛行場
Metabaru Air Field	nativenameA	目達原駐屯地
Kanoya Air Field	nativenameA	鹿屋飛行場
Hōfu Air Field	nativenameA	防府飛行場
Ojika Airport	nativenameA	小値賀空港
Kōzushima Airport	nativenameA	神津島空港
Niijima Airport	nativenameA	新島空港
Ashiya Air Field	nativenameA	芦屋飛行場
Utsunomiya Air Field	nativenameA	宇都宮飛行場
Tsuiki Air Field	nativenameA	築城飛行場
Civil Aviation Authority	nativenameA	民航局, Autoridade de Aviação Civil de Macau
Haneda Airport	nativenameA	(Tōkyō Kokusai Kūkō)
Narita International Airport	nativenameA	(成田国際空港)
Itami Airport	nativenameA	伊丹空港
Itami Airport	nativenameA	大阪国際空港
China Atomic Energy Authority	nativenameA	国家原子能机构
Martuba Air Base	nativenameA	90
Orléans – Bricy Air Base	nativenameA	« Commandant Charles Paoli »
Sint-Truiden Air Base	nativenameA	(Sint-Truiden/Brustem Airport)
Ras Tanura Airport	nativenameA	مطار راس تنورة
Abqaiq Airport	nativenameA	مطار بقيق
Udhayliyah Airport	nativenameA	مطار العضيلية
Khafji Airport	nativenameA	مطار الخفجي
Jubail Airport	nativenameA	مطار الجبيل
Abu Ali Airport	nativenameA	مطار ابو علي
Ras Tanajib Airport	nativenameA	مطار رأس تناجيب
Ras Mishab Airport	nativenameA	مطار راس مشعاب
Haradh Airport	nativenameA	مطار حرض
Shaybah Airport	nativenameA	مطار شيبة
Council of Agriculture	nativenameA	農業委員會
Youth Development Administration	nativenameA	教育部青年發展署
Research, Development and Evaluation Commission	nativenameA	研究發展考核委員會
Directorate General of Budget, Accounting and Statistics	nativenameA	行政院主計總處
Directorate-General of Personnel Administration	nativenameA	人事行政總處
Phu Quoc International Airport	nativenameA	Cảng hàng không quốc tế Phú Quốc
Hangzhou Jianqiao Airport	nativenameA	杭州笕桥机场
Liangping Airport	nativenameA	梁平机场
Chongqing Baishiyi Airport	nativenameA	重庆白市驿机场
Pathankot Air Force Station	nativenameA	ਪਠਾਨਕੋਟ ਹਵਾਈ ਅੱਡਾ
Ministry of Employment and Labor	nativenameA	고용노동부
Department of Non Resident Keralites Affairs	nativenameA	NORKA
Satna Airport	nativenameA	सतना हवाई अड्डे
Khandwa Airport	nativenameA	खंडवा हवाई अड्डे
Puducherry Airport	nativenameA	புதுச்சேரி விமான நிலையம்
Cuerpo de Investigaciones Científicas, Penales y Criminalísticas	nativenameA	CICPC
Central Institution for Meteorology and Geodynamics	nativenameA	ZAMG
Census and Statistics Department	nativenameA	政府統計處
Wujah Al Hajar Air Base	nativenameA	Pierre Gemayel International Airport
Ministry of National Education	nativenameA	Ministère de l'Éducation nationale
Commerce and Economic Development Bureau	nativenameA	商務及經濟發展局
Transport and Housing Bureau	nativenameA	運輸及房屋局
IIT Kanpur Airport	nativenameA	आईआईटी कानपुर हवाई अड्डा
Constitutional and Mainland Affairs Bureau	nativenameA	政制及內地事務局
Development Bureau	nativenameA	發展局
Ministry of Finance	nativenameA	Министерство на финансите
Poltava Air Base	nativenameA	Авиабаза «Полтава»
Environment Bureau	nativenameA	環境局
Labour and Welfare Bureau	nativenameA	勞工及福利局
Zavodske Airfield	nativenameA	Аеропорт \
Vojnoobaveštajna agencija	nativenameA	Vojnoobaveštajna Agencija
Military Security Agency	nativenameA	Vojnobezbednosna Agencija
Information and Communication Technologies Authority	nativenameA	ICTA
L'Aquila–Preturo Airport	nativenameA	Preturo Airport
Bureau of the Royal Household	nativenameA	Samnak Phra Ratcha Wang
National Council for Social Security Fund	nativenameA	全国社会保障基金理事会
Hosur Aerodrome	nativenameA	ஒசூர் ஆகாய விமான நிலையம்
Bureau of Foreign Trade	nativenameA	經濟部國際貿易局
Thiruvananthapuram Development Authority	nativenameA	തിരുവനന്തപുരം നഗര പ്രദേശ വികസന സമിതി
Nal Airport	nativenameA	बीकानेर एयर फोर्स बेस
Gelendzhik Airport	nativenameA	Аэропорт Геленджик
Presidential Council on Nation Branding, Korea	nativenameA	국가 브랜드 위원회
Wuhu Airport	nativenameA	芜湖机场
Wonsan Kalma International Airport	nativenameA	원산갈마국제공항
RAF Findo Gask	nativenameA	90
La Cerdanya Aerodrome	nativenameA	Aeròdrom de la Cerdanya
Kannur International Airport	nativenameA	കണ്ണൂർ അന്താരാഷ്ട്ര വിമാനത്താവളം
Ministry of Internal Affairs	nativenameA	''Ministarstvo unutrašnjih poslova
Ministry of Internal Affairs	nativenameA	''Republike Srbije
RAF Breighton	nativenameA	90
National Agency for Computer Security	nativenameA	الوكالة الوطنية للسلامة المعلوماتية
Chichijima Airfield	nativenameA	父島飛行場
Intelligence-Security Agency of Bosnia and Herzegovina	nativenameA	Obavještajno sigurnosna / bezbjednosna agencija BiH
Guam Environmental Protection Agency	nativenameA	Ahensian Pruteksion Lina'La Guahan
Ras al Hadd Airport	nativenameA	مطار رأس الحد
Sohar Airport	nativenameA	مطار صحار الدولي
Adam Airport	nativenameA	مطار آدم
Board of Intermediate and Secondary Education, Faisalabad	nativenameA	BISE Fsd
Bahrain News Agency	nativenameA	وكالة انباء البحرين
Board of Intermediate and Secondary Education, Gujranwala	nativenameA	BISE Gujranwala
Board of Intermediate and Secondary Education, Multan	nativenameA	BISE Multan
Board of Intermediate and Secondary Education, Bahawalpur	nativenameA	BISE Bahawalpur
Board of Intermediate and Secondary Education, Sargodha	nativenameA	BISE Sargodha
Board of Intermediate and Secondary Education, Dera Ghazi Khan	nativenameA	BISE DG Khan
Board of Intermediate and Secondary Education, Larkana	nativenameA	BISE Larkana
Korea Communications Commission	nativenameA	大韓民國 放送通信委員會
Connemara Airport	nativenameA	Minna Airport
New Chitose Airport	nativenameA	(新千歳空港)
Puntland Intelligence Agency	nativenameA	Hay’ada Sirdoonka Buntlaand
Jilin Ertaizi Airport	nativenameA	吉林二台子机场
Ministry of Public Safety and Security	nativenameA	國民安全處
National Election Commission	nativenameA	中央選擧管理委員會
Republic Hydrometeorological Institute of Serbia	nativenameA	Republički hidrometeorološki zavod Srbije
Correctional Services Bureau	nativenameA	Estabelecimento Prisional de Macau
Sabha Air Base	nativenameA	90
Berdyansk Airport	nativenameA	\
Kerch Airport	nativenameA	Аеропорт «Керч»
Cherkasy International Airport	nativenameA	\
Castellón–Costa Azahar Airport	nativenameA	(Aeroport de Castelló)
Local Government Officials Development Institute	nativenameA	地方行政硏修院
Ministry of Education, Science and Technology	nativenameA	교육과학기술부
Ministry of Education	nativenameA	교육부
Ministry of Gender Equality and Family	nativenameA	여성가족부
Ministry of Land, Infrastructure and Transport	nativenameA	국토교통부
Cologne Butzweilerhof Airport	nativenameA	RAF Butzweilerhof
Shirdi Airport	nativenameA	शिर्डी विमानतळ
An Giang Airport	nativenameA	Cảng hàng không An Giang
Chhatrapati Sambhaji Raje Airport	nativenameA	छत्रपती संभाजी राजे आंतरराष्ट्रीय विमानतळ
Uprava za obaveštajno izvidjačke poslove	nativenameA	J-2
Tea Research and Extension Station	nativenameA	行政院農業委員會茶業改良場
Ministry of Interior	nativenameA	وزارة الداخلية
Ghazni Airport	nativenameA	د غزنی نړیوال هوایی ډګر
State Special Communications Service of Ukraine	nativenameA	/
OBKhSS	nativenameA	Отдел по борьбе с хищениями социалистической собственности
INS Dega	nativenameA	आईएनएस डेगा
Jhansi Airport	nativenameA	جھانسی ہوائی اڈا \n200px
Meerut Airport	nativenameA	میرٹھ ہوائی اڈا
National Security Agency	nativenameA	جهاز الأمن الوطني
Bareilly Airport	nativenameA	بریلی ہوائی اڈا\n60px
Lucknow Air Force Station	nativenameA	Bakshi Ka Talab Air Force Station
Special Security Force Command	nativenameA	قيادة قوة الأمن الخاصة
Hadapsar Airport	nativenameA	हडपसर विमानतळ
Kaohsiung City Government	nativenameA	高雄市政府
Bidar Airport	nativenameA	ಬೀದರ್ ವಿಮಾನ ನಿಲ್ದಾಣ
Payerne Air Base	nativenameA	Base aérienne Payerne
Ministry of Healthcare	nativenameA	MO3
Raebareli Airport	nativenameA	इंदिरा गाँधी राष्ट्रीय उड़ान अकेडमी
Lakhimpur Kheri Airport	nativenameA	لکھیم پور کھیری  ہوائی اڈا
Farrukhabad Airport	nativenameA	فرّخ آباد ہوائی اڈا
Slavyansk-na-Kubani Airport	nativenameA	Славянск-на-Кубани
Department of Environment	nativenameA	سازمان حفاظت محیط زیست
Mehsana Airport	nativenameA	મહેસાણા હવાઈમથક
Deesa Airport	nativenameA	ડીસા હવાઇ મથક
Ministry of Energy	nativenameA	กระทรวงพลังงาน
Golfo de Morrosquillo Airport	nativenameA	Tolu Airport
Kismayo Airport	nativenameA	كيسمايو المطار
Hakimpet Air Force Station	nativenameA	हकीमपेट वायुसेना स्टेशन\n60px
Public Security Forces	nativenameA	قوات الأمن العام
Karad Airport	nativenameA	कराड विमानतळ
Liaison Office of the Central People's Government in the Macao Special Administrative Region	nativenameA	Gabinete de Ligação do Governo Central na Região Administrativa Especial de Macau
Montijo Air Base	nativenameA	Base Aérea n.º 6
Hydrometeorological Institute of Montenegro	nativenameA	HMZCG
Karwar Airport	nativenameA	ಕಾರವಾರ  ವಿಮಾನ ನಿಲ್ದಾಣ
National Security Service	nativenameA	Служба национальной безопасности
Nörvenich Air Base	nativenameA	Fliegerhorst Nörvenich
Ministry of Culture	nativenameA	Министерство культуры Российской Федерации
Tho Xuan Airport	nativenameA	Cảng hàng không Thọ Xuân
Zhytomyr Airport	nativenameA	Міжнародний аеропорт «Житомир»
Lymanske Airport	nativenameA	Міжнародний аеропорт «Лиманське»
Izmail International Airport	nativenameA	Аеропорт «Ізмаїл»
Information Affairs Authority	nativenameA	هيئة شؤون الإعلام
RAF Clifton	nativenameA	RAF Rawcliffe
Karaikal Airport	nativenameA	காரைக்கால் விமான நிலையம்
Yongxing Island Airport	nativenameA	永兴岛机场
Ganzhou Huangjin Airport	nativenameA	赣州黄金机场
Hisar Airport	nativenameA	Hisar Aviation Club
Chumphon Airport	nativenameA	ท่าอากาศยานชุมพร
Jagodina Airport	nativenameA	Аеродром Јагодина
Kooddoo Airport	nativenameA	ކޫއްޑޫ އެއަރޕޯޓް
Nanjing Dajiaochang Airport	nativenameA	南京大校场机场
Nanjing Luhe Airport	nativenameA	南京六合机场
Dharavandhoo Airport	nativenameA	ދަރަވަންދޫ އެއަރޕޯޓް
Ghana Space Science and Technology Centre	nativenameA	Ghana Space Agency
Aranmula International Airport	nativenameA	ആറന്മുള അന്താരാഷ്ട്ര വിമാനത്താവളം
Aranmula International Airport	nativenameA	अरनमुला अंतरराष्ट्रीय हवाई अड्डा
RAF Worksop	nativenameA	90
Dorothy Scott Airport	nativenameA	Dorothy Scott International Airport
State Administration for Science, Technology and Industry for National Defence	nativenameA	国家国防科技工业局
Chitrakoot Airport	nativenameA	ہوائی اڈا
RAF Berrow	nativenameA	RAF Pendock Moor
Menagh Military Airbase	nativenameA	قاعدة مطار منغ
Ministry of Education and Science of Ukraine	nativenameA	MOH
Maharashtra State Election Commission	nativenameA	महाराष्ट्र राज्य निवडणूक आयोग
Taiwan Intellectual Property Office	nativenameA	智慧財產局
Ministry of Justice	nativenameA	법무부
Association of East Asian Relations	nativenameA	亞東關係協會
Mineral Resource Authority of Mongolia	nativenameA	Ашигт малтмалын газрын
Hirakud Airstrip	nativenameA	ହିରାକୁଦ୍ ଉଡାଣ ପଥ
National Department for Culture and Arts	nativenameA	جابتن كبودايان دان كسنين نڬارا
Gimhae Air Base	nativenameA	Gimhae Gonggun Kige
Patna Regional Development Authority	nativenameA	PRDA
Sindhudurg Airport	nativenameA	सिंधुदुर्ग विमानतळ
Ankleshwar Airport	nativenameA	અંકલેશ્વર એરપોર્ટ
Suwon Air Base	nativenameA	Suwon Gonggun Kige
Jinhae Airport	nativenameA	Jinhae Gonghang
Iranshahr Airport	nativenameA	فرودگاه ایرانشهر
Office of the Macau Special Administrative Region in Beijing	nativenameA	Delegação da Região Administrativa Especial de Macau em Pequim
Thimarafushi Airport	nativenameA	ތިމަރަފުށި އެއަރޕޯޓް
Supreme Prosecutor Office	nativenameA	最高法院檢察署
Ministry of Energy	nativenameA	Türkmenistanyñ energetika ministrligi
Ministry of Finance	nativenameA	Молия вазирлиги
Administration for Security and Counterintelligence	nativenameA	Управа за безбедност и контраразузнавање
Architecture and Building Research Institute	nativenameA	建築研究所
Ministry of Electronics and Information Technology	nativenameA	इलेक्‍ट्रॉनिकी और सूचना प्रौद्योगिकी मंत्रालय
National Security Commission of the Communist Party of China	nativenameA	中央国家安全委员会
Taipei Representative Office in the U.K.	nativenameA	駐英國台北代表處
Ministry of Co-operatives and Poverty Alleviation	nativenameA	सहकारी मन्त्रालय
National Development Council	nativenameA	國家發展委員會
National Treasury Administration	nativenameA	國庫署
Taxation Administration	nativenameA	財政部賦稅署
National Property Administration	nativenameA	財政部國有財產署
National Security Council	nativenameA	國家安全會議
Taiwan Area National Freeway Bureau	nativenameA	臺灣區國道高速公路局
Taiwan Area National Expressway Engineering Bureau	nativenameA	交通部臺灣區國道新建工程局
Sintra Air Base	nativenameA	Base Aérea Nº 1
Highways Department	nativenameA	路政署
Customs Administration	nativenameA	關務署
Fiscal Information Agency	nativenameA	財政資訊中心
Armaments Bureau	nativenameA	軍備局
Political Warfare Bureau	nativenameA	政治作戰局
National Science and Technology Center for Disaster Reduction	nativenameA	國家災害防救科技中心
Bureau of Cultural Heritage	nativenameA	文化部文化資產局
Bureau of Audiovisual and Music Industry Development	nativenameA	文化部影視及流行音樂產業局
Agriculture and Food Agency	nativenameA	行政院農業委員會農糧署
Forestry Bureau	nativenameA	行政院農業委員會林務局
Industrial Development Bureau	nativenameA	經濟部工業局
Bureau of Standards, Metrology and Inspection	nativenameA	經濟部標準檢驗局
Ministry of Home Affairs	nativenameA	স্বরাষ্ট্র মন্ত্রণালয়
Regional Civil Service Development Institute	nativenameA	行政院人事行政總處地方行政研習中心
Civil Service Development Institute	nativenameA	行政院人事行政總處公務人力發展中心
Fisheries Agency	nativenameA	行政院農業委員會漁業署
Soil and Water Conservation Bureau	nativenameA	行政院農業委員會水土保持局
K-12 Education Administration	nativenameA	教育部國民及學前教育署
National Academy for Educational Research	nativenameA	國家教育研究院
Ministry of Railways	nativenameA	Türkmenistanyñ demir ýol ulaglary ministrligi
Consumer Council	nativenameA	消費者委員會
Department of Cultural Affairs, Taipei City Government	nativenameA	臺北市政府文化局
Defense Acquisition Program Administration	nativenameA	방위사업청
The Korea Transport Institute	nativenameA	한국 교통 연구원
National Directorate of Intelligence and Prevention Services	nativenameA	DISIP
National Unification Advisory Council	nativenameA	民主平和統一諮問會議
Centers for Disease Control	nativenameA	衛生福利部疾病管制署
Securities and Futures Bureau	nativenameA	金融監督管理委員會證券期貨局
Jajpur Airstrip	nativenameA	ଜାଜପୁର୍ ଉଡାଣ ପଥ
Nuagaon Airport	nativenameA	नूआगाओं हवाई पट्टी
Nawapara Airport	nativenameA	ନୁଆପଡା ବିମାନଘାଟି
Intelligence Agency of Republic of Macedonia	nativenameA	Агенција за разузнавање
Military Service for Security and Intelligence	nativenameA	Сектор - Служба за воена безбедност и разузнавање
Kollam Development Authority	nativenameA	Quilon Development Authority
Eastern Depot	nativenameA	東廠
Fujian Provincial Government	nativenameA	Fújiàn Shěng Zhèngfǔ
Taiwan Provincial Consultative Council	nativenameA	臺灣省諮議會
Iturup Airport	nativenameA	Аэропорт Итуруп
Lands Department	nativenameA	地政總署
National Emergency Management Agency	nativenameA	소방방재청
Ministry of Government Legislation	nativenameA	法制處
Ministry of Agriculture, Food and Rural Affairs	nativenameA	농림축산식품부
Pinjore Airport	nativenameA	Pinjore Flying Club
Bhiwani Airport	nativenameA	Bhiwani Aviation Club
Small and Medium Enterprise Administration	nativenameA	經濟部中小企業處
Bureau of Energy	nativenameA	經濟部能源局
Water Resources Agency	nativenameA	經濟部水利署
Malaysian Meteorological Department	nativenameA	جابتن ميتيورولوڬي مليسيا
Federal Institute for Risk Assessment	nativenameA	Bundesinstitut für Risikobewertung
Oitakenou Airport	nativenameA	大分県央飛行場
State Agency for National Security	nativenameA	Държавна агенция \
Almaza Air Base	nativenameA	مطار ألماظة
Archives of Republika Srpska	nativenameA	Архив Републике Српске
General Inspection of Security Forces	nativenameA	Generální inspekce bezpečnostních sborů
IPSA-3 Airport	nativenameA	مطار الأنبوب العراقي 3
Punjab Governance Reforms Commission	nativenameA	पंजाब प्रशाशन सुधार आयोग
Financial Crimes Investigation Division	nativenameA	நிதி குற்றம் புலனாய்வு பிரிவு
Katpol	nativenameA	Honvédelmi Minisztérium Katonapolitikai Osztály
Thai lottery	nativenameA	samnak ngan salak kin baeng raththaban
Talakan Airport	nativenameA	Аэропорт Талакан
Baikal International Airport	nativenameA	Международный
Baikal International Airport	nativenameA	Аэропорт Байкал
Khurais Airport	nativenameA	مطار خريص
Khurais Airport	nativenameA	مطار خريص القديم
Pump Station 3 Airport	nativenameA	مطار محطة الضخ 3
Institute of Transportation	nativenameA	運輸研究所
Maritime and Port Bureau	nativenameA	航港局
Election Commission of India	nativenameA	भारत निर्वाचन आयोग
Hun Airport	nativenameA	Houn, Hon
Criminal Investigation Bureau	nativenameA	刑事警察局
Army Postal Service	nativenameA	सेना डाक सेवा
Medical Affairs Bureau	nativenameA	軍醫局
Central Geological Survey	nativenameA	中央地質調查所
State-owned Enterprises Commission	nativenameA	經濟部國營事業委員會
Bureau of Mines	nativenameA	經濟部礦務局
Qazvin-Azadi Airport	nativenameA	فرودگاه آزادی
Bar Council of Rajasthan	nativenameA	राजस्थान विधिज्ञ परिषद
Hajj and Pilgrimage Organization	nativenameA	سازمان حج و زیارت
Dalian Jinzhouwan International Airport	nativenameA	大连金州湾国际机场
Radiation Monitoring Center	nativenameA	輻射偵測中心
Institute of Nuclear Energy Research	nativenameA	核能研究所
Taiwan Sugar Research Institute	nativenameA	台糖研究所
Armed Forces Division	nativenameA	বাংলাদেশ সশস্ত্র বাহিনী বিভাগ
Kinmen Fisheries Research Institute	nativenameA	金門縣水產試驗所
Hong Kong Maritime and Port Board	nativenameA	香港海運港口局
Sabetta International Airport	nativenameA	Международный аэропорт Сабетта
Public Security Directorate	nativenameA	مديرية الأمن العام
Cabinet Division	nativenameA	বাংলাদেশ মন্ত্রিপরিষদ বিভাগ
Kastelli Airport	nativenameA	Αεροδρόμιο Καστελλίου
Tanagra Air Base	nativenameA	Αεροπορική Βάση Τανάγρας
New Bellary Airport	nativenameA	ಹೊಸ ಬಳ್ಳಾರಿ ವಿಮಾನ ನಿಲ್ದಾಣ
Al Alamain International Airport	nativenameA	مطار العلمين الدولي
Ministry of Education	nativenameA	وزارة التعليم
New Paros Airport	nativenameA	Κρατικός Αερολιμένας Πάρου
Ukrainian Admission Center	nativenameA	УПЦ
Innovation and Technology Bureau	nativenameA	創新及科技局
Federal Institute for Population Research	nativenameA	Bundesinstitut für Bevölkerungsforschung
