Northamptonshire County Cricket Club	oneday	Northants Steelbacks
Warwickshire County Cricket Club	oneday	Warwickshire Bears
Nottinghamshire County Cricket Club	oneday	Notts Outlaws
Lancashire County Cricket Club	oneday	Lancashire Lightning
Yorkshire County Cricket Club	oneday	Yorkshire Vikings
Worcestershire County Cricket Club	oneday	Worcestershire
Durham County Cricket Club	oneday	Durham
Kent County Cricket Club	oneday	Kent Spitfires
Somerset County Cricket Club	oneday	Somerset
Essex County Cricket Club	oneday	Essex Eagles
Leicestershire County Cricket Club	oneday	Leicestershire Foxes
Glamorgan County Cricket Club	oneday	Glamorgan
Gloucestershire County Cricket Club	oneday	Gloucestershire
Sussex County Cricket Club	oneday	Sussex Sharks
Derbyshire County Cricket Club	oneday	Derbyshire Falcons
Hampshire County Cricket Club	oneday	Hampshire
ACT Comets	oneday	ACT Comets
Auckland cricket team	oneday	Auckland Aces
Wellington cricket team	oneday	Wellington Firebirds
Sinhalese Sports Club	oneday	Sinhalese Sports Club
Colombo Cricket Club	oneday	Colombo Cricket Club
Sialkot cricket team	oneday	Sialkot Stallions
Burgher Recreation Club	oneday	Burgher Recreation Club
Tamil Union Cricket and Athletic Club	oneday	Tamil Union Cricket and Athletic Club
Colts Cricket Club	oneday	Colts Cricket Club
Chilaw Marians Cricket Club	oneday	Chilaw Marians Cricket Club
Panadura Sports Club	oneday	Panadura Sports Club
Ragama Cricket Club	oneday	Ragama Cricket Club
Sebastianites Cricket and Athletic Club	oneday	Sebastianites Cricket and Athletic Club
Faisalabad cricket team	oneday	Faisalabad Wolves
Badureliya Sports Club	oneday	Badureliya Cricket Club
Saracens Sports Club	oneday	Saracens SC
Sri Lanka Army Sports Club	oneday	Sri Lanka Army Sports Club
Ruhuna cricket team	oneday	Ruhuna elevens
Basnahira North cricket team	oneday	Basnahira North elevens
Basnahira South cricket team	oneday	Basnahira South elevens
Seeduwa Raddoluwa Cricket Club	oneday	Seeduwa Raddoluwa Sports Club
Kandy Cricket Club	oneday	Kandy Cricket Club
Frankston Peninsula Cricket Club	oneday	Frankston Peninsula Heat
Unicorns	oneday	Unicorns
Fitzroy Doncaster Cricket Club	oneday	Fitzroy Doncaster Lions
Basnahira cricket team	oneday	Basnahira Elevens
Melbourne Cricket Club	oneday	Kangaroos
Lucas Cricket Club	oneday	Eagles
Boys' Town Cricket Club	oneday	Beavers
Empire Cricket Club	oneday	Blues
Bourne Cricket Club	oneday	Royal Challengers BourneGalore
Greenvale Cricket Club	oneday	Kangaroos
Kala Bagan Krira Chakra	oneday	KKC
Colombo Commandos	oneday	Colombo Commandos
Hambantota Troopers	oneday	Hambantota Troopers
Galle Guardians	oneday	Galle Guardians
Kandy Crusaders	oneday	Kandy Crusaders
Kurunegala Warriors	oneday	Kurunegala Warriors
Port Stephens Pythons	oneday	Port Stephens Pythons
