Auschwitz concentration camp	originalUse	Army barracks
Treblinka extermination camp	originalUse	Extermination camp
Bełżec extermination camp	originalUse	Extermination camp
Bergen-Belsen concentration camp	originalUse	Prisoner of war camp, later civilian internment camp
Sobibór extermination camp	originalUse	Extermination camp
Majdanek concentration camp	originalUse	Unfree labour
Dachau concentration camp	originalUse	Political prison
Tuol Sleng Genocide Museum	originalUse	High school
Ohrdruf concentration camp	originalUse	Prisoner of war camp
Mittelbau-Dora	originalUse	Subterranean fuel depot
Chełmno extermination camp	originalUse	Death
Vilina Vlas	originalUse	Hotel
Fannrem concentration camp	originalUse	Slave labor
Sajmište concentration camp	originalUse	Exhibition centre
Trnopolje camp	originalUse	Primary school
Keraterm camp	originalUse	Ceramic tile factory
Monowitz concentration camp	originalUse	Factories for producing synthetic rubber and chemicals including Zyklon B
Bereza Kartuska prison	originalUse	Political and criminal prison
Kamp Schoorl	originalUse	Army camp
Topovske Šupe concentration camp	originalUse	Royal Yugoslav Army military base
Mechelen transit camp	originalUse	Military barracks
Velepromet camp	originalUse	Storage facility
Janowska concentration camp	originalUse	Civilian internment camp
Trawniki concentration camp	originalUse	POW camp for 1941 Operation Barbarossa
Jastrebarsko concentration camp	originalUse	Castle
Jastrebarsko concentration camp	originalUse	Monastery
Jastrebarsko concentration camp	originalUse	Barracks
Jastrebarsko concentration camp	originalUse	Brickworks
Lapušnik prison camp	originalUse	imprisonment, cruel treatment, inhuman acts, and executions.
Shark Island Concentration Camp	originalUse	Officially a prisoner of war camp, in reality a civilian internment camp, described by some as a death camp or even extermination camp
Kemna concentration camp	originalUse	textile factory
Casoli internment camp	originalUse	Theatre
Mittelsteine	originalUse	Barracks custom-built for the purpose
Grafenort concentration camp	originalUse	*Stately residence \n* Prison barracks
National Internment Camp for Women in Hovedøya	originalUse	Recruit training camp for Hans Majestet Kongens Garde
Szebnie concentration camp	originalUse	Internment
Agfa-Commando	originalUse	manufacturing
