Dartmouth Dam	plantName	Dartmouth Power Station
Nalubaale Hydroelectric Power Station	plantName	Nalubaale Power Station
Somerset Dam	plantName	Somerset Dam
Wivenhoe Dam	plantName	Wivenhoe Power Station
Tinaroo Dam	plantName	Tinaroo Hydro Power Station
Ohakuri Dam	plantName	Ohakuri Power Station
Los Molinos Dam	plantName	Los Molinos I
Kidatu Dam	plantName	Kidatu Power Station
Reece Power Station	plantName	Reece Power Station
William Hovell Dam	plantName	William Hovell
Catagunya Power Station	plantName	Catagunya Power Station
Meadowbank Power Station	plantName	Meadowbank Power Station
Cluny Power Station	plantName	Cluny Power Station
Repulse Power Station	plantName	Repulse Power Station
Poatina Power Station	plantName	Poatina Power Station
Trevallyn Power Station	plantName	Trevallyn Power Station
Gordon Power Station	plantName	Gordon Power Station
Nathpa Jhakri Dam	plantName	Jhakra Power House
Cardinia Reservoir	plantName	Cardinia Dam Power Station
Koombooloomba Dam	plantName	Kareeya Hydro Power Station
Koombooloomba Dam	plantName	Koombooloomba Hydro Power Station
Splityard Creek Dam	plantName	Wivenhoe Power Station
Xiluodu Dam	plantName	Xiluodu Hydropower Station
Gordon Dam	plantName	Gordon Power Station
Kouga Dam	plantName	Kouga Dam Power Station
Almendra Dam	plantName	Villarino Power Station
Kaligandaki A Hydroelectric Power Station	plantName	Kaligandaki A Hydroelectric Power Station
Čapljina Hydroelectric Power Station	plantName	Capljina Hydro Power Plant
Turkwel Hydroelectric Power Station	plantName	Turkwel Hydroelectric Power Station
Kiambere Hydroelectric Power Station	plantName	Kiambere Power Station
Gitaru Hydroelectric Power Station	plantName	Gitaru Hydroelectric Power Station
Kamburu Dam	plantName	Kamburu Power Station
Murum Dam	plantName	Muram Hydroelectric Power Station
Arapuni Power Station	plantName	Arapuni Power Station
Victoria Dam	plantName	Victoria Power Station
Gilgel Gibe I Dam	plantName	Gilgel Gibe I Power Station
Dul Hasti Hydroelectric Plant	plantName	Dul Hasti Hydroelectric Plant
Blue Rock Dam	plantName	Blue Rock Dam Power Station
Narva Hydroelectric Station	plantName	Narva Hydroelectric Station
Feitsui Dam	plantName	Gueishan Power Station
Çınarcık Dam	plantName	Uluabat Hydroelectric Station
Kığı Dam	plantName	Kığı HES
Torul Dam	plantName	Torul Hydroelectric Station
Upper Kotmale Dam	plantName	Upper Kotmale Power Station
Ranganadi Dam	plantName	Dikrong Power House
Três Marias Dam	plantName	Bernard Mascarenhas Power Plant
Loch Sloy Hydro-Electric Scheme	plantName	Sloy Power Station
Nimoo Bazgo Hydroelectric Plant	plantName	Nimoo Bazgo Hydroelectric Plant
Bugoye Hydroelectric Power Station	plantName	Bugoye Power Station
Kotmale Dam	plantName	Kotmale Power Station
La Esmeralda Dam	plantName	Chivor Power Station
Ayago Hydroelectric Power Station	plantName	Ayago Power Station
Zimapán Dam	plantName	Zimapán Power Station
Jinping-II Dam	plantName	Jinping-II Hydropower Station
Maneri Dam	plantName	Tiloth Power Station
Zillergründl Dam	plantName	Häusling Power Plant
Vinje Hydroelectric Power Station	plantName	Vinje Hydroelectric Power Station
Allal al Fassi Dam	plantName	Allal al Fassi Power Plant
Pulangi Dam	plantName	Pulangi IV Hydroelectric Power Plant
Pandoh Dam	plantName	Dehar Power Plant
Neelum–Jhelum Hydropower Plant	plantName	Neelum-Jhelum Hydropower Plant
Kishanganga Hydroelectric Plant	plantName	Kishanganga Hydroelectric Plant
Nyagak III Hydroelectric Power Station	plantName	Nyagak III Hydroelectric Power Station
Cirata Dam	plantName	Cirata Power Station
Roselend Dam	plantName	La Bâthie Power Station
Denis-Perron Dam	plantName	Sainte-Marguerite 3 Generating Station
Winder Dam	plantName	Winder Dam
Bara Dam	plantName	Bara Dam
Misicuni Dam	plantName	Misicuni Hydroelectric Plant
Güllübağ Dam	plantName	Güllübağ Hydroelectric Plant
Sırımtaş Dam	plantName	Sırımtaş HES
Kavşak Bendi Dam	plantName	Kavşak Bendi Hydroelectric Station
Chardara Dam	plantName	Chardara  Hydroelectric Power Station
Toga Dam	plantName	Omaki Power Station
Senzoku Dam	plantName	Togagawa II Power Station
Togagawa Dam	plantName	Togagawa Power Station
Kindaruma Hydroelectric Power Station	plantName	Kindaruma Hydroelectric Power Station0°48'38.0\
Conemaugh Dam	plantName	Conemaugh Hydroelectric Station
Glenmaggie Dam	plantName	Glenmaggie Power Station
Shimokotori Dam	plantName	Shimokotori Power Station
Shweli I Dam	plantName	Shweli I Power Station
Mandraka Dam	plantName	Mandraka Power Station
Andekaleka Dam	plantName	Andekaleka Hydroelectric Power Station
Ratle Hydroelectric Plant	plantName	Ratle Hydroelectric Plant
Duber Khwar Hydroelectric Plant	plantName	Duber Khwar Hydroelectric Plant
Grand Poubara Dam	plantName	Grand Poubara Power Station
Golen Gol Hydropower Project	plantName	Golen Gol Hydroelectric Plant
Renala Khurd Hydropower Plant	plantName	Renala Khurd Hydroelectric Plant
Chichonki Malian Hydropower Plant	plantName	Chichonki Malian Hydroelectric Plant
Nandipur Hydropower Plant	plantName	Nandipur Hydroelectric Plant
Shadiwal Hydropower Plant	plantName	Shadiwal Hydroelectric Plant
Kurram Garhi Hydropower Plant	plantName	Kurram Garhi Hydropower Plant
Afobaka Dam	plantName	Brokopondo Krachtcentrale
Gulpur Hydropower Project	plantName	Gulpur Hydroelectric Plant
Corbara Dam	plantName	Terni Hydroelectric Complex
Gura Apelor Dam	plantName	Râul Mare Hydroelectric Power Station
Tangir Hydropower Project	plantName	Tangir Hydroelectric Plant
Nai Gaj Dam	plantName	Nai Gaj Dam
Yaté Dam	plantName	Yaté Hydroelectric Power Station
Monasavu Dam	plantName	Wailoa Hydro Power Station
Nadarivatu Dam	plantName	Nadarivatu Hydro Power Station
Afulilo Dam	plantName	Ta'lefaga Hydroelectric Plant
Monción Dam	plantName	Monción Hydroelectric Station
Jigüey Dam	plantName	Jigüey Hydroelectric Station
Bao-Tavera Dams	plantName	Tavera Hydroelectric Station
Hatillo Dam	plantName	Hatillo Hydroelectric Station
Mancotal Dam	plantName	Centro América Plant
Virgen Dam	plantName	Carlos Fonesca  Plant
Trängslet Dam	plantName	Dalälven Hydroelectric Power Station
Agua del Toro Dam	plantName	Agua del Toro Hydroelectric Station
Pakal Dul Dam	plantName	Pakal Dul Hydroelectric Power Station
Grančarevo Dam	plantName	Trebinje-1 Hydroelectric Power Station
Chilime Hydropower Plant	plantName	Chilime Hydropower Plant
Lubuge Dam	plantName	Lubuge Hydropower Station
Kajiwa Dam	plantName	Kajiwa Hydropower Plant
Lizhou Dam	plantName	Lizhou Hydropower Plant
Qiaoqi Dam	plantName	Qiaoqi Hydropower Station
Kohala Hydropower Project	plantName	Kohala Hydropower Plant
Maoergai Dam	plantName	Maoergai Hydropower Station
Pankou Dam	plantName	Pankou Hydropower Station
Yingzidu Dam	plantName	Yingzidu Hydropower Station
Sinanjiang Dam	plantName	Sinanjiang Hydropower Plant
Longjiang Dam	plantName	Longjiang Hydropower Plant
Madushan Dam	plantName	Madushan Hydropower Plant
Tianhuaban Dam	plantName	Tianhuaban Hydropower Station
Lianhua Dam	plantName	Lianhua Hydropower Plant
Meander Dam	plantName	Huntsman Lake Power Station
Upper Karnali Hydropower Project	plantName	Upper Karnali Hydropower Station
Mai Hydropower Station	plantName	Mai Hydropower Station
Eklutna Dam	plantName	Eklutna Power Plant
Reventazón Dam	plantName	Reventazón Hydropower Plant
Rama Dam	plantName	Rama Hydro Power Plant
Jablanica Dam	plantName	Jablanica Hydro Power Plant
Entrepeñas Reservoir	plantName	Central Hidroeléctrica de Entrepeñas
Alto Rabagão Dam	plantName	Alto Rabagão Power Plant
El Salto Dam	plantName	El Carpio Power Station
Koma Kulshan Project	plantName	Koma Kulshan powerhouse
Nilambe Dam	plantName	Nilambe Power Station
Mai Cascade Hydropower Plant	plantName	Mai Hydropower Station
Sunkoshi Small Hydropower Plant	plantName	Sunkoshi Small Hydropower Plant
Indravati Dam	plantName	Upper Indravati Power Station
Burç Bendi Dam	plantName	Burç Bendi HES
Waipapa Power Station	plantName	Waipapa Power Station
Tapovan Vishnugad Hydropower Plant	plantName	Tapovan Vishnugad Power Plant
Sondu Miriu Hydroelectric Power Station	plantName	Sondu Miriu Hydroelectric Power Station
Sang'oro Hydroelectric Power Station	plantName	Sang'oro Hydroelectric Power Station
Tana Hydroelectric Power Station	plantName	Tana Hydroelectric Power Station
Wanjii Hydroelectric Power Station	plantName	Wanjii Hydroelectric Power Station
Ndula Hydroelectric Power Station	plantName	Ndula Hydroelectric Power Station
Deralok Dam	plantName	Deralok Hydropower Station
Moore Dam	plantName	Moore Station
Manso Dam	plantName	Usina Hidrelétrica de Manso
