Pamela Anderson	preceded	Peggy McIntaggart
Nicole, Erica and Jaclyn Dahm	preceded	Tiffany Taylor
Jayne Mansfield	preceded	Bettie Page
Kelly Monaco	preceded	Jennifer Miriam
Stella Stevens	preceded	Ellen Stratton
Melissa Holliday	preceded	Elisa Bridges
Lisa Marie Scott	preceded	Melissa Holliday
Lena Söderberg	preceded	Sharon Johansen
Nicole Marie Lenz	preceded	Suzanne Stokes
Karen McDougal	preceded	Inga Drozdova
Nikki Ziering	preceded	Kalin Olson
Teri Weigel	preceded	Kim Morris
Renee Tenison	preceded	Karen Foster
Alicia Rickter	preceded	Donna D'Errico
Rebecca Ferratti	preceded	Christine Richters
Lindsey Vuolo	preceded	Stephanie Heinrich
Victoria Zdrok	preceded	Kelly Wearstler
Shanna Moakler	preceded	Lindsey Vuolo
Angel Boris	preceded	Karin Taylor
Daphnée Duplaix	preceded	Carrie Stevens
Lillian Müller	preceded	Lynn Schiller
Elisa Bridges	preceded	Donna Perry
Heather Kozar	preceded	Karen McDougal
Colleen Shannon	preceded	Deisy and Sarah Teles
Lisa Dergan Podsednik	preceded	Maria Luisa Gil
Shae Marks	preceded	List of Playboy Playmates of 1994
Liv Lindeland	preceded	Carol Imhof
Linn Thomas	preceded	Kelly Monaco
Lauren Anderson	preceded	Michele Rogers
Stacy Arthur	preceded	Morgan Fox
Lynne Austin	preceded	Rebecca Ferratti
Tina Bockrath	preceded	Lisa Matthews
Brandi Brandt	preceded	Gwen Hajek
Fawna MacLaren	preceded	Kata Kärkkäinen
Jodi Ann Paterson	preceded	Kristi Cline
Kari Kennell	preceded	Kimberley Conrad
Christa Speck	preceded	Karen Thompson
Stacy Sanches	preceded	Lisa Marie Scott
Victoria Vetri	preceded	DeDe Lind
Janet Pilgrim	preceded	Eve Meyer
Janet Pilgrim	preceded	List of Playboy Playmates of 1955
Janet Pilgrim	preceded	Elsa Sørensen
Jennifer LeRoy	preceded	Echo Johnson
Marina Baker	preceded	Julie Peterson
Susie Owens	preceded	Kari Kennell
Corinna Harney	preceded	Wendy Kaye
Tiffany Fallon	preceded	Cara Zavaleta
Jennifer Lyn Jackson	preceded	Laurie Wood
Diana Lee	preceded	Eloise Broady
Monique Noel	preceded	Jennifer Lyn Jackson
Jennifer Walcott	preceded	Kimberley Stanfield
Cynthia Wood	preceded	Miki Garcia
Martha Smith	preceded	Ruthy Ross
Denise Michele	preceded	Ann Pennington
Pilar Lastra	preceded	Stephanie Glasson
Victoria Fuller	preceded	Samantha Torres
Deanna Brooks	preceded	Holly Joan Hart
Teri Harrison	preceded	Shallan Meiers
Helle Michaelsen	preceded	Terri Lynn Doss
Sharry Konopski	preceded	Carmen Berg
Jennifer Lavoie	preceded	Leisa Sheridan
Yvette Vickers	preceded	Marilyn Hanold
Pia Reyes	preceded	Shannon Long
Angela Little	preceded	Lisa Dergan
Katariina Souri	preceded	Pia Reyes
Alexandria Karlsen	preceded	Stacy Marie Fuson
Jennifer Rovero	preceded	Kimberly Spicer
Kerissa Fare	preceded	Summer Altice
Irina Voronina	preceded	Cara Michelle
Nicole Narain	preceded	Shanna Moakler
Stephanie Heinrich	preceded	Dalene Kurtis
Janice Pennington	preceded	Chris Cranston
Kristine Hanson	preceded	Jean Manson
Serria Tawan	preceded	Teri Harrison
Mary Collinson	preceded	Debbie Ellison
Madeleine Collinson	preceded	Debbie Ellison
Shallan Meiers	preceded	Christina Santiago
Debra Jo Fondren	preceded	Julia Lyndon
Marianne Gravatte	preceded	Connie Brighton
Hiromi Oshima	preceded	Nicole Whitehead
Tamara Witmer	preceded	Qiana Chase
Cynthia Brimhall	preceded	Venice Kong
China Lee	preceded	Melba Ogle
Claudia Jennings	preceded	Jean Bell
Lee Ann Michelle	preceded	Candy Loving
Devin DeVasquez	preceded	Kathy Shower
Ava Fabian	preceded	Lynne Austin
Jennifer Jackson	preceded	Jessica St. George
Heidi Mark	preceded	Rhonda Adams
Susan Kiger	preceded	Karen Hafter
Candy Loving	preceded	Janet Quist
Kara Monaco	preceded	Jamie Westenhiser
Allison Parks	preceded	Patti Reynolds
Dianne Chandler	preceded	Susan Denberg
Kathy Shower	preceded	Cindy Brooks
Vicki Iovine	preceded	Dorothy Stratten
Penny Baker	preceded	Terry Nihen
Colleen Farrington	preceded	Jacquelyn Prescott
Cynthia Myers	preceded	Paige Young
Karin Taylor	preceded	Shauna Sand
Karen Price	preceded	Terri Welles
Jo Collins	preceded	Kai Brendlinger
Joanne Arnold	preceded	Marilyn Waltz
Katie Lohmann	preceded	Miriam Gonzalez
Tina Marie Jordan	preceded	Anka Romensky
Eve Meyer	preceded	Marguerite Empey
Mara Corday	preceded	Teri Hope
Connie Kreski	preceded	Lynn Winchell
Shay Knuth	preceded	Debbie Hooper
Sue Hamilton	preceded	Jennifer Jackson
Gloria Root	preceded	Claudia Jennings
Jessica St. George	preceded	Sally Duberson
Jean Bell	preceded	Shay Knuth
Reagan Wilson	preceded	Victoria Vetri
Joey Gibson	preceded	Anne Randall
Anne Randall	preceded	Gwen Wong
Lisa Baker	preceded	Linda Moon
Susan Denberg	preceded	Tish Howard
Kelly Burke	preceded	Dolly Read
Karla Conway	preceded	Priscilla Wright
Melinda Windsor	preceded	Judy Tyler
Willy Rey	preceded	Liv Lindeland
Maria McBane	preceded	Sue Hamilton
Patti Reynolds	preceded	Lannie Balcom
Hedy Scott	preceded	Maria McBane
Ashlyn Martin	preceded	Nancy Scott
Donna Michelle	preceded	Terre Tucker
Christine Williams	preceded	Victoria Valentino
Connie Mason	preceded	Sharon Cintron
Sharon Cintron	preceded	Sandra Settani
Dolly Martin	preceded	Karla Conway
Pat Sheehan	preceded	Teri Hope
Marilyn Cole	preceded	Karen Christy
June Cochran	preceded	Avis Kimble
Delores Wells	preceded	Ginger Young
Avis Kimble	preceded	Laura Young
Merle Pertile	preceded	Lynn Karrol
Marya Carter	preceded	Roberta Lane
Azizi Johari	preceded	Bridgett Rollins
Linné Ahlstrand	preceded	List of Playboy Playmates of 1958
Joyce Nizzari	preceded	Joan Staley
Marianne Gaba	preceded	List of Playboy Playmates of 1959
Ingeborg Sørensen	preceded	Laura Misch
Neva Gilbert	preceded	Margie Harrison
Carol Eden	preceded	Joni Mattis
Ursula Buchfellner	preceded	Vicki Iovine
Vicki Peters	preceded	Ellen Michaels
June Blair	preceded	Lisa Winters
Joan Staley	preceded	Mara Corday
Joan Staley	preceded	Pat Sheehan
Sharon Clark	preceded	Carol Willis
Marilyn Hanold	preceded	List of Playboy Playmates of 1959
Sharon Johansen	preceded	Susan Miller
Chris Cranston	preceded	Cynthia Hall
Sara Jean Underwood	preceded	Stephanie Larimore
Arline Hunter	preceded	Neva Gilbert
Jean Moorhead	preceded	Anne Fleming
Marian Stafford	preceded	Marguerite Empey
Betty Blue	preceded	Janet Pilgrim
Sally Todd	preceded	June Blair
Saundra Edwards	preceded	Sally Todd
Elizabeth Ann Roberts	preceded	Linda Vargas
Anulka Dziubinska	preceded	Julie Woodson
Felicia Atkins	preceded	Zahra Norbo
Corinne Cole	preceded	Felicia Atkins
Teri Hope	preceded	Myrna Weber
Virginia Gordon	preceded	Joyce Nizzari
Ellen Michaels	preceded	P. J. Lansing
Monica Tidwell	preceded	Valerie Lane
Julie McCullough	preceded	Sherry Arnett
Sandy Johnson	preceded	Marilyn Lange
Jeane Manson	preceded	Carol Vitale
Daina House	preceded	Nancie Li Brandi
Laura Lyons	preceded	Daina House
Patricia McClain	preceded	Denise Michele
Star Stowe	preceded	Susan Kiger
Ashley Cox	preceded	Rita Lee
Debra Jensen	preceded	Ashley Cox
Pamela Bryant	preceded	Christina Smith
Rosanne Katon	preceded	Vicki Witt
Teri Peterson	preceded	Ola Ray
Karen Witter	preceded	Anne-Marie Fox
Lynda Wiesmeier	preceded	Lourdes Estores
Priscilla Taylor	preceded	Kona Carmack
Eugena Washington	preceded	List of Playboy Playmates of 2015
Jayde Nicole	preceded	Kia Drayton
Heather Rene Smith	preceded	Jayde Nicole
Ann Pennington	preceded	Laura Lyons
Tamara Sky	preceded	Tiffany Selby
Jenny McCarthy	preceded	Carrie Westcott
Laura Croft	preceded	Juliette Fretté
Ida Ljungqvist	preceded	Michelle McLaughlin
Juliette Fretté	preceded	AJ Alexander
Janine Habeck	preceded	Nicole Voss
Kristina and Karissa Shannon	preceded	Candice Cassidy
Dasha Astafieva	preceded	Jennifer and Natalie Jo Campbell
Hope Dworaczyk	preceded	Jennifer Pershing
Crystal Hefner	preceded	Kelley Thompson
Diane Webber	preceded	Marilyn Waltz
Diane Webber	preceded	Lynn Turner
Krista Kelly	preceded	Sandra Hubby
List of Playboy Playmates of 1955	preceded	Marguerite Empey
List of Playboy Playmates of 1957	preceded	Sandra Edwards
List of Playboy Playmates of 1963	preceded	Terre Tucker
List of Playboy Playmates of 1965	preceded	Patti Reynolds
List of Playboy Playmates of 1989	preceded	Kimberley Conrad
Stephanie Adams	preceded	Tiffany Sloan
Anna Sophia Berglund	preceded	Ashley Hobbs
Pamela Anne Gordon	preceded	Kari Knudsen
