Hoover Dam	resName	Lake Mead
Kariba Dam	resName	Lake Kariba
Dartmouth Dam	resName	Dartmouth Reservoir
Three Gorges Dam	resName	Three Gorges Reservoir Region
Itaipu Dam	resName	Itaipu Reservoir
Aswan Dam	resName	Lake Nasser
Benmore Dam	resName	Lake Benmore
Detroit Dam	resName	Detroit Lake
Mansfield Dam	resName	Lake Travis
Cardiff Bay Barrage	resName	Cardiff Bay
W. A. C. Bennett Dam	resName	Williston Lake
Longhorn Dam	resName	Lady Bird Lake
Max Starcke Dam	resName	Lake Marble Falls
Tom Miller Dam	resName	Lake Austin
Wirtz Dam	resName	Lake LBJ
Inks Dam	resName	Inks Lake
Buchanan Dam	resName	Lake Buchanan
Glen Canyon Dam	resName	Lake Powell
Rocky Reach Dam	resName	Lake Entiat
Wells Dam	resName	Lake Pateros
Rock Island Dam	resName	Rock Island Pool
Wanapum Dam	resName	Lake Wanapum
Priest Rapids Dam	resName	Priest Rapids Lake
Hume Dam	resName	Lake Hume
Bonneville Dam	resName	Lake Bonneville
Teton Dam	resName	Teton Reservoir
Clyde Dam	resName	Lake Dunstan
Akosombo Dam	resName	Lake Volta
La Grande-3 generating station	resName	La Grande-3 Reservoir
Pak Mun Dam	resName	Pak Mun Reservoir
Manapouri Power Station	resName	Lake Manapouri
Warragamba Dam	resName	Lake Burragorang
Edersee Dam	resName	Edersee
Glenbawn Dam	resName	Lake Glenbawn
Eildon Dam	resName	Lake Eildon
Vajont Dam	resName	Lago del Vajont
Gardiner Dam	resName	Lake Diefenbaker
Qu'Appelle River Dam	resName	Lake Diefenbaker
Seven Oaks Dam	resName	Seven Oaks Reservoir
Keepit Dam	resName	Lake Keepit
Revelstoke Dam	resName	Lake Revelstoke
Chief Joseph Dam	resName	Rufus Woods Lake
McNary Dam	resName	Lake Wallula
The Dalles Dam	resName	Lake Celilo
John Day Dam	resName	Lake Umatilla
Mica Dam	resName	Kinbasket Lake
Keenleyside Dam	resName	Arrow Lakes
Shasta Dam	resName	Shasta Lake
Kelly Barnes Dam	resName	Barnes Lake
Hoover Dam	resName	Hoover Reservoir
Vaal Dam	resName	Vaal Dam
Kárahnjúkar Hydropower Plant	resName	Hálslón Reservoir
Imperial Dam	resName	Imperial Reservoir
Pyramid Dam	resName	Pyramid Lake
Koyna Dam	resName	Shivajisagar Lake
Kurobe Dam	resName	Kurobe Lake
Grande Dixence Dam	resName	Lac des Dix
Krishna Raja Sagara	resName	Krishna Raja Sagara/ಕೃಷ್ಣರಾಜ ಸಾಗರ ಜಲಾಶಯ
Norris Dam	resName	Norris Lake
Roxburgh Dam	resName	Lake Roxburgh
Bakun Dam	resName	Bakun Reservoir
Waranga Dam	resName	Waranga Basin
Vidraru Dam	resName	Lake Vidraru
Guri Dam	resName	Guri Reservoir
Davis Dam	resName	Lake Mohave
Eufaula Lake	resName	Eufaula Lake
Khadakwasla Dam	resName	Khadakwasla Lake
Oroville Dam	resName	Lake Oroville
Mangla Dam	resName	Mangla Lake
Prado Dam	resName	Prado Flood Control Basin
Fort Peck Dam	resName	Fort Peck Lake
Oahe Dam	resName	Lake Oahe
Bagnell Dam	resName	Lake of the Ozarks
Columbia River Treaty	resName	Duncan Lake
Columbia River Treaty	resName	Arrow Lakes
Columbia River Treaty	resName	Kinbasket Lake
Columbia River Treaty	resName	Lake Koocanusa
Wyangala Dam	resName	Lake Wyangala
Painted Rock Dam	resName	Painted Rock Reservoir
Mactaquac Dam	resName	Mactaquac Headpond
Parker Dam	resName	Lake Havasu
Pacoima Dam	resName	Pacoima Reservoir
Sélingué Dam	resName	Lake Sélingué
Lake Parramatta	resName	Lake Parramatta
Manantali Dam	resName	Lake Manantali
Lake Margaret Power Station	resName	Lake Margaret
Watts Bar Dam	resName	Watts Bar Lake
Fort Loudoun Dam	resName	Fort Loudoun Lake
Melton Hill Dam	resName	Melton Hill Lake
Bay d'Espoir Hydroelectric Power Station	resName	Meelpaeg Lake
Austin Dam	resName	Austin Dam Pool
New Melones Dam	resName	New Melones Lake
New Bullards Bar Dam	resName	New Bullards Bar Reservoir
Sartell Dam	resName	Little Rock Lake
Burrendong Dam	resName	Lake Burrendong
Elephant Butte Dam	resName	Elephant Butte Lake
Atatürk Dam	resName	Lake Atatürk
Mulshi Dam	resName	Mulshi
Bhakra Dam	resName	Gobindsagar Reservoir
Don Pedro Dam	resName	Don Pedro Reservoir
Friant Dam	resName	Millerton Lake
Merowe Dam	resName	Merowe Reservoir
Castaic Dam	resName	Castaic Lake
Wolf Creek Dam	resName	Lake Cumberland
Lake Eppalock	resName	Lake Eppalock
Old Hickory Lock and Dam	resName	Old Hickory Lake
Fontana Dam	resName	Fontana Lake
New Croton Dam	resName	New Croton Reservoir
Pine Flat Dam	resName	Pine Flat Lake
Mettur Dam	resName	Stanley Reservoir
Marina Barrage	resName	Marina Reservoir
Nurek Dam	resName	Nurek reservoir
Tarbela Dam	resName	Tarbela reservoir
Stephens Creek Dam	resName	Stephens Creek Reservoir
Little Goose Dam	resName	Lake Bryan
Lower Granite Dam	resName	Lower Granite Lake
Lower Monumental Dam	resName	Lake Herbert G. West
Ice Harbor Dam	resName	Lake Sacajawea
Dworshak Dam	resName	Dworshak Reservoir
Hebgen Dam	resName	Hebgen Lake
Tabqa Dam	resName	Lake Assad
Wachusett Dam	resName	Wachusett Reservoir
Casitas Dam	resName	Lake Casitas
Trinity Dam	resName	Trinity Lake
Libby Dam	resName	Lake Koocanusa
Usoi Dam	resName	Sarez Lake
Balimela Reservoir	resName	Balimela Reservoir
Jalaput Dam	resName	Jalaput Reservoir
Batman Dam	resName	Batman Reservoir
Birecik Dam	resName	Reservoir
Devegeçidi Dam	resName	Devegeçidi Reservoir
Dicle Dam	resName	Dicle Reservoir
Keban Dam	resName	Keban Reservoir
Karkamış Dam	resName	Karkamış Reservoir
Kralkızı Dam	resName	Kralkızı Reservoir
Ilısu Dam	resName	Ilısu Reservoir
Guntersville Dam	resName	Guntersville Lake
Wheeler Dam	resName	Wheeler Lake
Nam Ngum Dam	resName	Ang Nam Ngum
Midmar Dam	resName	Midmar Dam Reservoir
Link River Dam	resName	Klamath Lake
Crotty Dam	resName	Lake Burbury
Somerset Dam	resName	Lake Somerset
Hartbeespoort Dam	resName	Hartbeespoort Dam Reservoir
Bull Run Hydroelectric Project	resName	Roslyn Lake
Minidoka Dam	resName	Lake Walcott
Plastiras Dam	resName	Lake Plastiras
Pathfinder Dam	resName	Pathfinder Reservoir
Lake Chelan Dam	resName	Raised Lake Chelan
Saluda Dam	resName	Lake Murray
American Falls Dam	resName	American Falls Reservoir
Palisades Dam	resName	Palisades Reservoir
Gandhi Sagar Dam	resName	Multipurpose
Gariep Dam	resName	Gariep Dam Reservoir
Kainji Dam	resName	Kainji Lake
Glennies Creek Dam	resName	Lake Saint Clair
Copeton Dam	resName	Lake Copeton
Lostock Dam	resName	Lostock Dam
Windamere Dam	resName	Lake Windamere
Burrinjuck Dam	resName	Lake Burrinjuck
Ajwa	resName	Ajwa
Liujiaxia Dam	resName	Liujiaxia Reservoir
Blowering Dam	resName	Blowering Reservoir
Conowingo Dam	resName	Conowingo Reservoir
Hinze Dam	resName	Advancetown Lake
Wivenhoe Dam	resName	Wivenhoe Reservoir
Moogerah Dam	resName	Lake Moogerah
Googong Dam	resName	Googong Reservoir
Furnas Dam	resName	Furnas Reservoir
Bansagar Dam	resName	Bansagar Reservoir
Pineview Dam	resName	Pineview Reservoir
Gavins Point Dam	resName	Lewis and Clark Lake
Tallowa Dam	resName	Lake Yarrunga
Woronora Dam	resName	Woronora Dam
Longtan Dam	resName	Longtan Reservoir
Salto Grande Dam	resName	Salto Grande Reservoir
Flaming Gorge Dam	resName	Flaming Gorge Reservoir
Tinaroo Dam	resName	Lake Tinaroo
Indirasagar Dam	resName	Indira Sagar Reservoir
Rajghat Dam	resName	Rajghat Reservoir
Bargi Dam	resName	Bargi Reservoir
Jindabyne Dam	resName	Lake Jindabyne
Pickwick Landing Dam	resName	Pickwick Lake
Silvan Reservoir	resName	Silvan Reservoir
Bhandardara	resName	Arthur Lake
Contra Dam	resName	Lago di Vogorno
Lock and Dam No. 2	resName	Pool 2
New Waddell Dam	resName	Lake Pleasant Regional Park
Shadow Mountain Dam	resName	Shadow Mountain Lake
Granby Dam	resName	Lake Granby
Ohakuri Dam	resName	Lake Ohakuri
Mirani Dam	resName	Mirani Reservoir
Kardzhali Reservoir	resName	Kardzhali Reservoir
Leslie Harrison Dam	resName	Tingalpa Reservoir
King Talal Dam	resName	King Talal Reservoir
Kinzua Dam	resName	Allegheny Reservoir
Brisay generating station	resName	Caniapiscau Reservoir
Laforge-1 generating station	resName	Laforge-1 Reservoir
La Grande-4 generating station	resName	LG-4 Reservoir
Robert-Bourassa generating station	resName	Robert-Bourassa Reservoir
La Grande-2-A generating station	resName	Robert-Bourassa Reservoir
Laforge-2 generating station	resName	Laforge-2 Reservoir
Lock and Dam No. 1	resName	Pool 1
Krasnoyarsk Dam	resName	Krasnoyarsk Reservoir
Satpara Dam	resName	Satpara Lake
Wilson Dam	resName	Wilson Lake
Nickajack Dam	resName	Nickajack Lake
Chickamauga Dam	resName	Chickamauga Lake
Kentucky Dam	resName	Kentucky Lake
Falcon Dam	resName	Falcon International Reservoir
Greers Ferry Dam	resName	Greers Ferry Lake
Serpentine Dam	resName	Reservoir
Tumut Hydroelectric Power Station	resName	Tumut Pond Reservoir
Cochrane Dam	resName	Cochrane Lake
Isabella Dam	resName	Lake Isabella
North Pine Dam	resName	Lake Samsonvale
Robert Moses Niagara Power Plant	resName	Moses Niagara Power Plant forebay
Robert Moses Niagara Power Plant	resName	Lewiston Reservoir
Tooma Dam	resName	Tooma Reservoir
Summersville Lake	resName	Summersville Lake
Haditha Dam	resName	Lake Qadisiyah
Blue Mesa Dam	resName	Blue Mesa Reservoir
Morrow Point Dam	resName	Morrow Point Reservoir
Crystal Dam	resName	Crystal Reservoir
Eildon Hydroelectric Power Station	resName	Lake Eildon
Crystal Springs Dam	resName	Crystal Springs Reservoir
Melvin Price Locks and Dam	resName	Pool 26
Clark Canyon Dam	resName	Clark Canyon Reservoir
Holtwood Dam	resName	Lake Aldred
Bastyan Power Station	resName	Lake Rosebery
Mackintosh Power Station	resName	Lake Mackintosh
Reece Power Station	resName	Lake Pieman
Tribute Power Station	resName	Lake Plimsoll
Safe Harbor Dam	resName	Lake Clarke
Monticello Dam	resName	Lake Berryessa
Mratinje Dam	resName	Piva Lake
El Chocón Dam	resName	El Chocón Reservoir
Darwin Dam	resName	Lake Burbury
Burdekin Dam	resName	Lake Dalrymple
Albeni Falls Dam	resName	Raises Lake Pend Oreille
Winsor Dam	resName	Quabbin Reservoir
York Haven Dam	resName	Frederic Lake
Prospect Reservoir	resName	Prospect Reservoir
Rheidol Power Station	resName	Nant-y-Moch, Dinas, Cwm Rheidol
Coolidge Dam	resName	San Carlos Reservoir
Tawa Reservoir	resName	Tawa Reservoir
Foster Dam	resName	Foster Lake
Elwha Dam	resName	Lake Aldwell
Little Nerang Dam	resName	Lake Macdonald
Sultan Mahmud Power Station	resName	Kenyir Lake
Srisailam Dam	resName	Srisailam Reservoir
Peechi Dam	resName	Manali River
Cwm Dyli	resName	Llyn Llydaw
Bhavanisagar dam	resName	Bhavanisagar Reservoir
Malampuzha Dam	resName	Malampuzha Reservoir
William Hovell Dam	resName	Lake William Hovell
Wayatinah Power Station	resName	Wayatinah Lagoon
Liapootah Power Station	resName	Lake Liapootah
Catagunya Power Station	resName	Lake Catagunya
Meadowbank Power Station	resName	Meadowbank Lake
Cluny Power Station	resName	Cluny Lagoon
Butlers Gorge Power Station	resName	Lake King William
Repulse Power Station	resName	Lake Repulse
Tungatinah Power Station	resName	Tungatinah Lagoon
Lake Echo Power Station	resName	Lake Echo
Poatina Power Station	resName	Great Lake
Bratsk Hydroelectric Power Station	resName	Bratsk Reservoir
Cethana Power Station	resName	Sheffield, Tasmania
Rowallan Power Station	resName	Rowallan Lake
Devils Gate Power Station	resName	Lake Barrington
Lemonthyme Power Station	resName	Lake Parangana
Paloona Power Station	resName	Lake Paloona
Trevallyn Power Station	resName	Lake Trevallyn
Gordon Power Station	resName	Lake Gordon
Wilmot Power Station	resName	Lake Gairdner
Fisher Power Station	resName	Lake Mackenzie
Lock and Dam No. 3	resName	Pool 3
Lock and Dam No. 4	resName	Pool 4
Lock and Dam No. 5A	resName	Pool 5A
Lock and Dam No. 5	resName	Pool 5
Lock and Dam No. 6	resName	Pool 6
Lock and Dam No. 9	resName	Pool 9
Lock and Dam No. 8	resName	Pool 8
Lock and Dam No. 10	resName	Pool 10
Lock and Dam No. 7	resName	Pool 7
Lock and Dam No. 11	resName	Pool 11
Lock and Dam No. 12	resName	Pool 12
Lock and Dam No. 13	resName	Pool 13
Lock and Dam No. 16	resName	Pool 16
Lock and Dam No. 14	resName	Pool 14
Lock and Dam No. 15	resName	Pool 15
Lock and Dam No. 18	resName	Pool 18
Lock and Dam No. 19	resName	Pool 19 / Lake Cooper
Lock and Dam No. 17	resName	Pool 17
Lock and Dam No. 20	resName	Pool 20
Lock and Dam No. 22	resName	Pool 22
Lock and Dam No. 21	resName	Pool 21
Lock and Dam No. 24	resName	Pool 24
Lock and Dam No. 25	resName	Pool 25
Goodnough Dike	resName	Quabbin Reservoir
Linganamakki Dam	resName	Sharavati River
Scrivener Dam	resName	Lake Burley Griffin
Chicopee Falls Dam	resName	Chicopee Reservoir
Hàm Thuận – Đa Mi hydroelectric power stations	resName	Hàm Thuận Reservoir
Hàm Thuận – Đa Mi hydroelectric power stations	resName	Đa Mi Reservoir
Barre Falls Dam	resName	Barre Falls temporary impoundment area
Lake Davis	resName	Lake Davis
Ross Dam	resName	Ross Lake
Hasan Uğurlu Dam	resName	Lake Hasan Uğurlu Dam
Sarıyar Dam	resName	Sarıyar reservoir
Altınkaya Dam	resName	Lake Altınkaya Dam
Almus Dam	resName	Almus Reservoir
Douglas Dam	resName	Douglas Lake
Nimbus Dam	resName	Lake Natoma
Thomson Dam	resName	Thomson Reservoir ; called Lake Thomson
Stratos Dam	resName	Stratos
Batang Ai Dam	resName	Batang Ai Reservoir
Hungry Horse Dam	resName	Hungry Horse Reservoir
Suat Uğurlu Dam	resName	Lake Suat Uğurlu Dam
El Atazar Dam	resName	El Atazar Reservoir
Silvan Dam	resName	Silvan Reservoir
Yonki Dam	resName	Yonki Reservoir
Rana Pratap Sagar Dam	resName	Multipurpose
Kaptai Dam	resName	Kaptai Lake
Navajo Dam	resName	Navajo Lake
Serpentine Pipehead Dam	resName	Reservoir
Morbe Dam	resName	morbe
Nillahcootie Dam	resName	Lake Nillahcootie
Rocky Creek Dam	resName	Rocky Lake
Lake Narracan	resName	Lake Narracan
Coquitlam Dam	resName	Coquitlam Lake
Mulholland Dam	resName	Hollywood Reservoir
Englebright Dam	resName	Englebright Lake
Volga Hydroelectric Station	resName	Volgograd Reservoir
Saratov Hydroelectric Station	resName	Saratov Reservoir
Chats Falls	resName	Chats Lake
Cochiti Dam	resName	Cochiti Lake
Mattupetty Dam	resName	Mattupetty
Folsom Dam	resName	Folsom Lake
Solina Dam	resName	Lake Solina
Toktogul Dam	resName	Toktogul Reservoir
The Barrier	resName	Garibaldi Lake
Hells Canyon Dam	resName	Hells Canyon Reservoir
Oxbow Dam	resName	Oxbow Reservoir
Brownlee Dam	resName	Brownlee Reservoir
Jackson Lake Dam	resName	Jackson Lake
Gosling Creek Dam	resName	Gosling Creek Reservoir
Suma Park Dam	resName	Suma Park Reservoir
Spring Creek Dam	resName	Spring Creek Reservoir
Red Rock Dam	resName	Lake Red Rock
Bendora Dam	resName	Bendora Reservoir
Yellowtail Dam	resName	Bighorn Lake
Vanderkloof Dam	resName	Vanderkloof Dam Reservoir
Milner Dam	resName	Milner Lake
Cabinet Gorge Dam	resName	Cabinet Gorge Reservoir
Box Canyon Dam	resName	Box Canyon Reservoir
Noxon Rapids Dam	resName	Noxon Reservoir
C. J. Strike Dam	resName	C. J. Strike Reservoir
Mansfield Hollow Lake	resName	Lake Naubesatuck
Terminus Dam	resName	Lake Kaweah
Tantangara Dam	resName	Tantangara Reservoir
Fanshawe Dam	resName	Fanshawe Lake
Péligre Dam	resName	Lake Péligre
Auburn Dam	resName	Auburn Reservoir
Denison Dam	resName	Lake Texoma
Lake Cascade	resName	Lake Cascade
Cardinia Reservoir	resName	Cardinia Reservoir
Maithon Dam	resName	Maithon Lake
Panchet Dam	resName	Panchet reservoir
Balbina Dam	resName	Balbina Reservoir
Tokuyama Dam	resName	Tokuyama Reservoir
Kenney Dam	resName	Nechako Reservoir
Croton Dam	resName	Croton Reservoir
X. Henry Goodnough	resName	Quabbin Reservoir
Split Rock Dam	resName	Split Rock Reservoir
Pindari Dam	resName	Lake Pindari
Talbingo Dam	resName	Talbingo Reservoir
Chichester Dam	resName	Lake Chichester
Conant Brook Dam	resName	Conant Brook flood control reservoir
East Brimfield Dam	resName	East Brimfield Reservoir
Westville Dam	resName	Westville Lake
Sameura Dam	resName	Lake Sameura
Nandoni Dam	resName	Nandoni Dam Reservoir
Ambuklao Dam	resName	Ambuklao reservoir
Apalachia Dam	resName	Apalachia Reservoir
Horse Mesa Dam	resName	Apache Lake
Bartlett Dam	resName	Bartlett Lake
Aviemore Dam	resName	Lake Aviemore
Mosul Dam	resName	Lake Dahuk
Frank D. Comerford Dam	resName	Comerford Reservoir
Sayano–Shushenskaya Dam	resName	Sayano–Shushenskoe reservoir
Tumut Pond Dam	resName	Tumut Pond Reservoir
Caruachi Dam	resName	Caruachi Reservoir
Cheboksary Dam	resName	Cheboksary Reservoir
Zhiguli Hydroelectric Station	resName	Kuybyshev Reservoir
Sideling Creek Dam	resName	Lake Kurwongbah
Atkinson Dam	resName	Lake Atkinson
Cooby Dam	resName	Cooby Creek Reservoir
Fairbairn Dam	resName	Lake Maraboon
Borumba Dam	resName	Lake Borumba
Enoggera Dam	resName	Enoggera Reservoir
Gold Creek Dam	resName	Gold Creek Reservoir
E.J. Beardmore Dam	resName	Lake Kajarabie
Bill Gunn Dam	resName	Lake Dyer
Lake Clarendon Dam	resName	Lake Clarendon
Baroon Pocket Dam	resName	Lake Baroon
Koombooloomba Dam	resName	Lake Koombooloomba
Bromelton Dam	resName	Bromelton Offstream Storage
Xiluodu Dam	resName	Xiluodu Reservoir
Waterbury Dam	resName	Waterbury Reservoir
Paradise Dam	resName	Paradise Dam
Coolmunda Dam	resName	Lake Coolmunda
Lake Manchester Dam	resName	Lake Manchester
Six Mile Creek Dam	resName	Lake Macdonald
Yusufeli Dam	resName	Yusufeli Reservoir
Box Canyon Dam	resName	Lake Siskiyou
Squannacook River Dam	resName	Squannacook River Reservoir
Tucuruí Dam	resName	Lago Tucuruí
Southedge Dam	resName	Lake Mitchell
Lewiston Dam	resName	Lewiston Lake
Iron Gate II Hydroelectric Power Station	resName	Iron Gates II Reservoir
Iron Gate I Hydroelectric Power Station	resName	Iron Gate I Reservoir
Conklingville Dam	resName	Great Sacandaga Lake
Buffalo Bill Dam	resName	Buffalo Bill Reservoir
Owyhee Dam	resName	Owyhee Reservoir
Laxiwa Dam	resName	Laxiwa Reservoir
Nuozhadu Dam	resName	Nuozhadu Reservoir
Pubugou Dam	resName	Pubugou Reservoir
Goupitan Dam	resName	Goupitan Reservoir
Guandi Dam	resName	Guandi Reservoir
Ertan Dam	resName	Ertan Reservoir
Holt Lock and Dam	resName	Holt Lake
James J. Lenihan Dam	resName	Lexington Reservoir
El Cajón Dam	resName	El Cajón Reservoir
Glines Canyon Dam	resName	Lake Mills
Victoria Dam	resName	Victoria Reservoir
Jayakwadi Dam	resName	Nath Sagar Jalashay
Gordon Dam	resName	Lake Gordon
Bakhtiari Dam	resName	Bakhtiari Reservoir
Perunchani Dam	resName	Perunchani Reservoir
Kouga Dam	resName	Kouga Dam Reservoir
Scotts Peak Dam	resName	Lake Pedder
Serpentine Dam	resName	Lake Pedder
Edgar Dam	resName	Lake Pedder
Gillespie Dam	resName	Gillespie Dam Reservoir
Solaiyar Dam	resName	Chalakkudi River
Karun-4 Dam	resName	Reservoir
Bicaz-Stejaru Hydroelectric Power Station	resName	Lake Izvorul Muntelui
Dubăsari Dam	resName	Dubăsari Reservoir
Dniester Hydroelectric Station	resName	Dniester reservoir
Steenbras Dam	resName	Steenbras Dam
Boa Esperança Hydroelectric Power Plant	resName	Boa Esperança Reservoir
Boca Dam	resName	Boca Reservoir
Ririe Reservoir	resName	Ririe Reservoir
Conchas Dam	resName	Conchas Lake
Dock Street Dam	resName	Susquehanna River
Eufaula Dam	resName	Eufaula Lake
Tismana Hydroelectric Power Station	resName	Motru Lake
Punt dal Gall Dam	resName	Lago di Livigno
Sterkfontein Dam	resName	Sterkfontein Dam Reservoir
Malibu Hydro	resName	McCannel Lake
Jean-Lesage generating station	resName	Manic-2
René-Lévesque generating station	resName	Reservoir Manic-3
Vatnsfell Power Station	resName	Lake Thórisvatn
Duncan Dam	resName	Duncan Lake
Madikheda Dam	resName	Madikheda
Spioenkop Dam	resName	Spioenkop Dam Reservoir
Mossyrock Dam	resName	Riffe Lake
Merwin Dam	resName	Lake Merwin
Yale Dam	resName	Yale Lake
Swift Dam	resName	Swift Reservoir
Round Butte Dam	resName	The Cove Palisades State Park
Arthur R. Bowman Dam	resName	Prineville Reservoir
Cougar Dam	resName	Cougar Reservoir
Lookout Point Dam	resName	Lookout Point Lake
Lucky Peak Dam	resName	Lucky Peak Lake
Whatshan Dam	resName	Whatshan Lake
Arrowrock Dam	resName	Arrowrock Reservoir
Anderson Ranch Dam	resName	Anderson Ranch Reservoir
Tieton Dam	resName	Rimrock Lake
Corra Linn Dam	resName	Kootenay Lake
Dry Falls Dam	resName	Banks Lake
Maroondah Dam	resName	Maroondah Reservoir
Amaravathi Dam	resName	Amaravathi Reservoir
Shintoyone Dam	resName	Lake Midori
Hyugami Dam	resName	Hyūgami Reservoir
Aburagi Dam	resName	Aburagi Dam reservoir
Ōi Dam	resName	Ena Gorge
Hosobidani Dam	resName	Hosobedani Chōsei Reservoir
Agigawa Dam	resName	Agigawako Lake
Naramata Dam	resName	Lake Naramata
Nozori Dam	resName	Lake Nozori
Aimata Dam	resName	Akaya Lake
Taishakugawa Dam	resName	Lake Shuiryuko
Hatori Dam	resName	Hatori Reservoir
Sakamoto Dam	resName	Lake Usui
Shiroyama Dam	resName	Lake Tsukui
Hōheikyō Dam	resName	Lake Jōzan
Kuriyama Dam	resName	Lake Kuriyama
Black Rock Dam	resName	Black Rock Pool
Rietvlei Dam	resName	Rietvlei Dam Reservoir
Kilburn Dam	resName	Kilburn Dam Reservoir
Fierza Hydroelectric Power Station	resName	Fierza Reservoir
Koman Hydroelectric Power Station	resName	Koman Reservoir
Mingachevir Dam	resName	Mingachevir reservoir
Trị An Dam	resName	Trị An Lake
Tsankov Kamak Hydro Power Plant	resName	Tsankov Kamak reservoir
Canyon Ferry Dam	resName	Canyon Ferry Lake
Turkwel Hydroelectric Power Station	resName	Turkwel Gorge Reservoir
Driekloof Dam	resName	Driekloof Dam
Watauga Dam	resName	Watauga Lake
Dix Dam	resName	Herrington Lake
Pardee Dam	resName	Pardee Reservoir
Karapiro Power Station	resName	Lake Karapiro
Roodeplaat Dam	resName	Roodeplaat Dam Reservoir
Chingaza Dam	resName	Chuza Reservoir
Tully Lake	resName	Tully Lake
Dukan Dam	resName	Lake Dukan
Cherokee Dam	resName	Cherokee Lake
Pittock Dam	resName	Pittock Reservoir
Blue Ridge Dam	resName	Blue Ridge Lake
Ocoee Dam No. 3	resName	Ocoee No. 3 Reservoir
Hiwassee Dam	resName	Hiwassee Reservoir
Mammoth Pool Dam	resName	Mammoth Pool Reservoir
Nottely Dam	resName	Lake Nottely
Chatuge Dam	resName	Chatuge Lake
Zhinvali Dam	resName	Zhinvali Reservoir
South Holston Dam	resName	South Holston Lake
Boone Dam	resName	Boone Lake
Fort Patrick Henry Dam	resName	Fort Patrick Henry Lake
Zipingpu Dam	resName	Zipingpu Reservoir
Kingsley Dam	resName	Lake McConaughy
Salime Reservoir	resName	Salime Reservoir
Étang de Soulcem	resName	Étang de Soulcem
Culmback Dam	resName	Spada Lake
Jamestown Dam	resName	Jamestown Reservoir
Millers Ferry Lock and Dam	resName	William %22Bill%22 Dannelly Reservoir
Chulabhorn Dam	resName	Chulabhorn Dam Reservoir
Curwensville Dam	resName	West Branch Susquehanna River
Chamera Dam	resName	Chamera Reservoir
Fontenelle Dam	resName	Fontenelle Reservoir
Alder Dam	resName	Alder Lake
Bayano Dam	resName	Lago Bayano
Gangrel Dam	resName	Ravishankar Reservoir
Spring Creek Dam	resName	Spring Creek Reservoir
Tashiro Dam	resName	Tashiro-chōseichi
Hatanagi-I Dam	resName	Lake Hatanagi
Ikawa Dam	resName	Ikawa-ko
Maguga Dam	resName	Maguga Dam Reservoir
Cerrón Grande Dam	resName	Embalse Cerrón Grande
Maraetai Power Station	resName	Lake Maraetai
Arapuni Power Station	resName	Lake Arapuni
New Hogan Dam	resName	New Hogan Lake
Satpula	resName	Irrigation
Peace Canyon Dam	resName	Dinosaur Lake
Emmarentia Dam	resName	Emmarentia Dam Reservoir
Victoria Dam	resName	Victoria Reservoir
Glendo Reservoir	resName	Glendo Reservoir
Guernsey Dam	resName	Guernsey Reservoir
Nagashima Dam	resName	Nagashima Reservoir
Samanala Dam	resName	Samanala Reservoir
Funagira Dam	resName	Funagira Reservoir
Clarrie Hall Dam	resName	Lake Clarrie Hall
Toonumbar Dam	resName	Lake Toonumbar
New Exchequer Dam	resName	Lake McClure
Misakubo Dam	resName	Misabuko Reservoir
Akiba Dam	resName	Akiba Reservoir
Buyo Dam	resName	Lake Buyo
Kossou Dam	resName	Lake Kossou
Kakki Reservoir	resName	Kakki
Miyagase Dam	resName	Lake Miyagase
Sagami Dam	resName	Lake Sagami
Miho Dam	resName	Lake Tanzawa
Boguchany Dam	resName	Boguchany Reservoir
Nilwande Dam	resName	Nilwande Dam
Bhadbhada Dam	resName	Upper Lake
Akhori Dam	resName	Akhori reservoir
Anangpur Dam	resName	Water supply
Anangpur Dam	resName	Irrigation
O'Neill Dam	resName	O'Neill Forebay
Jim Woodruff Dam	resName	Lake Seminole
Whiskeytown Dam	resName	Whiskeytown Lake
Angat Dam	resName	Angat Reservoir
Albasini Dam	resName	Albasini Dam Reservoir
Daniel-Johnson Dam	resName	Manicouagan Reservoir
Hemrin Dam	resName	Hemrin Reservoir
Cizre Dam	resName	Cizre Reservoir
Gilgel Gibe III Dam	resName	Gilgel Gibe III Reservoir
Blue Rock Dam	resName	Blue Rock Lake
Ahai Dam	resName	Ahai Reservoir
Pantabangan Dam	resName	Pantabangan Lake
Glanum Dam	resName	Lac des Peiròu
Lake Homs Dam	resName	Lake Homs
Sathanur Dam	resName	Sathanur Reservoir
Krishnagiri Dam	resName	Krishnagiri Reservoir
Narva Hydroelectric Station	resName	Narva Reservoir
Paute Dam	resName	Paute Reservoir
Feitsui Dam	resName	Feitsui Reservoir
Mingtan Dam	resName	Mingtan Reservoir
John H. Kerr Dam	resName	Kerr Lake
Bridgeport Reservoir	resName	Bridgeport Reservoir
Berg River Dam	resName	Berg River Dam Reservoir
Smith Mountain Dam	resName	Smith Mountain Lake
Çine Dam	resName	Cine Reservoir
Çubuk-1 Dam	resName	Çubuk Reservoir
Hirfanlı Dam	resName	Hirfanli Reservoir
Göksu Dam	resName	Göksu Reservoir
Deriner Dam	resName	Deriner Reservoir
Kemer Dam	resName	Kemer Reservoir
Patnos Dam	resName	Asagigösmez
Bloemhof Dam	resName	Bloemhof Dam Reservoir
Baath Dam	resName	Baath Dam Reservoir
Woodstock Dam	resName	Woodstock Dam Reservoir
Tishrin Dam	resName	Tishrin Dam Reservoir
Allemanskraal Dam	resName	Allemanskraal Dam Reservoir
Alphen Dam	resName	Alphen Dam Reservoir
Albert Falls Dam	resName	Albert Falls Dam Reservoir
Beervlei Dam	resName	Beervlei Dam Reservoir
Bivane Dam	resName	Bivane Dam Reservoir
Armenia Dam	resName	Armenia Dam Reservoir
Bon Accord Dam	resName	Bon Accord Dam Reservoir
Blyderivierpoort Dam	resName	Blyderivierpoort Dam Reservoir
Boegoeberg Dam	resName	Boegoeberg Dam Reservoir
Bospoort Dam	resName	Bospoort Dam Reservoir
Brandvlei Dam	resName	Brandvlei Dam Reservoir
Bronkhorstspruit Dam	resName	Bronkhorstspruit Dam Reservoir
Bridle Drift Dam	resName	Bridal Drift Dam Reservoir
Boskop Dam	resName	Boskop Dam Reservoir
Driekloof Dam	resName	Driekloof Dam  Reservoir
Dap Naudé Dam	resName	Dap Naudé Dam Reservoir
Buffeljags Dam	resName	Buffeljags Dam Reservoir
Kromme Dam	resName	Kromme Dam Reservoir
Ceres Koekedouw Dam	resName	Ceres Koekedouw Dam Reservoir
Doorndraai Dam	resName	Doorndraai Dam Reservoir
Clanwilliam Dam	resName	Clanwilliam Dam Reservoir
Darlington Dam	resName	Lake Mentz
Craigie Burn Dam	resName	Craigie Burn Dam Reservoir
Driekoppies Dam	resName	Lake Matsamo
Ebenezer Dam	resName	Ebenezer Dam Reservoir
Eikenhof Dam	resName	Eikenhof Dam Reservoir
Elandskuil Dam	resName	Elandskuil Dam Reservoir
Elandskloof Dam	resName	Elandskloof Dam Reservoir
Erfenis Dam	resName	Erfenis Dam Reservoir
Flag Boshielo Dam	resName	Flag Boshielo Dam Reservoir
Egmont Dam	resName	Egmont Dam Reservoir
Hellsgate Dam	resName	Hellsgate Dam Reservoir
Glen Alpine Dam	resName	Glen Alpine Dam Reservoir
Greater Brandvlei Dam	resName	Greater Brandvlei Dam Reservoir
Grootdraai Dam	resName	Grootdraai Dam Reservoir
Impofu Dam	resName	Impofu Dam Reservoir
Heyshope Dam	resName	Heyshope Dam Reservoir
Goedertrouw Dam	resName	Goedertrouw Dam Reservoir
Keerom Dam	resName	Keerom Dam Reservoir
Kalkfontein Dam	resName	Kalkfontein Dam Reservoir
Klipberg Dam	resName	Klipberg Dam Reservoir
Metz Dam	resName	Metz Dam Reservoir
Klipdrif Dam	resName	Klipdrif Dam Reservoir
Knellpoort Dam	resName	Knellpoort Dam Reservoir
Klerkskraal Dam	resName	Klerkskraal Dam Reservoir
Inanda Dam	resName	Inanda Dam Reservoir
Kwaggaskloof Dam	resName	Kwaggaskloof Dam Reservoir
Luphephe Dam	resName	Luphephe Dam Reservoir
Lubisi Dam	resName	Lubisi Dam Reservoir
Koppies Dam	resName	Koppies Dam Reservoir
Kwena Dam	resName	Kwena Dam Reservoir
Loskop Dam	resName	Loskop Dam reservoir
Mokolo Dam	resName	Mokolo Dam Reservoir
Molatedi Dam	resName	Molatedi Dam Reservoir
Lakenvallei Dam	resName	Lakenvallei Dam Reservoir
Misverstand Dam	resName	Misverstand Dam Reservoir
Mutshedzi Dam	resName	Mutshedzi Dam Reservoir
Kogelberg Dam	resName	Kogelberg Dam Reservoir
Nagle Dam	resName	Nagle Dam Reservoir
Middle Letaba Dam	resName	Middle Letaba Dam Reservoir
Phiphidi Dam	resName	Phiphidi Dam Reservoir
Nooitgedacht Dam	resName	Nooitgedacht Dam reservoir
Nzhelele Dam	resName	Nzhelele Dam Reservoir
Nwanedi Dam	resName	Nwanedi Dam Reservoir
Ncora Dam	resName	Ncora Dam Reservoir
Ohrigstad Dam	resName	Ohrigstad Dam Reservoir
Ntshingwayo Dam	resName	Ntshingwayo Dam Reservoir
Qedusizi Dam	resName	Qedusizi Dam Reservoir
Xonxa Dam	resName	Xonxa Dam Reservoir
Witbank Dam	resName	Witbank Dam Reservoir
Wemmershoek Dam	resName	Wemmershoek Dam Reservoir
Welbedacht Dam	resName	Welbedacht Dam Reservoir
Theewaterskloof Dam	resName	Theewaterskloof Dam Reservoir
Spitskop Dam	resName	Spitskop Dam Reservoir
Voëlvlei Dam	resName	Voëlvlei Dam
Rhenosterkop Dam	resName	Rhenosterkop Dam Reservoir
Zaaihoek Dam	resName	Zaaihoek Dam Reservoir
Woodhead Dam	resName	Woodhead Reservoir
Wagendrift Dam	resName	Wagendrift Dam Reservoir
Pongolapoort Dam	resName	Pongolapoort Dam Reservoir
Pietersfontein Dam	resName	Pietersfontein Dam Reservoir
Poortjieskloof Dam	resName	Poortjieskloof Dam Reservoir
Tianshengqiao-I Dam	resName	Tianshengqiao-I Reservoir
J. Strom Thurmond Dam	resName	Lake Strom Thurmond
Richard B. Russell Dam	resName	Richard B. Russell Lake
Oker Dam	resName	Oker Reservoir
Bongolo Dam	resName	Bongolo Dam Reservoir
Kommandodrif Dam	resName	Kommandodrif Dam Reservoir
Saville Dam	resName	Barkhamsted Reservoir
Santa Fe Dam	resName	Santa Fe Flood Control Basin
Lower Baker Dam	resName	Lake Shannon
Buffelspoort Dam	resName	Buffelspoort Dam Reservoir
Bloemhoek Dam	resName	Bloemhoek Dam Reservoir
Da Gama Dam	resName	Da Gama Dam Reservoir
Binfield Park Dam	resName	Binfield Park Dam Reservoir
Boschmanskop No 1 Dam	resName	Boschmanskop No 1+2 Dam Reservoir
Damani Dam	resName	Damani Dam Reservoir
Disaneng Dam	resName	Disaneng Dam Reservoir
Doring River Dam	resName	Doring River Dam Reservoir
De Hoop Dam	resName	De Hoop Dam Reservoir
Douglas Weir	resName	Douglas Weir Reservoir
Fika-Patso Dam	resName	Fika-Patso Dam Reservoir
Gamkapoort Dam	resName	Gamkapoort Dam Reservoir
Floriskraal Dam	resName	Floriskraal Dam Reservoir
Gathright Dam	resName	Lake Moomaw
Grassridge Dam	resName	Grassridge Dam Reservoir
Groendal Dam	resName	Groendal Dam Reservoir
Hazelmere Dam	resName	Hazelmere Dam Reservoir
Injaka Dam	resName	Injaka Dam Reservoir
Jericho Dam	resName	Jericho Dam Reservoir
Kammanassie Dam	resName	Kammanassie Dam Reservoir
Katrivier Dam	resName	Katrivier Dam Reservoir
Kettingspruit Dam	resName	Kettingspruit Dam Reservoir
Klipkopjes Dam	resName	Klipkopjes Dam Reservoir
Klipvoor Dam	resName	Klipvoor Dam Reservoir
Kromfonteinlower	resName	Kromfonteinlower Reservoir
Kromfontein Middle Cofferdam	resName	Kromfontein Middle Reservoir
Krugerdrift Dam	resName	Krugerdrift Dam Reservoir
Kruismansrivier Dam	resName	Kruisrivier Dam Reservoir
Laing Dam	resName	Laing Dam Reservoir
Lake Arthur Dam	resName	Lake Arthur
Lake Mzingazi Dam	resName	Lake Mzingazi
Leeu-Gamka Dam	resName	Leeu-Gamka Dam Reservoir
Lindleyspoort Dam	resName	Lindleyspoort Dam Reservoir
Howard A. Hanson Dam	resName	Howard A. Hanson Reservoir/Pool
Madikwe Dam	resName	Madikwe Dam Reservoir
Makuleke Dam	resName	Makuleke Dam Reservoir
Middelburg Dam	resName	Middelburg Dam Reservoir
Marico-Bosveld Dam	resName	Marico-Bosveld Dam Reservoir
Modderpoort Dam	resName	Modderpoort Dam Reservoir
Morgenstond Dam	resName	Morgenstond Dam Reservoir
Mthatha Dam	resName	Mthatha Dam Reservoir
Nahoon Dam	resName	Nahoon Dam Reservoir
Portugués Dam	resName	Portugues Reservoir
Sly Park Dam	resName	Jenkinson Lake
Kelbra Dam	resName	Kelbra Reservoir
Cotter Dam	resName	Cotter Reservoir
Ngodwana Dam	resName	Ngodwana Dam Reservoir
Ngotwane Dam	resName	Ngotwane Dam Reservoir
Myitsone Dam	resName	Myitsone reservoir
Shuibuya Dam	resName	Shuibuya Reservoir
New Savannah Bluff Lock and Dam	resName	Savannah River
Nqweba Dam	resName	Nqweba Dam Reservoir
Olifantsnek Dam	resName	Olifantsnek Dam Reservoir
Chimmony Dam	resName	Chimmony River
Oudebaaskraal Dam	resName	Oudebaaskraal Dam Reservoir
Rockview Dam	resName	Rockview Dam Reservoir
Roodekoppies Dam	resName	Roodekoppies Dam Reservoir
Rustfontein Dam	resName	Rustfontein Dam Reservoir
Sandile Dam	resName	Sandile Dam Reservoir
Setumo Dam	resName	Setumo Dam Reservoir
Slangdraai Dam	resName	Slangdraai Dam Reservoir
Smartt Dam	resName	Smartt Dam Reservoir
Sol Plaatje Dam	resName	Sol Plaatje Dam Reservoir
Steenbras Dam – Upper	resName	Steenbras Dam - Upper Reservoir
Taung Dam	resName	Taung Dam Reservoir
Stompdrift Dam	resName	Stompdrift Dam Reservoir
Trichardtsfontein Dam	resName	Trichardtsfontein Dam Reservoir
Tsojana Dam	resName	Tsojana Dam Reservoir
Vaal Barrage	resName	Vaal Barrage Reservoir
Waterdown Dam	resName	Waterdown Dam Reservoir
Tweedraai Dam	resName	Tweedraai Dam Reservoir
Vondo Dam	resName	Vondo Dam Reservoir
Westoe Dam	resName	Westoe Dam Reservoir
Witklip Dam	resName	Witklip Dam Reservoir
Wolwedans Dam	resName	Wolwedans Dam Reservoir
Wriggleswade Dam	resName	Wriggleswade Dam Reservoir
Green Peter Dam	resName	Green Peter Reservoir
Peñitas Dam	resName	Peñitas Reservoir
E.B. Campbell Hydroelectric Station	resName	Tobin Lake
Guaicaramo Dam	resName	Upia Reservoir
Amir Kabir Dam	resName	Amir Kabir Lake
Hòa Bình Dam	resName	Sông Đà Reservoir
Cahora Bassa Dam	resName	Cahora Bassa Lake
Sobradinho Dam	resName	Sobradinho Reservoir
Andrew F.C. Turpin Dam	resName	Andrew F.C. Turpin Dam Reservoir
Seimare Dam	resName	Seimareh Reservoir
Upper Gotvand Dam	resName	Upper Gotvand Reservoir
Khersan-3 Dam	resName	Khersan-3 Reservoir
Gavoshan Dam	resName	Gavoshan Reservoir
Stânca-Costești Dam	resName	Stânca-Costeşti Lake
Zobe Dam	resName	Zobe lake
Jibiya Dam	resName	Jibiya lake
Kiri Dam	resName	Kiri lake
Oyan River Dam	resName	Oyan lake
Dadin Kowa Dam	resName	Lake Dadin Kowa
Ikere Gorge Dam	resName	Ikere Gorge Dam
Asejire Reservoir	resName	Asejire Reservoir
Josefův Důl dam	resName	Josefův Důl reservoir
Rangit Dam	resName	Rangit Reservoir
Tenughat Dam	resName	Khandoli Lake
Holter Dam	resName	Holter Lake
Hauser Dam	resName	Hauser Lake
John W. Flannagan Dam	resName	John W. Flannagan Reservoir
Cerro de Oro Dam	resName	Cerro de Oro Lake
Miguel Alemán Dam	resName	Miguel Alemán Lake
Ukai Dam	resName	Vallabhsagar
La Grange Dam	resName	La Grange Reservoir
Hope Mills Dam	resName	Hope Mills Lake
Laurel Run Dam	resName	Laurel Run Reservoir
Salmon Creek Dam	resName	Salmon Creek Reservoir
Jawa Dam	resName	Jawa Reservoir
Sadd el-Kafara	resName	Sadd-el-Kafara Reservoir
Searsville Dam	resName	Searsville Lake
Aldeadávila Dam	resName	Aldeadávila Reservoir
Delhi Dam	resName	Lake Delhi
San Vicente Dam	resName	San Vicente Reservoir
Upper Kotmale Dam	resName	Upper Kotmale Reservoir
San Gabriel Dam	resName	San Gabriel Reservoir
Santa Anita Dam	resName	Santa Anita Reservoir
Ben Chifley Dam	resName	Chifley Dam
Gileppe Dam	resName	Lake Gileppe
Outardes-4	resName	Outardes-4 Reservoir
Carbon Canyon Dam	resName	Carbon Canyon Reservoir
Vileshchay reservoir	resName	Vileshchay Dam Reservoir
Ranganadi Dam	resName	Ranganadi Reservoir
Farkhad Dam	resName	Farkhad Reservoir
Ust-Ilimsk Hydroelectric Power Station	resName	Ust-Ilimsk Reservoir
Ilha Solteira Dam	resName	Ilha Solteira Reservoir
Xingó Dam	resName	Xingó Reservoir
Irganai Dam	resName	Irganai reservoir
Luiz Gonzaga Dam	resName	Luiz Gonzaga Reservoir
O'Shannassy Reservoir	resName	O'Shannassy Reservoir
José Richa Hydroelectric Plant	resName	Governor José Richa Reservoir
Bento Munhoz Hydroelectric Plant	resName	Governor Bento Munhoz da Rocha Netto Reservoir
Ney Braga Hydroelectric Plant	resName	Governor Ney Braga de Barros Reservoir
Salto Santiago Hydroelectric Power Plant	resName	Salto Santiago Reservoir
Salto Osório Hydroelectric Power Plant	resName	Salto Osório Reservoir
Itá Hydroelectric Power Plant	resName	Itá Reservoir
Machadinho Hydroelectric Power Plant	resName	Itá Reservoir
Barra Grande Hydroelectric Power Plant	resName	Barra Grande Reservoir
Eng Sérgio Motta Dam	resName	Sérgio Motta Reservoir
Bersimis-1 generating station	resName	Pipmuacan Reservoir
Itumbiara Dam	resName	Itumbiara Reservoir
Serra da Mesa Dam	resName	Serra da Mesa Reservoir
Marimbondo Dam	resName	Marimbondo Reservoir
Água Vermelha Dam	resName	Água Vermelha Reservoir
Engineer Souza Dias Dam	resName	Engineer Souza Dias Reservoir
Luiz Barreto Dam	resName	Luiz Carlos Barreto de Carvalho Reservoir
São Simão Dam	resName	São Simão Reservoir
Emborcação Dam	resName	Emborcação Reservoir
Mandohol Dam	resName	Mandohol Lake
Gandō Dam	resName	Gandō Lake
Gosho Dam	resName	Gosho Lake
Hayachine Dam	resName	Hayachine Lake
Toyosawa Dam	resName	Toyosawa Lake
Sannōkai Dam	resName	Heian Lake
Shijūshida Dam	resName	Nanbu-Katafuji Lake
Okuno Dam	resName	Lake Matsukawa
Großer Brombachsee	resName	Großer Brombachsee
Tikhol Dam	resName	Tikhol lake
Palashi Dam	resName	Palashi lake
Hanga Dam	resName	Hanga lake
Rui Chatrapati Dam	resName	Rui Chatrapati lake
Dhoki Dam	resName	Dhoki lake
Lonimavla Dam	resName	Lonimavla lake
Três Marias Dam	resName	Três Marias Reservoir
Al Wahda Dam	resName	Al Wahda Reservoir
Aburumagawa Dam	resName	Aburumagawa Reservoir
Bham Dam	resName	Bham reservoir
Thokarwadi Dam	resName	Thokarwadi
Yeldari Dam	resName	Yeldari
Siddheshwar Dam	resName	Siddheshwar
Sirpur Dam	resName	Bagh reservoir
Manjara Dam	resName	Manjara
Majalgaon Dam	resName	Majalgaon
Polavaram Project	resName	Polavaram Reservoir
New Don Pedro Dam	resName	Don Pedro Reservoir
Success Dam	resName	Lake Success
Pit 3 Dam	resName	Lake Britton
Yomasari Dam	resName	Lake Aoba
Loch Sloy Hydro-Electric Scheme	resName	Loch Sloy
Varvara reservoir	resName	Varvara Dam Reservoir
Fuchu Dam	resName	Lake Fuchu
Honzawa Dam	resName	Shiroyama Reservoir
Yanase Dam	resName	Yanase Chosuichi Reservoir
Hachisu Dam	resName	Okukahada Reservoir
Hinachi Dam	resName	Hinachi Reservoir
Misedani Dam	resName	Lake Okuise
Shorenji Dam	resName	Shōrenji Reservoir
Hanayama Dam	resName	Hanayama Reservoir
Kamafusa Dam	resName	Kamafusa Lake
Naruko Dam	resName	Araoko
Ottu barrage	resName	Water supply
Ottu barrage	resName	Irrigation
Gongboxia Dam	resName	Gongboxia Reservoir
Idamalayar Dam	resName	Idamalayar Reservoir
Aswan Low Dam	resName	tailwater of Lake Nasser
Tianshengqiao-II Dam	resName	Tianshengqiao-II Reservoir
Yele Dam	resName	Yele Reservoir
El Vado Dam	resName	El Vado Lake
Shuangjiangkou Dam	resName	Shuangjiangkou Reservoir
Shuikou Dam	resName	Shuikou Reservoir
Olivenhain Dam	resName	Olivenhain Reservoir
Shapai Dam	resName	Shapai Reservoir
Sirindhorn Dam	resName	Sirindhorn Reservoir
Mianhuatan Dam	resName	Mianhuatan Reservoir
Longyangxia Dam	resName	Longyangxia Reservoir
Hongjiadu Dam	resName	Hongjiadu Reservoir
Zeya Dam	resName	Zeya Reservoir
Liuxihe Dam	resName	Liuxihe Reservoir
Guangzhao Dam	resName	Guangzhao Reservoir
Dahuashui Dam	resName	Dahuashui Reservoir
Ankang Dam	resName	Ankang Reservoir
Dachaoshan Dam	resName	Dachaoshan Reservoir
Jinghong Dam	resName	Jinghong Reservoir
Lijiaxia Dam	resName	Lijiaxia Reservoir
Ulla-Førre	resName	Blåsjø
Sanbanxi Dam	resName	Sanbanxi Reservoir
Dagangshan Dam	resName	Dagangshan Reservoir
Jiangpinghe Dam	resName	Jiangpinghe Reservoir
Fengman Dam	resName	Fengman Reservoir
Baishan Dam	resName	Baishan Reservoir
Jishixia Dam	resName	Jishixia Reservoir
Guanyinyan Dam	resName	Guanyinyan Reservoir
Changheba Dam	resName	Changheba Reservoir
Jinanqiao Dam	resName	Jinanqiao Reservoir
Liyuan Dam	resName	Liyuan Reservoir
Sambor Dam	resName	Sambor Hydropower Dam Reservoir
Pengshui Dam	resName	Pengshui Reservoir
Silin Dam	resName	Silin Reservoir
Yantan Dam	resName	Yantan Reservoir
Wuqiangxi Dam	resName	Wuqiangxi Reservoir
Wanjiazhai Dam	resName	Wanjiazhai Reservoir
Wujiangdu Dam	resName	Wujiangdu Reservoir
Chirkey Dam	resName	Chirkey Reservoir
Macagua Dam	resName	Macagua Reservoir
Nizhnekamsk Hydroelectric Station	resName	Nizhnekamsk Reservoir
Votkinsk Hydroelectric Station	resName	Votkinsk Reservoir
Pavlovka Hydroelectric Station	resName	Pavlovka Reservoir
Ivaylovgrad Dam	resName	Ivaylovgrad Reservoir
Amagase Dam	resName	Lake Hōō
Martin Dam	resName	Lake Martin
Stung Battambang 1 Dam	resName	Stung Battambang 1 Hydropower Dam Reservoir
Kirirom 1 Hydropower Dam	resName	Kirirom 1 Hydropower Dam Reservoir
Upper Baker Dam	resName	Baker Lake
O Chum 2 Hydropower Dam	resName	O Chum 2 Hydropower Dam Reservoir
Stung Sen Dam	resName	Stung Sen Dam Reservoir
Huai Kum Dam	resName	Huai Kum Dam Reservoir
Hua Na Dam	resName	Hua Na Dam Reservoir
Lam Takhong Dam	resName	Lam Thakhong Dam Reservoir
Lam Phra Phloeng Dam	resName	Lam Phra Phloeng Dam Reservoir
Nam Pung Dam	resName	Nam Pung Dam Reservoir
Ubol Ratana Dam	resName	Ubol Ratana Reservoir
Sweetwater Dam	resName	Sweetwater Reservoir
Loveland Dam	resName	Loveland Reservoir
Bridge Canyon Dam	resName	Bridge Canyon Reservoir
Amistad Dam	resName	Amistad Reservoir
Chicoasén Dam	resName	Chicoasén Reservoir
Infiernillo Dam	resName	Infiernillo Reservoir
Savage Dam	resName	Lower Otay Reservoir
Lianghekou Dam	resName	Lianghekou Reservoir
Aras Dam	resName	Aras Reservoir
Angostura Dam	resName	Angostura Reservoir
Danjiangkou Dam	resName	Danjiangkou Reservoir
Salaulim Dam	resName	Salaulim Reservoir
Bhadra Dam	resName	Multipurpose
Techi Dam	resName	Techi Reservoir
Longkaikou Dam	resName	Longkaikou Reservoir
Houziyan Dam	resName	Houziyan Reservoir
Shatuo Dam	resName	Shatuo Reservoir
Tingzikou Dam	resName	Tingzikou Reservoir
Seminoe Dam	resName	Seminoe Reservoir
Álvaro Obregón Dam	resName	Lake Oviáchic
Bhumibol Dam	resName	Bhumibol Reservoir
Sirikit Dam	resName	Sirikit Reservoir
Srinagarind Dam	resName	Srinagarind Reservoir
Cochrane Dam	resName	Cochrane Lake
Gleno Dam	resName	Gleno Reservoir
Xinfengjiang Dam	resName	Xinfengjiang Reservoir
Marathon Dam	resName	Lake Marathon
Craig Goch Dam	resName	Craig Goch Reservoir
Castelo de Bode Dam	resName	Castelo de Bode Reservoir
Fujinuma Dam	resName	Fujinuma Reservoir
Pensacola Dam	resName	Grand Lake o' the Cherokees
Green Mountain Reservoir	resName	Green Mountain Reservoir
Boysen Dam	resName	Boysen Reservoir
Black Eagle Dam	resName	Long Pool
Grand Ethiopian Renaissance Dam	resName	Millennium Reservoir
Toston Dam	resName	Toston Reservoir
Kotmale Dam	resName	Kotmale Reservoir
Toorourrong Reservoir	resName	Toorourrong Reservoir
Salvajina Dam	resName	Salvajina Reservoir
Grassy Lake Dam	resName	Grassy Creek Reservoir
Island Park Dam	resName	Island Park Reservoir
Sanmenxia Dam	resName	Sanmenxia Reservoir
Alcova Dam	resName	Alcova Reservoir
Lake Sherburne Dam	resName	Lake Sherburne
La Esmeralda Dam	resName	La Esmeralda Reservoir
Glacier View Dam	resName	Glacier View Reservoir
Paradise Dam	resName	Paradise Reservoir
El Quimbo Dam	resName	Hydropower
Bull Shoals Dam	resName	Bull Shoals Lake
Lake Yahola	resName	Lake Yahola
Pipestem Dam	resName	Pipestem Reservoir
Sherwood Dam	resName	Lake Sherwood
Ruskin Dam and Powerhouse	resName	Hayward Lake
Stave Falls Dam and Powerhouse	resName	Stave Lake
Jinping-I Dam	resName	Jinping-I Reservoir
Lake Darling Dam	resName	Lake Darling, North Dakota
Jinping-II Dam	resName	Jinping-II Reservoir
Kootenay Canal	resName	Kootenay Lake
Miel I Dam	resName	Amani Reservoir
Punchiná Dam	resName	Punchiná Reservoir
Menihek Hydroelectric Generating Station	resName	Lake Menihek
Ichari Dam	resName	Ichari Reservoir
Hitotsuse Dam	resName	Mera Reservoir
Tsukabaru Dam	resName	34326000
Pulichinthala Project	resName	Pulichinthala
Shimajigawa Dam	resName	Lake Takase
Sripada Yellampalli project	resName	Yellampalli
Bradbury Dam	resName	Lake Cachuma
Zillergründl Dam	resName	Zillergründl Reservoir
Rapel Dam	resName	Lake Rapel
Okutadami Dam	resName	Lake Okutadami
Prewitt Reservoir	resName	Prewitt Reservoir
Munda Dam	resName	Munda Reservoir
Bratsberg Hydroelectric Power Station	resName	Selbusjøen reservoir
Silver Lake Dam	resName	Silver Lake Basin
Banning Dam	resName	Lake Eleanor
Kōsaka Dam	resName	Lake Kōsaka Dam
Lake Kutsuzawa Dam	resName	Lake Kutsuzawa
Lake Misuzu Dam	resName	Lake Misuzu
Sup'ung Dam	resName	Sapung Lake
Jinshuitan Dam	resName	Xiangong Lake
Dongjiang Dam	resName	Dongjiang Lake
Baozhusi Dam	resName	White Dragon Lake
Fort Gibson Dam	resName	Fort Gibson Lake
Lake Fayetteville	resName	Lake Fayetteville
Camanche Dam	resName	Camanche Reservoir
Big Tujunga Dam	resName	Big Tujunga Reservoir
Iron Gate Dam	resName	Iron Gate Reservoir
Lake Eucha	resName	Lake Eucha
Tulloch Dam	resName	Tulloch Reservoir
Long Lake Dam	resName	Long Lake
Fresno Dam	resName	Fresno Reservoir
Keswick Dam	resName	Keswick Reservoir
Pulangi Dam	resName	Pulangi IV Reservoir
Cogswell Dam	resName	Cogswell Reservoir
El Capitan Dam	resName	El Capitan Reservoir
Canyon Dam	resName	Lake Almanor
Puddingstone Dam	resName	Puddingstone Reservoir
Pandoh Dam	resName	Pandoh Lake
Pong Dam	resName	Maharana Pratap Sagar
Madden Dam	resName	Lake Alajuela
Grand'Maison Dam	resName	Lac de Grand Maison
Tungabhadra Dam	resName	Tungabhadra Reservoir
Kodiveri dam	resName	Kodiveri
Parangana Power Station	resName	Lake Parangana
Kremasta Dam	resName	Lake Kremasta
Moses-Saunders Power Dam	resName	Lake St. Lawrence
Khandoli Dam	resName	Khandoli Lake
Temperance Flat Dam	resName	Temperance Flat Reservoir
Roselend Dam	resName	Lac de Roselend
Vaalkop Dam	resName	Vaalkop Dam Reservoir
Massingir Dam	resName	Massingir Lake
Florentino Ameghino Dam	resName	Florentino Ameghino Reservoir
Jounama Dam	resName	Jounama Pondage
Xiaonanhai Dam	resName	Xiaonanhai Reservoir
Denis-Perron Dam	resName	Sainte-Marguerite 3 Reservoir
Veterans Memorial Dam	resName	Lake of the Woods
Vazhani Dam	resName	Wadakkanchery River
Bheemgarh Dam	resName	Sanjay Sarovar
Rye Patch Reservoir	resName	Rye Patch Reservoir
Bunji Dam	resName	Indus River
Pinto Dam	resName	Billy Clapp Lake
Soldier Creek Dam	resName	Strawberry Reservoir
Edenville Dam	resName	Wixom Lake
Enders Dam	resName	Enders Reservoir
Gibson Dam	resName	Gibson Reservoir
Angostura Dam	resName	Angostura Reservoir
Salmon Falls Dam	resName	Salmon Falls Creek Reservoir
A. I. Selden Dam	resName	Warrior Lake
Jocassee Dam	resName	Lake Jocassee
Harsprånget hydroelectric power station	resName	Harsprånget Reservoir
Abiquiu Dam	resName	Abiquiu Lake
Antelope Dam	resName	Antelope Lake
Donnells Dam	resName	Donnell Lake
San Antonio Dam	resName	Lake San Antonio
Bass Lake Dam	resName	Bass Lake
Grahamstown Dam	resName	Grahamstown Lake
Cheruthoni Dam	resName	Idukki Reservoir
Engelhard Dam	resName	Engelhard Dam Reservoir
Potchefstroom Dam	resName	Potchefstroom Dam Reservoir
Papanasam Dam	resName	Papanasam Reservoir
Basava Sagara	resName	Basava Sagara/ಬಸವ ಸಾಗರ
Lake Thomas A Edison	resName	Lake Thomas A Edison
Little Grass Valley Reservoir	resName	Little Grass Valley Reservoir
Copco Lake	resName	Copco Reservoir
Mauá Hydroelectric Plant	resName	Mauá Reservoir
Rust de Winter Dam	resName	Rust de Winter Dam Reservoir
Tzaneen Dam	resName	Tzaneen Dam Reservoir
Oxkraal Dam	resName	Oxkraal Dam Reservoir
Bustos Dam	resName	Bustos Dam Reservoir
Trasona Reservoir	resName	Embalse de Trasona
Boz Dam	resName	95
Carraízo Dam	resName	Loíza Lake
Khashm el-Girba Dam	resName	Khashm el-Girba Reservoir
Xilinxa Dam	resName	Xilinxa Dam Reservoir
Rooikrantz Dam	resName	Rooikrantz Dam Reservoir
Lavon Dam	resName	Lavon Reservoir
Oberon Dam	resName	Lake Oberon
Tignes Dam	resName	Lac du Chevril
Jaber Dam	resName	95
Kastraki Dam	resName	Kastraki
Tumut Two Dam	resName	Tumut Two Reservoir
Deep Creek Dam	resName	Deep Creek Reservoir
Geehi Dam	resName	Geehi Reservoir
Guthega Dam	resName	Guthega Pondage
Happy Jacks Dam	resName	Happy Jacks Pondage
Khancoban Dam	resName	Khancoban Reservoir
Island Bend Dam	resName	Island Bend Pondage
Murray Two Dam	resName	Murray Two Pondage
Garzan Dam	resName	Garzan Reservoir
Sırımtaş Dam	resName	Sırımtaş Reservoir
Shamo Dam	resName	95
Bust-e gez Dam	resName	95
Jawid Dam	resName	95
Alpaslan-2 Dam	resName	Alpaslan-2 Reservoir
Yedigöze Dam	resName	Yedigöze Reservoir
Kavşak Bendi Dam	resName	Kavşak Bendi Reservoir
O'Shaughnessy Dam	resName	Hetch Hetchy Reservoir
Florence Lake Dam	resName	Florence Lake
Zosel Dam	resName	Osoyoos Lake
Potrerillos Dam	resName	Potrerillos Reservoir
Peixotos Dam	resName	Represa dos Peixotos
San Andrés de los Tacones Reservoir	resName	Embalse de Trasona
Alfilorios Reservoir	resName	Embalse de Alfilorios
Wushantou Dam	resName	Wusanto Reservoir
Peringalkuthu Dam	resName	Chalakkudi River
Lanka Sagar Dam	resName	Lanka Sagar Reservoir
Kindaruma Hydroelectric Power Station	resName	Kindaruma Lake
Rocklands Reservoir	resName	Rocklands Reservoir
Big Cliff Dam	resName	Big Cliff Lake
Kiev Hydroelectric Power Plant	resName	Kiev Reservoir
Mékinac Dam	resName	Mékinac Lake
Corin Dam	resName	Corin Reservoir
Oiticica Dam	resName	Oiticica reservoir
Elderberry Forebay Dam	resName	Elderberry Forebay
Wusanto Reservoir	resName	Wusanto Reservoir
Randenigala Dam	resName	Randenigala Reservoir
Rantembe Dam	resName	Rantembe Reservoir
Moragahakanda Dam	resName	Moragahakanda Reservoir
Kalu Ganga Dam	resName	Kalu Ganga Reservoir
Bowatenna Dam	resName	Bowetenna Reservoir
Polgolla Barrage	resName	Polgolla Reservoir
Norton Dam	resName	Norton Reservoir
Canyon Dam	resName	Canyon Reservoir
Laxapana Dam	resName	Laxapana Reservoir
Mujib Dam	resName	Mujib Reservoir
Kukule Ganga Dam	resName	Kukule Ganga Reservoir
Udawalawe Dam	resName	Udawalawe Reservoir
Kantale Dam	resName	Kantale Reservoir
Gal Oya Dam	resName	Senanayake Samudhraya
Kremenchuk Hydroelectric Power Plant	resName	Kremenchuk Reservoir
Kakhovka Hydroelectric Power Plant	resName	Kakhovka Reservoir
Dniprodzerzhynsk Hydroelectric Power Plant	resName	Dniprodzerzhynsk Reservoir
Conemaugh Dam	resName	Conemaugh River Lake
Glenmaggie Dam	resName	Lake Glenmaggie
Mantasoa Dam	resName	Lake Mantasoa
Mandraka Dam	resName	Lake Mandraka
Esch-sur-Sûre Dam	resName	Upper Sûre Lake
Yeruham Dam	resName	Lake Yeruham
Najran Valley Dam	resName	Najran Reservoir
Jizan Dam	resName	Jizan Reservoir
Petit-Saut Dam	resName	Petit-Saut Lake
Afobaka Dam	resName	Brokopondo Reservoir
Corbara Dam	resName	Lake Corbara
Yaté Dam	resName	Lake Yaté
Monasavu Dam	resName	Monasavu Reservoir
Afulilo Dam	resName	Lake Afulilo
Zaza Dam	resName	Zaza Reservoir
Hermitage Dam	resName	Hermitage Reservoir
Mancotal Dam	resName	Lake Apanás
Virgen Dam	resName	Lake Virgen
Khandip Dam	resName	Khandip Dam Reservoir
Claytor Dam	resName	Claytor Lake
Gazivoda Dam	resName	Gazivoda Lake
Marble Canyon Dam	resName	Marble Canyon Reservoir
Tisza Dam	resName	Lake Tisza
Grančarevo Dam	resName	Bileća Lake
Chilime Hydropower Plant	resName	Chilime Peaking Pond
Mojave Forks Dam	resName	Mojave River Forks Reservoir
Morena Dam	resName	Morena Reservoir
Barrett Dam	resName	Barrett Lake
Bang Lang Dam	resName	Bang Lang Reservoir
Kaeng Krachan Dam	resName	Kaeng Krachan Reservoir
Tha Thung Na Dam	resName	Tha Thung Na Reservoir
Mae Ngat Somboon Chon Dam	resName	Mae Ngat Somboon Chon Reservoir
Hantangang Dam	resName	Hantangang Reservoir
Pharping Hydropower Station	resName	Chandrajyoti Hydro-electric power station
Lianhua Dam	resName	Lianhua Reservoir
Lower Manair Dam	resName	Lower Manair Reservoir
Meander Dam	resName	Lake Huntsman
Santa Luzia Dam	resName	Santa Luzia Reservoir
Upper Manair Dam	resName	Upper Manair Reservoir
Kaddam Project	resName	Kaddam Reservoir
Sri Komaram Bheem Project	resName	Sri Komaram Bheem Reservoir
Mid Manair Dam	resName	Mid Manair Reservoir
Shanigaram Reservoir	resName	Shanigaram Reservoir
Taliperu Project	resName	Taliperu Reservoir
Wyra Reservoir	resName	Wyra Reservoir
Sugar Pine Dam	resName	Sugar Pine Reservoir
Fitzroy Falls Dam	resName	Fitzroy Falls Reservoir
Wingecarribee Dam	resName	Wingecarribee Reservoir
Casad Dam	resName	Union River Reservoir
San Dimas Dam	resName	San Dimas Reservoir
Três Irmãos Dam	resName	Três Irmãos Reservoir
Nova Avanhandava Dam	resName	Nova Avanhandava Reservoir
Tods Corner Power Station	resName	Arthurs Lake
Little Rock Dam	resName	Little Rock Reservoir
Eklutna Dam	resName	Eklutna Lake
Hivra Dam	resName	Hivra Reservoir
San Clemente Dam	resName	San Clemente Reservoir
Little Camas Dam	resName	Little Camas Reservoir
Sage Hen Dam	resName	Sage Hen Reservoir
Rogers Dam	resName	Rogers Dam Pond
Tuyamuyun Hydro Complex	resName	Channel Reservoir
Kayrakkum Dam	resName	Kayrakkum Reservoir
Tangevaerket Dam	resName	Tange Sø
Silveh Dam	resName	Silveh Reservoir
Bissorte Dam	resName	Bissorte Lake
North Dam	resName	Banks Lake
Rama Dam	resName	Rama Lake
Jablanica Dam	resName	Jablanica lake
Kherkatta Reservoir	resName	Kherkatta Reservoir
Kulekhani Dam	resName	Kulekhani Reservoir
El Salto Dam	resName	El Carpio Reservoir
John Butters Power Station	resName	Lake Burbury
Nieterana Power Station	resName	Lake King William
Somasila Dam	resName	Somasila Reservoir
Inginimitiya Dam	resName	Inginimitiya Reservoir
Kemano Generating Station	resName	Nechako Reservoir
Thotapalli Barrage	resName	Sardar Gouthu Latchanna Thotapalli Barrage
Ulu Jelai Power Station	resName	Susu reservoir
Nilambe Dam	resName	Nilambe Reservoir
Émosson Dam	resName	Lac d'Émosson
Deduru Oya Dam	resName	Deduru Oya Reservoir
Rambakan Oya Dam	resName	Rambakan Oya Reservoir
Sevan–Hrazdan Cascade	resName	Akhpara Reservoir
Vorotan Cascade	resName	Spandaryan Reservoir
Vorotan Cascade	resName	Tatev Reservoir
Gose Khurd Dam	resName	Gosikhurd
John Compton Dam	resName	Roseau Reservoir
Allatoona Dam	resName	Lake Allatoona
Pacheco Reservoir	resName	Pacheco Lake
Indravati Dam	resName	Upper Indravati
Red Bluff Diversion Dam	resName	Lake Red Bluff
Matilija Dam	resName	Matilija Reservoir
Kanjirapuzha Dam	resName	Kanjirapuzha
Búðarháls Power Plant	resName	Sporðalda Reservoir
Moccasin Dam	resName	Moccasin Reservoir
El Granero Dam	resName	El Granero Reservoir
Lago Colina Dam	resName	Lake Colina
La Boquilla Dam	resName	Toronto Lake
Sturgis Dam	resName	Sturgis Reservoir
