Solnechnogorsky District	ruName	Солнечногорский район
Kryukovo District	ruName	район Крюково
Pavlovo-Posadsky District	ruName	Павлово-Посадский район
Sergiyevo-Posadsky District	ruName	Сергиево-Посадский район
Gorodishchensky District, Volgograd Oblast	ruName	Городищенский район
Lyuberetsky District	ruName	Люберецкий район
Konstantinovsky District, Rostov Oblast	ruName	Константиновский район
Minusinsky District	ruName	Минусинский район
Nagaybaksky District	ruName	Нагайбакский район
Kovrovsky District	ruName	Ковровский район
Kolomensky District	ruName	Коломенский район
Liskinsky District	ruName	Лискинский район
Volosovsky District	ruName	Волосовский район
Bagrationovsky District	ruName	Багратионовский район
Chernyakhovsky District	ruName	Черняховский район
Krasnoznamensky District	ruName	Краснознаменский район
Nemansky District	ruName	Неманский район
Nesterovsky District	ruName	Нестеровский район
Polessky District	ruName	Полесский район
Pravdinsky District	ruName	Правдинский район
Guryevsky District, Kemerovo Oblast	ruName	Гурьевский район
Shatursky District	ruName	Шатурский район
Oktyabrsky District, Volgograd Oblast	ruName	Октябрьский район
Kamyshinsky District	ruName	Камышинский район
Andreapolsky District	ruName	Андреапольский район
Kashinsky District	ruName	Кашинский район
Ramenki District	ruName	район Раменки
Plesetsky District	ruName	Плесецкий район
Kholmogorsky District	ruName	Холмогорский район
Akhtubinsky District	ruName	Ахтубинский район
Kstovsky District	ruName	Кстовский район
Lyskovsky District	ruName	Лысковский район
Maykopsky District	ruName	Майкопский район
Ust-Yansky District	ruName	Усть-Янский улус
Priozersky District	ruName	Приозерский район
Krasnogvardeysky District, Belgorod Oblast	ruName	Красногвардейский район
Adlersky City District	ruName	Адлерский внутригородской район
Orekhovo-Borisovo Yuzhnoye District	ruName	Район Орехово-Борисово Южное
Dorogomilovo District	ruName	район Дорогомилово
Vyborgsky District, Leningrad Oblast	ruName	Выборгский район
Vsevolozhsky District	ruName	Всеволожский район
Churapchinsky District	ruName	Чурапчинский улус
Abyysky District	ruName	Абыйский улус
Allaikhovsky District	ruName	Аллаиховский улус
Aldansky District	ruName	Алданский улус
Srednekansky District	ruName	Среднеканский район
Yuryev-Polsky District	ruName	Юрьев-Польский район
Solovetsky District	ruName	Соловецкий район
Ramensky District	ruName	Раменский район
Sokolniki District	ruName	район Сокольники
Tosnensky District	ruName	Тосненский район
Nizhnekolymsky District	ruName	Нижнеколымский улус
Beryozovsky District, Khanty-Mansi Autonomous Okrug	ruName	Берёзовский район
Tatishchevsky District	ruName	Татищевский район
Gatchinsky District	ruName	Гатчинский район
Krasnensky District	ruName	Красненский район
Ongudaysky District	ruName	Онгудайский район
Amginsky District	ruName	Амгинский улус
Eveno-Bytantaysky National District	ruName	Эвено-Бытантайский национальный улус
Gorny District	ruName	Горный улус
Khangalassky District	ruName	Хангаласский улус
Lensky District, Sakha Republic	ruName	Ленский улус
Anabarsky District	ruName	Анабарский улус
Momsky District	ruName	Момский улус
Nyurbinsky District	ruName	Нюрбинский улус
Bulunsky District	ruName	Булунский улус
Suntarsky District	ruName	Сунтарский улус
Kobyaysky District	ruName	Кобяйский улус
Megino-Kangalassky District	ruName	Мегино-Кангаласский улус
Namsky District	ruName	Намский улус
Olenyoksky District	ruName	Оленёкский улус
Zhigansky District	ruName	Жиганский улус
Verkhnevilyuysky District	ruName	Верхневилюйский улус
Mirninsky District	ruName	Мирнинский улус
Olyokminsky District	ruName	Олёкминский улус
Oymyakonsky District	ruName	Оймяконский улус
Tattinsky District	ruName	Таттинский улус
Tomponsky District	ruName	Томпонский улус
Ust-Maysky District	ruName	Усть-Майский улус
Verkhnekolymsky District	ruName	Верхнеколымский улус
Verkhoyansky District	ruName	Верхоянский улус
Vilyuysky District	ruName	Вилюйский улус
Srednekolymsky District	ruName	Среднеколымский улус
Ust-Aldansky District	ruName	Усть-Алданский улус
Neryungrinsky District	ruName	Нерюнгринский улус
Kargasoksky District	ruName	Каргасокский район
Alexandrovsky District, Tomsk Oblast	ruName	Александровский район
Kuntsevo District	ruName	Кунцево
Sherbakulsky District	ruName	Шербакульский район
Sedelnikovsky District	ruName	Седельниковский район
Izmaylovo District	ruName	район Измайлово
Chaunsky District	ruName	Чаунский район
Anadyrsky District	ruName	Анадырский район
Bilibinsky District	ruName	Билибинский район
Chukotsky District	ruName	Чукотский район
Iultinsky District	ruName	Иультинский район
Providensky District	ruName	Провиденский район
Nadymsky District	ruName	Надымский район
Sukhobuzimsky District	ruName	Сухобузимский район
Ulagansky District	ruName	Улаганский район
Kosh-Agachsky District	ruName	Кош-Агачский район
Turochaksky District	ruName	Турочакский район
Ust-Koksinsky District	ruName	Усть-Коксинский район
Mayminsky District	ruName	Майминский район
Chemalsky District	ruName	Чемальский район
Choysky District	ruName	Чойский район
Ust-Kansky District	ruName	Усть-Канский район
Shebalinsky District	ruName	Шебалинский район
Babyninsky District	ruName	Бабынинский район
Yemelyanovsky District	ruName	Емельяновский район
Abansky District	ruName	Абанский район
Achinsky District	ruName	Ачинский район
Balakhtinsky District	ruName	Балахтинский район
Beryozovsky District, Krasnoyarsk Krai	ruName	Берёзовский район
Birilyussky District	ruName	Бирилюсский район
Bogotolsky District	ruName	Боготольский район
Boguchansky District	ruName	Богучанский район
Khoroshevo-Mnevniki District	ruName	район Хорошево-Мневники
Dzerzhinsky District, Krasnoyarsk Krai	ruName	Дзержинский район
Bolsheuluysky District	ruName	Большеулуйский район
Bolshemurtinsky District	ruName	Бальшемуртинский район
Evenkiysky District	ruName	Эвенкийский район
Idrinsky District	ruName	Идринский район
Ilansky District	ruName	Иланский район
Irbeysky District	ruName	Ирбейский район
Kansky District	ruName	Канский район
Karatuzsky District	ruName	Каратузский район
Kezhemsky District	ruName	Кежемский район
Kazachinsky District	ruName	Казачинский район
Kozulsky District	ruName	Козульский район
Krasnoturansky District	ruName	Краснотуранский район
Kuraginsky District	ruName	Курагинский район
Mansky District	ruName	Манский район
Motyginsky District	ruName	Мотыгинский район
Nazarovsky District	ruName	Назаровский район
Nizhneingashsky District	ruName	Нижнеингашский район
Novosyolovsky District	ruName	Новосёловский район
Partizansky District, Krasnoyarsk Krai	ruName	Партизанский район
Pirovsky District	ruName	Пировский район
Rybinsky District, Krasnoyarsk Krai	ruName	Рыбинский район
Sayansky District	ruName	Саянский район
Severo-Yeniseysky District	ruName	Северо-Енисейский район
Sharypovsky District	ruName	Шарыповский район
Taseyevsky District	ruName	Тасеевский район
Shushensky District	ruName	Шушенский район
Turukhansky District	ruName	Туруханский район
Tyukhtetsky District	ruName	Тюхтетский район
Uzhursky District	ruName	Ужурский район
Uyarsky District	ruName	Уярский район
Yeniseysky District	ruName	Енисейский район
Yermakovsky District	ruName	Ермаковский район
Zapolyarny District	ruName	Заполярный район
Azovsky Nemetsky National District	ruName	Азовский немецкий национальный район
Znamensky District, Oryol Oblast	ruName	Знаменский район
Krasninsky District, Smolensk Oblast	ruName	Краснинский район
Usolsky District, Irkutsk Oblast	ruName	Усольский район
Bokhansky District	ruName	Боханский район
Kovdorsky District	ruName	Ковдорский район
Kolsky District	ruName	Кольский район
Bezhanitsky District	ruName	Бежаницкий район
Ustyansky District	ruName	Устьянский район
Chertanovo	ruName	Чертаново
Sladkovsky District	ruName	Сладковский район
Shchukino District	ruName	район Щукино
Filyovsky park District	ruName	район Филёвский парк
Znamensky District, Tambov Oblast	ruName	Знаменский район
Vilegodsky District	ruName	Вилегодский район
Verkhnetoyemsky District	ruName	Верхнетоемский район
Velsky District	ruName	Вельский район
Shenkursky District	ruName	Шенкурский район
Nyandomsky District	ruName	Няндомский район
Brateyevo District	ruName	район Братеево
Pinezhsky District	ruName	Пинежский район
Belogorsky District	ruName	Белогорский район
Arkharinsky District	ruName	Архаринский район
Blagoveshchensky District, Amur Oblast	ruName	Благовещенский район
Petrovsk-Zabaykalsky District	ruName	Петровск-Забайкальский район
Mazanovsky District	ruName	Мазановский район
Konstantinovsky District, Amur Oblast	ruName	Константиновский район
Oktyabrsky District, Amur Oblast	ruName	Октябрьский район
Shimanovsky District	ruName	Шимановский район
Romnensky District	ruName	Ромненский район
Svobodnensky District	ruName	Свободненский район
Ivanovsky District, Amur Oblast	ruName	Ивановский район
Tyndinsky District	ruName	Тындинский район
Tambovsky District, Amur Oblast	ruName	Тамбовский район
Zeysky District	ruName	Зейский район
Primorsky District, Arkhangelsk Oblast	ruName	Приморский район
Kharabalinsky District	ruName	Харабалинский  район
Limansky District	ruName	Лиманский район
Seryshevsky District	ruName	Серышевский район
Chernoyarsky District	ruName	Черноярский район
Onezhsky District	ruName	Онежский район
Yenotayevsky District	ruName	Енотаевский район
Ikryaninsky District	ruName	Икрянинский район
Kamyzyaksky District	ruName	Камызякский район
Krasnoyarsky District, Astrakhan Oblast	ruName	Красноярский район
Volodarsky District, Astrakhan Oblast	ruName	Володарский район
Privolzhsky District, Astrakhan Oblast	ruName	Приволжский район
Grayvoronsky District	ruName	Грайворонский район
Krasnoyaruzhsky District	ruName	Краснояружский район
Borisovsky District	ruName	Борисовский район
Alexeyevsky District, Belgorod Oblast	ruName	Алексеевский район
Korochansky District	ruName	Корочанский район
Ivnyansky District	ruName	Ивнянский район
Belgorodsky District	ruName	Белгородский район
Rakityansky District	ruName	Ракитянский район
Rovensky District, Belgorod Oblast	ruName	Ровеньский район
Volokonovsky District	ruName	Волоконовский район
Valuysky District	ruName	Валуйский район
Veydelevsky District	ruName	Вейделевский район
Dubrovsky District	ruName	Дубровский район
Yakovlevsky District, Belgorod Oblast	ruName	Яковлевский район
Gordeyevsky District	ruName	Гордеевский район
Karachevsky District	ruName	Карачевский район
Brasovsky District	ruName	Брасовский район
Dyatkovsky District	ruName	Дятьковский район
Bryansky District	ruName	Брянский район
Shebekinsky District	ruName	Шебекинский район
Komarichsky District	ruName	Комаричский район
Klimovsky District	ruName	Климовский район
Krasnogorsky District, Bryansk Oblast	ruName	Красногорский район
Kletnyansky District	ruName	Клетнянский район
Mglinsky District	ruName	Мглинский район
Klintsovsky District	ruName	Клинцовский район
Pogarsky District	ruName	Погарский район
Novozybkovsky District	ruName	Новозыбковский район
Navlinsky District	ruName	Навлинский район
Sevsky District	ruName	Севский район
Pochepsky District	ruName	Почепский район
Rognedinsky District	ruName	Рогнединский район
Starodubsky District	ruName	Стародубский район
Vygonichsky District	ruName	Выгоничский район
Surazhsky District	ruName	Суражский район
Trubchevsky District	ruName	Трубчевский район
Zhiryatinsky District	ruName	Жирятинский район
Unechsky District	ruName	Унечский район
Bredinsky District	ruName	Брединский район
Kartalinsky District	ruName	Карталинский район
Zlynkovsky District	ruName	Злынковский район
Zhukovsky District, Bryansk Oblast	ruName	Жуковский район
Palekhsky District	ruName	Палехский район
Shuysky District	ruName	Шуйский район
Lukhsky District	ruName	Лухский район
Pestyakovsky District	ruName	Пестяковский район
Ilyinsky District, Ivanovo Oblast	ruName	Ильинский район
Lezhnevsky District	ruName	Лежневский район
Gavrilovo-Posadsky District	ruName	Гаврилово-Посадский район
Kineshemsky District	ruName	Кинешемский район
Ivanovsky District, Ivanovo Oblast	ruName	Ивановский район
Furmanovsky District	ruName	Фурмановский район
Tulunsky District	ruName	Тулунский район
Tayshetsky District	ruName	Тайшетский район
Slyudyansky District	ruName	Слюдянский район
Ust-Ilimsky District	ruName	Усть-Илимский район
Ust-Udinsky District	ruName	Усть-Удинский район
Kirensky District	ruName	Киренский район
Mamsko-Chuysky District	ruName	Мамско-Чуйский район
Zalarinsky District	ruName	Заларинский район
Ziminsky District	ruName	Зиминский район
Zhigalovsky District	ruName	Жигаловский район
Ust-Kutsky District	ruName	Усть-Кутский район
Kachugsky District	ruName	Качугский район
Nizhneudinsky District	ruName	Нижнеудинский район
Kazachinsko-Lensky District	ruName	Казачинско-Ленский район
Kuytunsky District	ruName	Куйтунский район
Olkhonsky District	ruName	Ольхонский район
Nizhneilimsky District	ruName	Нижнеилимский район
Shelekhovsky District	ruName	Шелеховский район
Varnensky District	ruName	Варненский район
Sosnovsky District, Chelyabinsk Oblast	ruName	Сосновский район
Satkinsky District	ruName	Саткинский район
Verkhneuralsky District	ruName	Верхнеуральский район
Bodaybinsky District	ruName	Бодайбинский район
Yetkulsky District	ruName	Еткульский район
Izhmorsky District	ruName	Ижморский район
Oktyabrsky District, Jewish Autonomous Oblast	ruName	Октябрьский район
Smidovichsky District	ruName	Смидовичский район
Belovsky District, Kemerovo Oblast	ruName	Беловский район
Chebulinsky District	ruName	Чебулинский район
Spas-Demensky District	ruName	Спас-Деменский район
Zavolzhsky District, Ivanovo Oblast	ruName	Заволжский район
Birobidzhansky District	ruName	Биробиджанский район
Leninsky District, Jewish Autonomous Oblast	ruName	Ленинский район
Obluchensky District	ruName	Облученский район
Verkhnelandekhovsky District	ruName	Верхнеландеховский район
Vichugsky District	ruName	Вичугский район
Teykovsky District	ruName	Тейковский район
Yuzhsky District	ruName	Южский район
Yuryevetsky District	ruName	Юрьевецкий район
Kizilsky District	ruName	Кизильский район
Krasnoarmeysky District, Chelyabinsk Oblast	ruName	Красноармейский район
Meshchovsky District	ruName	Мещовский район
Slavsky District	ruName	Славский район
Ashinsky District	ruName	Ашинский  район
Argayashsky District	ruName	Аргаяшский район
Kaslinsky District	ruName	Каслинский район
Chebarkulsky District	ruName	Чебаркульский район
Katav-Ivanovsky District	ruName	Катав-Ивановский район
Chesmensky District	ruName	Чесменский район
Kunashaksky District	ruName	Кунашакский район
Uvelsky District	ruName	Увельский район
Nyazepetrovsky District	ruName	Нязепетровский район
Plastovsky District	ruName	Пластовский район
Uysky District	ruName	Уйский район
Irkutsky District	ruName	Иркутский район
Cheremkhovsky District	ruName	Черемховский район
Bratsky District	ruName	Братский район
Suzemsky District	ruName	Суземский район
Agapovsky District	ruName	Агаповский район
Troitsky District, Chelyabinsk Oblast	ruName	Троицкий район
Yemanzhelinsky District	ruName	Еманжелинский район
Chunsky District	ruName	Чунский район
Korkinsky District	ruName	Коркинский район
Oktyabrsky District, Chelyabinsk Oblast	ruName	Октябрьский район
Kusinsky District	ruName	Кусинский район
Poshekhonsky District	ruName	Пошехонский район
Nekrasovsky District	ruName	Некрасовский район
Podosinovsky District	ruName	Подосиновский район
Oparinsky District	ruName	Опаринский район
Lyubimsky District	ruName	Любимский район
Rostovsky District	ruName	Ростовский район
Breytovsky District	ruName	Брейтовский район
Bolsheselsky District	ruName	Большесельский район
Borisoglebsky District, Yaroslavl Oblast	ruName	Борисоглебский район
Pereslavsky District	ruName	Переславский район
Gavrilov-Yamsky District	ruName	Гаврилов-Ямский район
Myshkinsky District	ruName	Мышкинский район
Pervomaysky District, Yaroslavl Oblast	ruName	Первомайский район
Belokholunitsky District	ruName	Белохолуницкий район
Nekouzsky District	ruName	Некоузский район
Danilovsky District, Yaroslavl Oblast	ruName	Даниловский район
Kirovo-Chepetsky District	ruName	Кирово-Чепецкий район
Arbazhsky District	ruName	Арбажский район
Bogorodsky District, Kirov Oblast	ruName	Богородский район
Kumyonsky District	ruName	Кумёнский район
Kilmezsky District	ruName	Кильмезский район
Malmyzhsky District	ruName	Малмыжский район
Luzsky District	ruName	Лузский район
Lebyazhsky District	ruName	Лебяжский район
Murashinsky District	ruName	Мурашинский район
Nemsky District	ruName	Немский район
Nolinsky District	ruName	Нолинский район
Orichevsky District	ruName	Оричевский район
Omutninsky District	ruName	Омутнинский район
Pizhansky District	ruName	Пижанский район
Sovetsky District, Kirov Oblast	ruName	Советский район
Orlovsky District, Kirov Oblast	ruName	Орловский район
Urzhumsky District	ruName	Уржумский район
Shabalinsky District	ruName	Шабалинский район
Verkhnekamsky District	ruName	Верхнекамский район
Slobodskoy District	ruName	Слободской район
Yaransky District	ruName	Яранский район
Sunsky District	ruName	Сунский район
Verkhoshizhemsky District	ruName	Верхошижемский район
Tuzhinsky District	ruName	Тужинский район
Zuyevsky District	ruName	Зуевский район
Vyatskopolyansky District	ruName	Вятскополянский район
Topkinsky District	ruName	Топкинский район
Afanasyevsky District	ruName	Афанасьевский район
Kotelnichsky District	ruName	Котельничский район
Kiknursky District	ruName	Кикнурский район
Falyonsky District	ruName	Фалёнский район
Darovskoy District	ruName	Даровской район
Rybinsky District, Yaroslavl Oblast	ruName	Рыбинский район
Galichsky District	ruName	Галичский район
Chukhlomsky District	ruName	Чухломский район
Buysky District	ruName	Буйский район
Novokuznetsky District	ruName	Новокузнецкий район
Tutayevsky District	ruName	Тутаевский район
Uglichsky District	ruName	Угличский район
Antropovsky District	ruName	Антроповский район
Kostromskoy District	ruName	Костромской район
Kadyysky District	ruName	Кадыйский район
Yaroslavsky District, Yaroslavl Oblast	ruName	Ярославский район
Krasnoselsky District, Kostroma Oblast	ruName	Красносельский район
Kologrivsky District	ruName	Кологривский район
Manturovsky District, Kostroma Oblast	ruName	Мантуровский район
Mezhevskoy District	ruName	Межевской район
Neysky District	ruName	Нейский район
Nerekhtsky District	ruName	Нерехтский район
Ostrovsky District, Kostroma Oblast	ruName	Островский район
Pavinsky District	ruName	Павинский район
Parfenyevsky District	ruName	Парфеньевский район
Oktyabrsky District, Kostroma Oblast	ruName	Октябрьский район
Pyshchugsky District	ruName	Пыщугский район
Soligalichsky District	ruName	Солигаличский район
Sudislavsky District	ruName	Судиславский район
Sharyinsky District	ruName	Шарьинский район
Susaninsky District	ruName	Сусанинский район
Vokhomsky District	ruName	Вохомский район
Ponazyrevsky District	ruName	Поназыревский район
Belozersky District, Kurgan Oblast	ruName	Белозерский район
Dalmatovsky District	ruName	Далматовский район
Shadrinsky District	ruName	Шадринский район
Tselinny District, Kurgan Oblast	ruName	Целинный район
Petukhovsky District	ruName	Петуховский район
Mishkinsky District, Kurgan Oblast	ruName	Мишкинский район
Khomutovsky District	ruName	Хомутовский район
Cheremisinovsky District	ruName	Черемисиновский район
Fatezhsky District	ruName	Фатежский район
Glushkovsky District	ruName	Глушковский район
Bolshesoldatsky District	ruName	Большесолдатский район
Korenevsky District	ruName	Кореневский район
Gorshechensky District	ruName	Горшеченский район
Dmitriyevsky District	ruName	Дмитриевский район
Belovsky District, Kursk Oblast	ruName	Беловский район
Kursky District, Kursk Oblast	ruName	Курский район
Konyshyovsky District	ruName	Конышёвский район
Kurchatovsky District, Kursk Oblast	ruName	Курчатовский район
Lgovsky District	ruName	Льговский район
Manturovsky District, Kursk Oblast	ruName	Мантуровский район
Oktyabrsky District, Kursk Oblast	ruName	Октябрьский район
Medvensky District	ruName	Медвенский район
Oboyansky District	ruName	Обоянский район
Ponyrovsky District	ruName	Поныровский район
Shchigrovsky District	ruName	Щигровский район
Pristensky District	ruName	Пристенский район
Timsky District	ruName	Тимский район
Solntsevsky District	ruName	Солнцевский район
Rylsky District	ruName	Рыльский район
Sovetsky District, Kursk Oblast	ruName	Советский район
Sudzhansky District	ruName	Суджанский район
Zolotukhinsky District	ruName	Золотухинский район
Kirishsky District	ruName	Киришский район
Zheleznogorsky District	ruName	Железногорский район
Kirovsky District, Leningrad Oblast	ruName	Кировский район
Kingiseppsky District	ruName	Кингисеппский район
Lomonosovsky District, Leningrad Oblast	ruName	Ломоносовский район
Lodeynopolsky District	ruName	Лодейнопольский район
Podporozhsky District	ruName	Подпорожский район
Luzhsky District	ruName	Лужский район
Tikhvinsky District	ruName	Тихвинский район
Slantsevsky District	ruName	Сланцевский район
Chaplyginsky District	ruName	Чаплыгинский район
Volkhovsky District	ruName	Волховский район
Dobrinsky District	ruName	Добринский район
Dobrovsky District	ruName	Добровский район
Gryazinsky District	ruName	Грязинский район
Khlevensky District	ruName	Хлевенский район
Izmalkovsky District	ruName	Измалковский район
Dolgorukovsky District	ruName	Долгоруковский район
Krasninsky District, Lipetsk Oblast	ruName	Краснинский район
Stanovlyansky District	ruName	Становлянский район
Lipetsky District	ruName	Липецкий район
Lebedyansky District	ruName	Лебедянский район
Terbunsky District	ruName	Тербунский район
Lev-Tolstovsky District	ruName	Лев-Толстовский район
Yeletsky District	ruName	Елецкий район
Usmansky District	ruName	Усманский район
Volovsky District, Lipetsk Oblast	ruName	Воловский район
Omsukchansky District	ruName	Омсукчанский район
Olsky District	ruName	Ольский район
Khasynsky District	ruName	Хасынский район
Zadonsky District	ruName	Задонский район
Tenkinsky District	ruName	Тенькинский район
Dankovsky District	ruName	Данковский район
Yagodninsky District	ruName	Ягоднинский район
Severo-Evensky District	ruName	Северо-Эвенский район
Kashirsky District, Moscow Oblast	ruName	Каширский район
Dmitrovsky District, Moscow Oblast	ruName	Дмитровский район
Chekhovsky District	ruName	Чеховский район
Leninsky District, Moscow Oblast	ruName	Ленинский район
Istrinsky District	ruName	Истринский район
Lukhovitsky District	ruName	Луховицкий район
Krasnogorsky District, Moscow Oblast	ruName	Красногорский район
Lotoshinsky District	ruName	Лотошинский район
Ozyorsky District, Moscow Oblast	ruName	Озёрский район
Mytishchinsky District	ruName	Мытищинский район
Naro-Fominsky District	ruName	Наро-Фоминский район
Orekhovo-Zuyevsky District	ruName	Орехово-Зуевский район
Noginsky District	ruName	Ногинский район
Klinsky District	ruName	Клинский район
Mozhaysky District, Moscow Oblast	ruName	Можайский район
Serebryano-Prudsky District	ruName	Серебряно-Прудский район
Shakhovskoy District	ruName	Шаховской район
Ruzsky District	ruName	Рузский район
Podolsky District	ruName	Подольский район
Pushkinsky District, Moscow Oblast	ruName	Пушкинский район
Shchyolkovsky District	ruName	Щёлковский район
Odintsovsky District	ruName	Одинцовский район
Serpukhovsky District	ruName	Серпуховский район
Stupinsky District	ruName	Ступинский район
Zaraysky District	ruName	Зарайский район
Taldomsky District	ruName	Талдомский район
Yegoryevsky District, Moscow Oblast	ruName	Егорьевский район
Ardatovsky District, Nizhny Novgorod Oblast	ruName	Ардатовский район
Voskresensky District, Moscow Oblast	ruName	Воскресенский район
Volokolamsky District	ruName	Волоколамский район
Arzamassky District	ruName	Арзамасский район
Balakhninsky District	ruName	Балахнинский район
Bolsheboldinsky District	ruName	Большеболдинский район
Buturlinsky District	ruName	Бутурлинский район
Bogorodsky District, Nizhny Novgorod Oblast	ruName	Богородский район
Chkalovsky District, Nizhny Novgorod Oblast	ruName	Чкаловский район
Bolshemurashkinsky District	ruName	Большемурашкинский район
Diveyevsky District	ruName	Дивеевский район
Gaginsky District	ruName	Гагинский район
Knyagininsky District	ruName	Княгининский район
Sechenovsky District	ruName	Сеченовский район
Gorodetsky District	ruName	Городецкий район
Krasnobakovsky District	ruName	Краснобаковский район
Dalnekonstantinovsky District	ruName	Дальнеконстантиновский район
Kulebaksky District	ruName	Кулебакский район
Pochinkovsky District, Nizhny Novgorod Oblast	ruName	Починковский район
Krasnooktyabrsky District, Nizhny Novgorod Oblast	ruName	Краснооктябрьский район
Pilninsky District	ruName	Пильнинский район
Lukoyanovsky District	ruName	Лукояновский район
Koverninsky District	ruName	Ковернинский район
Sergachsky District	ruName	Сергачский район
Navashinsky District	ruName	Навашинский район
Pavlovsky District, Nizhny Novgorod Oblast	ruName	Павловский район
Sosnovsky District, Nizhny Novgorod Oblast	ruName	Сосновский район
Shatkovsky District	ruName	Шатковский район
Perevozsky District	ruName	Перевозский район
Sokolsky District, Nizhny Novgorod Oblast	ruName	Сокольский район
Vadsky District	ruName	Вадский район
Spassky District, Nizhny Novgorod Oblast	ruName	Спасский район
Urensky District	ruName	Уренский район
Sharangsky District	ruName	Шарангский район
Vachsky District	ruName	Вачский район
Tonkinsky District	ruName	Тонкинский район
Varnavinsky District	ruName	Варнавинский район
Tonshayevsky District	ruName	Тоншаевский район
Vetluzhsky District	ruName	Ветлужский район
Volodarsky District, Nizhny Novgorod Oblast	ruName	Володарский район
Voskresensky District, Nizhny Novgorod Oblast	ruName	Воскресенский район
Vorotynsky District	ruName	Воротынский район
Voznesensky District	ruName	Вознесенский район
Bagansky District	ruName	Баганский район
Chistoozyorny District	ruName	Чистоозёрный район
Barabinsky District	ruName	Барабинский  район
Chulymsky District	ruName	Чулымский район
Karasuksky District	ruName	Карасукский район
Iskitimsky District	ruName	Искитимский район
Cherepanovsky District	ruName	Черепановский район
Dovolensky District	ruName	Доволенский район
Kargatsky District	ruName	Каргатский район
Kochkovsky District	ruName	Кочковский район
Kochenyovsky District	ruName	Коченёвский район
Kolyvansky District	ruName	Колыванский район
Kupinsky District	ruName	Купинский район
Chanovsky District	ruName	Чановский район
Kuybyshevsky District, Novosibirsk Oblast	ruName	Куйбышевский район
Krasnozyorsky District	ruName	Краснозёрский район
Ordynsky District	ruName	Ордынский район
Moshkovsky District	ruName	Мошковский район
Bolotninsky District	ruName	Болотнинский район
Maslyaninsky District	ruName	Маслянинский район
Ust-Tarksky District	ruName	Усть-Таркский район
Ubinsky District	ruName	Убинский район
Tatarsky District	ruName	Татарский район
Novosibirsky District	ruName	Новосибирский район
Suzunsky District	ruName	Сузунский район
Toguchinsky District	ruName	Тогучинский район
Kyshtovsky District	ruName	Кыштовский район
Vengerovsky District	ruName	Венгеровский район
Zdvinsky District	ruName	Здвинский район
Severny District, Novosibirsk Oblast	ruName	Северный район
Bolsheukovsky District	ruName	Большеуковский район
Isilkulsky District	ruName	Исилькульский район
Gorkovsky District	ruName	Горьковский район
Bolsherechensky District	ruName	Большереченский район
Cherlaksky District	ruName	Черлакский район
Kalachinsky District	ruName	Калачинский район
Kolosovsky District	ruName	Колосовский район
Lyubinsky District	ruName	Любинский район
Krutinsky District	ruName	Крутинский район
Muromtsevsky District	ruName	Муромцевский район
Nazyvayevsky District	ruName	Называевский район
Odessky District	ruName	Одесский район
Kormilovsky District	ruName	Кормиловский район
Moskalensky District	ruName	Москаленский район
Maryanovsky District	ruName	Марьяновский район
Omsky District	ruName	Омский район
Poltavsky District	ruName	Полтавский район
Nizhneomsky District	ruName	Нижнеомский район
Russko-Polyansky District	ruName	Русско-Полянский район
Pavlogradsky District	ruName	Павлоградский район
Okoneshnikovsky District	ruName	Оконешниковский район
Novovarshavsky District	ruName	Нововаршавский район
Sargatsky District	ruName	Саргатский район
Tyukalinsky District	ruName	Тюкалинский район
Znamensky District, Omsk Oblast	ruName	Знаменский район
Tarsky District	ruName	Тарский район
Tavrichesky District	ruName	Таврический район
Asekeyevsky District	ruName	Асекеевский район
Tevrizsky District	ruName	Тевризский район
Akbulaksky District	ruName	Акбулакский район
Alexandrovsky District, Orenburg Oblast	ruName	Александровский район
Buzuluksky District	ruName	Бузулукский район
Ust-Ishimsky District	ruName	Усть-Ишимский район
Grachyovsky District, Orenburg Oblast	ruName	Грачёвский район
Adamovsky District	ruName	Адамовский район
Abdulinsky District	ruName	Абдулинский район
Dombarovsky District	ruName	Домбаровский район
Buguruslansky District	ruName	Бугурусланский район
Belyayevsky District	ruName	Беляевский район
Gaysky District	ruName	Гайский район
Kvarkensky District	ruName	Кваркенский район
Kuvandyksky District	ruName	Кувандыкский район
Kurmanayevsky District	ruName	Курманаевский район
Matveyevsky District	ruName	Матвеевский район
Ileksky District	ruName	Илекский район
Krasnogvardeysky District, Orenburg Oblast	ruName	Красногвардейский район
Novoorsky District	ruName	Новоорский район
Oktyabrsky District, Orenburg Oblast	ruName	Октябрьский район
Perevolotsky District	ruName	Переволоцкий район
Orenburgsky District	ruName	Оренбургский район
Novosergiyevsky District	ruName	Новосергиевский район
Pervomaysky District, Orenburg Oblast	ruName	Первомайский район
Ponomaryovsky District	ruName	Пономарёвский район
Sharlyksky District	ruName	Шарлыкский район
Sol-Iletsky District	ruName	Соль-Илецкий район
Sakmarsky District	ruName	Сакмарский район
Saraktashsky District	ruName	Саракташский район
Severny District, Orenburg Oblast	ruName	Северный район
Sorochinsky District	ruName	Сорочинский район
Tashlinsky District	ruName	Ташлинский район
Svetlinsky District	ruName	Светлинский район
Totsky District	ruName	Тоцкий район
Tyulgansky District	ruName	Тюльганский район
Dolzhansky District	ruName	Должанский район
Glazunovsky District	ruName	Глазуновский район
Khotynetsky District	ruName	Хотынецкий район
Maloserdobinsky District	ruName	Малосердобинский район
Narovchatsky District	ruName	Наровчатский район
Mokshansky District	ruName	Мокшанский район
Lopatinsky District	ruName	Лопатинский район
Kuznetsky District, Penza Oblast	ruName	Кузнецкий район
Luninsky District	ruName	Лунинский район
Kolyshleysky District	ruName	Колышлейский район
Kameshkirsky District	ruName	Камешкирский район
Kamensky District, Penza Oblast	ruName	Каменский район
Issinsky District	ruName	Иссинский район
Bessonovsky District	ruName	Бессоновский район
Gorodishchensky District, Penza Oblast	ruName	Городищенский район
Bekovsky District	ruName	Бековский район
Belinsky District	ruName	Белинский район
Uritsky District	ruName	Урицкий район
Bashmakovsky District	ruName	Башмаковский район
Zalegoshchensky District	ruName	Залегощенский район
Verkhovsky District	ruName	Верховский район
Trosnyansky District	ruName	Троснянский район
Pokrovsky District	ruName	Покровский район
Soskovsky District	ruName	Сосковский район
Sverdlovsky District, Oryol Oblast	ruName	Свердловский район
Krasnozorensky District	ruName	Краснозоренский район
Novoderevenkovsky District	ruName	Новодеревеньковский район
Shablykinsky District	ruName	Шаблыкинский район
Novosilsky District	ruName	Новосильский район
Orlovsky District, Oryol Oblast	ruName	Орловский район
Maloarkhangelsky District	ruName	Малоархангельский район
Mtsensky District	ruName	Мценский район
Kromskoy District	ruName	Кромской район
Livensky District	ruName	Ливенский район
Korsakovsky District, Oryol Oblast	ruName	Корсаковский район
Kolpnyansky District	ruName	Колпнянский район
Bolkhovsky District	ruName	Болховский район
Dmitrovsky District, Oryol Oblast	ruName	Дмитровский район
Yasnensky District	ruName	Ясненский район
Neverkinsky District	ruName	Неверкинский район
Nizhnelomovsky District	ruName	Нижнеломовский район
Pachelmsky District	ruName	Пачелмский район
Vadinsky District	ruName	Вадинский район
Dedovichsky District	ruName	Дедовичский район
Shemysheysky District	ruName	Шемышейский район
Nikolsky District, Penza Oblast	ruName	Никольский район
Zemetchinsky District	ruName	Земетчинский район
Penzensky District	ruName	Пензенский район
Tamalinsky District	ruName	Тамалинский район
Gdovsky District	ruName	Гдовский район
Spassky District, Penza Oblast	ruName	Спасский район
Dnovsky District	ruName	Дновский район
Krasnogorodsky District	ruName	Красногородский район
Serdobsky District	ruName	Сердобский район
Kunyinsky District	ruName	Куньинский район
Loknyansky District	ruName	Локнянский район
Sosnovoborsky District	ruName	Сосновоборский район
Novorzhevsky District	ruName	Новоржевский район
Opochetsky District	ruName	Опочецкий район
Nevelsky District, Pskov Oblast	ruName	Невельский район
Palkinsky District	ruName	Палкинский район
Novosokolnichesky District	ruName	Новосокольнический район
Ostrovsky District, Pskov Oblast	ruName	Островский район
Pechorsky District	ruName	Печорский район
Porkhovsky District	ruName	Порховский район
Pskovsky District	ruName	Псковский район
Pushkinogorsky District	ruName	Пушкиногорский район
Pytalovsky District	ruName	Пыталовский район
Sebezhsky District	ruName	Себежский район
Pustoshkinsky District	ruName	Пустошкинский район
Usvyatsky District	ruName	Усвятский район
Velikoluksky District	ruName	Великолукский район
Aksaysky District	ruName	Аксайский район
Bagayevsky District	ruName	Багаевский район
Kagalnitsky District	ruName	Кагальницкий район
Krasnosulinsky District	ruName	Красносулинский район
Bokovsky District	ruName	Боковский район
Azovsky District	ruName	Азовский район
Belokalitvinsky District	ruName	Белокалитвинский район
Matveyevo-Kurgansky District	ruName	Матвеево-Курганский район
Kamensky District, Rostov Oblast	ruName	Каменский  район
Kuybyshevsky District, Rostov Oblast	ruName	Куйбышевский район
Dubovsky District, Rostov Oblast	ruName	Дубовский район
Martynovsky District	ruName	Мартыновский район
Myasnikovsky District	ruName	Мясниковский район
Kasharsky District	ruName	Кашарский район
Chertkovsky District	ruName	Чертковский район
Milyutinsky District	ruName	Милютинский район
Millerovsky District	ruName	Миллеровский район
Neklinovsky District	ruName	Неклиновский район
Morozovsky District	ruName	Морозовский район
Oblivsky District	ruName	Обливский район
Orlovsky District, Rostov Oblast	ruName	Орловский район
Salsky District	ruName	Сальский район
Remontnensky District	ruName	Ремонтненский район
Oktyabrsky District, Rostov Oblast	ruName	Октябрьский район
Proletarsky District, Rostov Oblast	ruName	Пролетарский район
Tatsinsky District	ruName	Тацинский район
Semikarakorsky District	ruName	Семикаракорский район
Rodionovo-Nesvetaysky District	ruName	Родионово-Несветайский район
Sovetsky District, Rostov Oblast	ruName	Советский район
Sholokhovsky District	ruName	Шолоховский район
Tselinsky District	ruName	Целинский район
Peschanokopsky District	ruName	Песчанокопский район
Tarasovsky District	ruName	Тарасовский район
Tsimlyansky District	ruName	Цимлянский район
Verkhnedonskoy District	ruName	Верхнедонской район
Vesyolovsky District	ruName	Весёловский район
Zavetinsky District	ruName	Заветинский район
Yegorlyksky District	ruName	Егорлыкский район
Volgodonskoy District	ruName	Волгодонской район
Zernogradsky District	ruName	Зерноградский район
Ust-Donetsky District	ruName	Усть-Донецкий район
Chuchkovsky District	ruName	Чучковский район
Kadomsky District	ruName	Кадомский район
Zimovnikovsky District	ruName	Зимовниковский район
Kasimovsky District	ruName	Касимовский район
Korablinsky District	ruName	Кораблинский район
Klepikovsky District	ruName	Клепиковский район
Miloslavsky District	ruName	Милославский район
Alexandro-Nevsky District	ruName	Александро-Невский район
Mikhaylovsky District, Ryazan Oblast	ruName	Михайловский район
Pitelinsky District	ruName	Пителинский район
Ryazansky District, Ryazan Oblast	ruName	Рязанский район
Putyatinsky District	ruName	Путятинский район
Pronsky District	ruName	Пронский район
Shatsky District	ruName	Шацкий район
Sapozhkovsky District	ruName	Сапожковский район
Sasovsky District	ruName	Сасовский район
Ryazhsky District	ruName	Ряжский район
Rybnovsky District	ruName	Рыбновский район
Skopinsky District	ruName	Скопинский район
Ukholovsky District	ruName	Ухоловский район
Sarayevsky District	ruName	Сараевский район
Shilovsky District	ruName	Шиловский район
Starozhilovsky District	ruName	Старожиловский район
Zakharovsky District	ruName	Захаровский район
Yermishinsky District	ruName	Ермишинский район
Spassky District, Ryazan Oblast	ruName	Спасский район
Krasnoarmeysky District, Samara Oblast	ruName	Красноармейский район
Koshkinsky District	ruName	Кошкинский район
Kamyshlinsky District	ruName	Камышлинский район
Bolsheglushitsky District	ruName	Большеглушицкий район
Alexeyevsky District, Samara Oblast	ruName	Алексеевский район
Bogatovsky District	ruName	Богатовский район
Pokhvistnevsky District	ruName	Похвистневский район
Pestravsky District	ruName	Пестравский район
Khvorostyansky District	ruName	Хворостянский район
Bezenchuksky District	ruName	Безенчукский район
Isaklinsky District	ruName	Исаклинский район
Kinel-Cherkassky District	ruName	Кинель-Черкасский район
Neftegorsky District	ruName	Нефтегорский район
Borsky District, Samara Oblast	ruName	Борский район
Bolshechernigovsky District	ruName	Большечерниговский район
Klyavlinsky District	ruName	Клявлинский район
Chelno-Vershinsky District	ruName	Челно-Вершинский район
Kinelsky District	ruName	Кинельский район
Stavropolsky District	ruName	Ставропольский район
Krasnoyarsky District, Samara Oblast	ruName	Красноярский район
Privolzhsky District, Samara Oblast	ruName	Приволжский район
Shentalinsky District	ruName	Шенталинский район
Sergiyevsky District	ruName	Сергиевский район
Shigonsky District	ruName	Шигонский район
Syzransky District	ruName	Сызранский район
Alexandrovo-Gaysky District	ruName	Александрово-Гайский район
Volzhsky District, Samara Oblast	ruName	Волжский район
Yelkhovsky District	ruName	Елховский район
Atkarsky District	ruName	Аткарский район
Arkadaksky District	ruName	Аркадакский район
Balakovsky District	ruName	Балаковский район
Balashovsky District	ruName	Балашовский район
Dergachyovsky District	ruName	Дергачёвский район
Dukhovnitsky District	ruName	Духовницкий район
Baltaysky District	ruName	Балтайский район
Fyodorovsky District, Saratov Oblast	ruName	Фёдоровский район
Kalininsky District, Saratov Oblast	ruName	Калининский район
Khvalynsky District	ruName	Хвалынский район
Bazarno-Karabulaksky District	ruName	Базарно-Карабулакский район
Engelssky District	ruName	Энгельсский район
Krasnoarmeysky District, Saratov Oblast	ruName	Красноармейский район
Ivanteyevsky District	ruName	Ивантеевский район
Krasnokutsky District	ruName	Краснокутский район
Ozinsky District	ruName	Озинский район
Marksovsky District	ruName	Марксовский район
Novouzensky District	ruName	Новоузенский район
Novoburassky District	ruName	Новобурасский район
Lysogorsky District	ruName	Лысогорский район
Krasnopartizansky District	ruName	Краснопартизанский район
Petrovsky District, Saratov Oblast	ruName	Петровский район
Pitersky District	ruName	Питерский район
Pugachyovsky District	ruName	Пугачёвский район
Perelyubsky District	ruName	Перелюбский район
Rtishchevsky District	ruName	Ртищевский район
Rovensky District, Saratov Oblast	ruName	Ровенский район
Romanovsky District, Saratov Oblast	ruName	Романовский район
Saratovsky District	ruName	Саратовский район
Samoylovsky District	ruName	Самойловский район
Voskresensky District, Saratov Oblast	ruName	Воскресенский район
Sovetsky District, Saratov Oblast	ruName	Советский район
Volsky District	ruName	Вольский район
Yekaterinovsky District	ruName	Екатериновский район
Turkovsky District	ruName	Турковский район
Yershovsky District	ruName	Ершовский район
Glinkovsky District	ruName	Глинковский район
Gagarinsky District, Smolensk Oblast	ruName	Гагаринский район
Dorogobuzhsky District	ruName	Дорогобужский район
Khislavichsky District	ruName	Хиславичский район
Dukhovshchinsky District	ruName	Духовщинский район
Demidovsky District	ruName	Демидовский район
Kardymovsky District	ruName	Кардымовский район
Novoduginsky District	ruName	Новодугинский район
Roslavlsky District	ruName	Рославльский район
Pochinkovsky District, Smolensk Oblast	ruName	Починковский район
Shumyachsky District	ruName	Шумячский район
Safonovsky District	ruName	Сафоновский район
Monastyrshchinsky District	ruName	Монастырщинский район
Rudnyansky District, Smolensk Oblast	ruName	Руднянский район
Tyomkinsky District	ruName	Тёмкинский район
Ugransky District	ruName	Угранский район
Kholm-Zhirkovsky District	ruName	Холм-Жирковский район
Yartsevsky District	ruName	Ярцевский район
Sychyovsky District	ruName	Сычёвский район
Velizhsky District	ruName	Велижский район
Smolensky District, Smolensk Oblast	ruName	Смоленский район
Vyazemsky District, Smolensk Oblast	ruName	Вяземский район
Yershichsky District	ruName	Ершичский район
Yelninsky District	ruName	Ельнинский район
Artyomovsky District	ruName	Артёмовский район
Bogdanovichsky District	ruName	Богдановичский район
Garinsky District	ruName	Гаринский район
Baykalovsky District	ruName	Байкаловский район
Alapayevsky District	ruName	Алапаевский район
Achitsky District	ruName	Ачитский район
Kamensky District, Sverdlovsk Oblast	ruName	Каменский район
Irbitsky District	ruName	Ирбитский район
Beloyarsky District, Sverdlovsk Oblast	ruName	Белоярский район
Artinsky District	ruName	Артинский район
Krasnoufimsky District	ruName	Красноуфимский район
Kamyshlovsky District	ruName	Камышловский район
Novolyalinsky District	ruName	Новолялинский район
Nizhneserginsky District	ruName	Нижнесергинский район
Nevyansky District	ruName	Невьянский район
Serovsky District	ruName	Серовский район
Rezhevsky District	ruName	Режевский район
Pyshminsky District	ruName	Пышминский район
Sukholozhsky District	ruName	Сухоложский район
Prigorodny District, Sverdlovsk Oblast	ruName	Пригородный район
Tavdinsky District	ruName	Тавдинский район
Taborinsky District	ruName	Таборинский район
Turinsky District	ruName	Туринский район
Slobodo-Turinsky District	ruName	Слободо-Туринский район
Sysertsky District	ruName	Сысертский район
Shalinsky District, Sverdlovsk Oblast	ruName	Шалинский район
Verkhotursky District	ruName	Верхотурский район
Tugulymsky District	ruName	Тугулымский район
Bondarsky District	ruName	Бондарский район
Gavrilovsky District	ruName	Гавриловский район
Verkhnesaldinsky District	ruName	Верхнесалдинский район
Inzhavinsky District	ruName	Инжавинский район
Talitsky District	ruName	Талицкий район
Michurinsky District	ruName	Мичуринский район
Kirsanovsky District	ruName	Кирсановский район
Mordovsky District	ruName	Мордовский район
Pichayevsky District	ruName	Пичаевский район
Pervomaysky District, Tambov Oblast	ruName	Первомайский район
Petrovsky District, Tambov Oblast	ruName	Петровский район
Morshansky District	ruName	Моршанский район
Muchkapsky District	ruName	Мучкапский район
Rzhaksinsky District	ruName	Ржаксинский район
Sampursky District	ruName	Сампурский район
Rasskazovsky District	ruName	Рассказовский район
Tokaryovsky District	ruName	Токарёвский район
Uvarovsky District	ruName	Уваровский район
Umyotsky District	ruName	Умётский район
Tambovsky District, Tambov Oblast	ruName	Тамбовский район
Bakcharsky District	ruName	Бакчарский район
Kolpashevsky District	ruName	Колпашевский район
Sosnovsky District, Tambov Oblast	ruName	Сосновский район
Asinovsky District	ruName	Асиновский район
Staroyuryevsky District	ruName	Староюрьевский район
Chainsky District	ruName	Чаинский район
Zherdevsky District	ruName	Жердевский район
Nikiforovsky District	ruName	Никифоровский район
Krivosheinsky District	ruName	Кривошеинский район
Parabelsky District	ruName	Парабельский район
Shegarsky District	ruName	Шегарский район
Teguldetsky District	ruName	Тегульдетский район
Verkhneketsky District	ruName	Верхнекетский район
Zyryansky District	ruName	Зырянский район
Tomsky District	ruName	Томский район
Kamensky District, Tula Oblast	ruName	Каменский район
Pervomaysky District, Tomsk Oblast	ruName	Первомайский район
Bogoroditsky District	ruName	Богородицкий район
Chernsky District	ruName	Чернский район
Dubensky District, Tula Oblast	ruName	Дубенский район
Kimovsky District	ruName	Кимовский район
Kurkinsky District	ruName	Куркинский район
Kozhevnikovsky District	ruName	Кожевниковский район
Aleksinsky District	ruName	Алексинский район
Belyovsky District	ruName	Белёвский район
Plavsky District	ruName	Плавский район
Kireyevsky District	ruName	Киреевский район
Odoyevsky District	ruName	Одоевский район
Leninsky District, Tula Oblast	ruName	Ленинский район
Molchanovsky District	ruName	Молчановский район
Tyoplo-Ogaryovsky District	ruName	Тёпло-Огарёвский район
Uzlovsky District	ruName	Узловский район
Novomoskovsky District	ruName	Новомосковский район
Shchyokinsky District	ruName	Щёкинский район
Yasnogorsky District	ruName	Ясногорский район
Suvorovsky District	ruName	Суворовский район
Belsky District, Tver Oblast	ruName	Бельский район
Yefremovsky District	ruName	Ефремовский район
Zaoksky District	ruName	Заокский район
Volovsky District, Tula Oblast	ruName	Воловский район
Arsenyevsky District	ruName	Арсеньевский район
Venyovsky District	ruName	Венёвский район
Bezhetsky District	ruName	Бежецкий район
Bologovsky District	ruName	Бологовский район
Kalyazinsky District	ruName	Калязинский район
Firovsky District	ruName	Фировский район
Lesnoy District	ruName	Лесной район
Kuvshinovsky District	ruName	Кувшиновский район
Kalininsky District, Tver Oblast	ruName	Калининский район
Kimrsky District	ruName	Кимрский район
Molokovsky District	ruName	Молоковский район
Kesovogorsky District	ruName	Кесовогорский район
Krasnokholmsky District	ruName	Краснохолмский район
Konakovsky District	ruName	Конаковский район
Maksatikhinsky District	ruName	Максатихинский район
Nelidovsky District	ruName	Нелидовский район
Oleninsky District	ruName	Оленинский район
Likhoslavlsky District	ruName	Лихославльский район
Rzhevsky District	ruName	Ржевский район
Rameshkovsky District	ruName	Рамешковский район
Ostashkovsky District	ruName	Осташковский район
Selizharovsky District	ruName	Селижаровский район
Penovsky District	ruName	Пеновский район
Sandovsky District	ruName	Сандовский район
Sonkovsky District	ruName	Сонковский район
Toropetsky District	ruName	Торопецкий район
Spirovsky District	ruName	Спировский район
Staritsky District	ruName	Старицкий район
Torzhoksky District	ruName	Торжокский район
Udomelsky District	ruName	Удомельский район
Abatsky District	ruName	Абатский район
Zharkovsky District	ruName	Жарковский район
Zubtsovsky District	ruName	Зубцовский район
Zapadnodvinsky District	ruName	Западнодвинский район
Aromashevsky District	ruName	Аромашевский район
Vesyegonsky District	ruName	Весьегонский район
Armizonsky District	ruName	Армизонский район
Vyshnevolotsky District	ruName	Вышневолоцкий район
Golyshmanovsky District	ruName	Голышмановский район
Berdyuzhsky District	ruName	Бердюжский район
Isetsky District	ruName	Исетский район
Nizhnetavdinsky District	ruName	Нижнетавдинский район
Ishimsky District	ruName	Ишимский район
Kazansky District	ruName	Казанский район
Uporovsky District	ruName	Упоровский район
Yalutorovsky District	ruName	Ялуторовский район
Tobolsky District	ruName	Тобольский район
Omutinsky District	ruName	Омутинский район
Vikulovsky District	ruName	Викуловский район
Tyumensky District	ruName	Тюменский район
Uvatsky District	ruName	Уватский район
Sorokinsky District	ruName	Сорокинский район
Vagaysky District	ruName	Вагайский район
Zavodoukovsky District	ruName	Заводоуковский район
Yarkovsky District	ruName	Ярковский район
Yurginsky District, Tyumen Oblast	ruName	Юргинский район
Cherdaklinsky District	ruName	Чердаклинский район
Baryshsky District	ruName	Барышский район
Inzensky District	ruName	Инзенский район
Maynsky District	ruName	Майнский район
Melekessky District	ruName	Мелекесский район
Kuzovatovsky District	ruName	Кузоватовский район
Novomalyklinsky District	ruName	Новомалыклинский район
Bazarnosyzgansky District	ruName	Базарносызганский район
Karsunsky District	ruName	Карсунский район
Radishchevsky District	ruName	Радищевский район
Nikolayevsky District, Ulyanovsk Oblast	ruName	Николаевский район
Novospassky District	ruName	Новоспасский район
Pavlovsky District, Ulyanovsk Oblast	ruName	Павловский район
Sengileyevsky District	ruName	Сенгилеевский район
Tsilninsky District	ruName	Цильнинский район
Starokulatkinsky District	ruName	Старокулаткинский район
Sursky District	ruName	Сурский район
Terengulsky District	ruName	Тереньгульский район
Staromaynsky District	ruName	Старомайнский район
Veshkaymsky District	ruName	Вешкаймский район
Ulyanovsky District, Ulyanovsk Oblast	ruName	Ульяновский район
Muromsky District	ruName	Муромский район
Kolchuginsky District	ruName	Кольчугинский район
Melenkovsky District	ruName	Меленковский район
Kumylzhensky District	ruName	Кумылженский район
Kalachyovsky District	ruName	Калачёвский район
Kotelnikovsky District	ruName	Котельниковский район
Kotovsky District	ruName	Котовский район
Dubovsky District, Volgograd Oblast	ruName	Дубовский район
Ilovlinsky District	ruName	Иловлинский район
Kletsky District	ruName	Клетский район
Chernyshkovsky District	ruName	Чернышковский район
Danilovsky District, Volgograd Oblast	ruName	Даниловский район
Kikvidzensky District	ruName	Киквидзенский район
Frolovsky District	ruName	Фроловский район
Bykovsky District	ruName	Быковский район
Alexeyevsky District, Volgograd Oblast	ruName	Алексеевский район
Vyaznikovsky District	ruName	Вязниковский район
Suzdalsky District	ruName	Суздальский район
Selivanovsky District	ruName	Селивановский район
Sobinsky District	ruName	Собинский район
Sudogodsky District	ruName	Судогодский район
Gus-Khrustalny District	ruName	Гусь-Хрустальный район
Petushinsky District	ruName	Петушинский район
Kameshkovsky District	ruName	Камешковский район
Kirzhachsky District	ruName	Киржачский район
Leninsky District, Volgograd Oblast	ruName	Ленинский район
Olkhovsky District	ruName	Ольховский район
Mikhaylovsky District, Volgograd Oblast	ruName	Михайловский район
Novoanninsky District	ruName	Новоаннинский район
Rudnyansky District, Volgograd Oblast	ruName	Руднянский район
Nikolayevsky District, Volgograd Oblast	ruName	Николаевский район
Serafimovichsky District	ruName	Серафимовичский район
Nekhayevsky District	ruName	Нехаевский район
Staropoltavsky District	ruName	Старополтавский район
Pallasovsky District	ruName	Палласовский район
Sredneakhtubinsky District	ruName	Среднеахтубинский район
Surovikinsky District	ruName	Суровикинский район
Svetloyarsky District	ruName	Светлоярский район
Uryupinsky District	ruName	Урюпинский район
Yelansky District	ruName	Еланский район
Zhirnovsky District	ruName	Жирновский район
Anninsky District	ruName	Аннинский район
Kalacheyevsky District	ruName	Калачеевский район
Bobrovsky District	ruName	Бобровский район
Ertilsky District	ruName	Эртильский район
Kashirsky District, Voronezh Oblast	ruName	Каширский район
Kamensky District, Voronezh Oblast	ruName	Каменский район
Kantemirovsky District	ruName	Кантемировский район
Bogucharsky District	ruName	Богучарский район
Khokholsky District	ruName	Хохольский район
Buturlinovsky District	ruName	Бутурлиновский район
Nizhnedevitsky District	ruName	Нижнедевицкий район
Novokhopyorsky District	ruName	Новохопёрский район
Novousmansky District	ruName	Новоусманский район
Ostrogozhsky District	ruName	Острогожский район
Talovsky District	ruName	Таловский район
Olkhovatsky District	ruName	Ольховатский район
Povorinsky District	ruName	Поворинский район
Repyovsky District	ruName	Репьёвский район
Gribanovsky District	ruName	Грибановский район
Petropavlovsky District, Voronezh Oblast	ruName	Петропавловский район
Rossoshansky District	ruName	Россошанский район
Kalininsky District, Saint Petersburg	ruName	Калининский район
Ramonsky District	ruName	Рамонский район
Vorobyovsky District	ruName	Воробьёвский район
Semiluksky District	ruName	Семилукский район
Ternovsky District	ruName	Терновский район
Primorsky District, Saint Petersburg	ruName	Приморский район
Verkhnekhavsky District	ruName	Верхнехавский район
Verkhnemamonsky District	ruName	Верхнемамонский район
Paninsky District	ruName	Панинский район
Podgorensky District	ruName	Подгоренский район
Pavlovsky District, Voronezh Oblast	ruName	Павловский район
Bibirevo District	ruName	Бибирево
Otradnoye District	ruName	Отрадное
Mitino District	ruName	Митино
Danilovsky District, Moscow	ruName	Даниловский район
Donskoy District	ruName	Донской район
Biryulyovo Vostochnoye District	ruName	Район Бирюлёво Восточное
Chertanovo Severnoye District	ruName	Район Чертаново Северное
Nagorny District	ruName	Нагорный район
Yuzhnoportovy District	ruName	Южнопортовый район
Nagatino-Sadovniki District	ruName	Район Нагатино-Садовники
Kapotnya District	ruName	Район Капотня
Krasnoselkupsky District	ruName	Красноселькупский район
Tazovsky District	ruName	Тазовский район
Priuralsky District	ruName	Приуральский район
Yamalsky District	ruName	Ямальский район
Beloyarsky District, Khanty-Mansi Autonomous Okrug	ruName	Белоярский район
Purovsky District	ruName	Пуровский район
Oktyabrsky District, Khanty-Mansi Autonomous Okrug	ruName	Октябрьский район
Surgutsky District	ruName	Сургутский район
Kondinsky District	ruName	Кондинский район
Nefteyugansky District	ruName	Нефтеюганский район
Sovetsky District, Khanty-Mansi Autonomous Okrug	ruName	Советский район
Khanty-Mansiysky District	ruName	Ханты-Мансийский район
Nizhnevartovsky District	ruName	Нижневартовский район
Shuryshkarsky District	ruName	Шурышкарский район
Alarsky District	ruName	Аларский район
Bayandayevsky District	ruName	Баяндаевский район
Nukutsky District	ruName	Нукутский район
Osinsky District, Irkutsk Oblast	ruName	Осинский район
Ekhirit-Bulagatsky District	ruName	Эхирит-Булагатский район
Kandalakshsky District	ruName	Кандалакшский район
Baltiysky District, Kaliningrad Oblast	ruName	Балтийский район
Svetlogorsky District	ruName	Светлогорский район
Novonikolayevsky District	ruName	Новониколаевский район
Khostinsky City District	ruName	Хостинский внутригородской район
Lazarevsky City District	ruName	Лазаревский внутригородской район
