Aberdour	scotsName	Aiberdour
Alexandria, West Dunbartonshire	scotsName	The Vale
Belfast	scotsName	Bilfawst/Bilfaust
Derry	scotsName	Derrie/Lunnonderrie
Enniskillen	scotsName	Inniskillin
Fort William, Highland	scotsName	Fort Weelum
Hawick	scotsName	Haaick
Cardonald	scotsName	Cardonal
Perth, Scotland	scotsName	Perth
Airdrie, North Lanarkshire	scotsName	Airdrie
Stirling	scotsName	Stirlin
Arbroath	scotsName	Aiberbrothock
Milngavie	scotsName	Mulguye
Carrickfergus	scotsName	Carrick or Craigfergus
Omagh	scotsName	Omey
Ballycastle, County Antrim	scotsName	Ballykessel,
Ballycastle, County Antrim	scotsName	Bellykessel or Bellycaissle
Rathlin Island	scotsName	Racherie
Downpatrick	scotsName	Doonpetèrick or Doonpetherick
Cookstown	scotsName	Cookestoun or Cookstoon
Limavady	scotsName	Limavadie
Newcastle, County Down	scotsName	Newkessel or Newcaissle
Newtownards	scotsName	Newton or Newtonairds
Strabane	scotsName	Stràbane
Kirkwall	scotsName	Kirkwaa or Kirkwal
Stromness	scotsName	Strumnis
Ruthwell	scotsName	Rival
Castle Douglas	scotsName	Castle Deeg
Moniaive	scotsName	Minnyhive
Sanquhar	scotsName	Sanchar
Wigtown	scotsName	Wigtoun
Stranraer	scotsName	Stranrawer
Newport-on-Tay	scotsName	Newport-on-Tay
Stonehaven	scotsName	Steenhive
Dalgety Bay	scotsName	Dawgety
Innerleithen	scotsName	Innerleithen
Ayr	scotsName	Ayr
Fraserburgh	scotsName	The Broch
Dunbar	scotsName	Dunbaur
Dunfermline	scotsName	Dunfaurlin
Castlereagh	scotsName	Stye Braes o Ulidia Burgh
Bishopbriggs	scotsName	Beeshops' Rigs
Maryhill	scotsName	Maryhull
Dunoon	scotsName	Dunoon
Partick	scotsName	Pairtick
Govan	scotsName	Gouan
Jordanhill	scotsName	Jordanhull
Forfar	scotsName	Farfar
Livingston, West Lothian	scotsName	Leivinstoun
Rutherglen	scotsName	Ruglen
Montrose, Angus	scotsName	Montrose
Lanark	scotsName	Lanrik
Elgin, Moray	scotsName	Ailgin
Melrose, Scottish Borders	scotsName	Melrose
Cambuslang	scotsName	Cammuslang
East Kilbride	scotsName	East Kirkbride
Crieff	scotsName	Crieff
Irvine, North Ayrshire	scotsName	Irvin
Motherwell	scotsName	Mitherwall
Greenock	scotsName	Greenock
Dornoch	scotsName	Dornach
Thurso	scotsName	Thursa
Newry	scotsName	Newrie
St Andrews	scotsName	Saunt Aundraes
Falkirk	scotsName	The Fawkirk
Bridge of Allan	scotsName	Brig Allan
Kilmarnock	scotsName	Kilmarnock, Killie
Portadown	scotsName	Portadoun or Portadoon
Dumbarton	scotsName	Dumbairton, Dumbartoun or Dumbertan
Helensburgh	scotsName	Eelansburgh
Broughty Ferry	scotsName	Brochtie or Brochty
Alloa	scotsName	Allowae
Dingwall	scotsName	Dingwal
Dufftown	scotsName	Dufftoun
Uphall	scotsName	Uphauch
Eyemouth	scotsName	Heymooth
Peebles	scotsName	Peebles
North Berwick	scotsName	Northbarrick, Northberwyke
Pitlochry	scotsName	Pitlochry
Lossiemouth	scotsName	Lossie
Kirriemuir	scotsName	Kirriemuir, Kirrie
Galashiels	scotsName	Gallae
Campbeltown	scotsName	Cammeltoun
Port Glasgow	scotsName	Port Glesga
Culross	scotsName	Culross
Coldstream	scotsName	Caustrim
Duns	scotsName	Dunse
Fortrose	scotsName	Chainry
Grangemouth	scotsName	Grangemooth
Langholm	scotsName	Langhowm
Kingussie	scotsName	Kineussie
Inveraray	scotsName	Inverera
Inverkeithing	scotsName	Inverkeithin
Burntisland	scotsName	Bruntisland
Brechin	scotsName	Brechin
Burghead	scotsName	Burgheid / The Broch
Banchory	scotsName	Banchry
Larne	scotsName	Lairne
Ballyclare	scotsName	Bellyclare
Bushmills	scotsName	Bushmill
Coleraine	scotsName	Cowlrain or Cowlraine
Bangor, County Down	scotsName	Bengor
Portrush	scotsName	Tha Port
Clydebank	scotsName	Clidbaunk
Bearsden	scotsName	Easter Kirkpatrick, Eister Kilpatrick
Bridge of Weir	scotsName	Brig o' Weir
Warrenpoint	scotsName	Warrenpynt
Coalisland	scotsName	Collislann
Comber	scotsName	Commer
Irvinestown	scotsName	Irvinestoun
Blairgowrie and Rattray	scotsName	Blairgowrie
Coatbridge	scotsName	Cotbrig or Coatbrig
Cowdenbeath	scotsName	Coudenbeith
Armagh	scotsName	Airmagh
Troon	scotsName	The Truin
Cathcart	scotsName	Kithcart
Saltcoats	scotsName	Salkits
Tongue, Highland	scotsName	Tunga
Helmsdale	scotsName	Helmsdal
Knightswood	scotsName	Knichtswid
Kelvinbridge	scotsName	Kelvinbrig
Roxburgh	scotsName	Roxburgh, Rosbroch
Ralston, Renfrewshire	scotsName	Ralphstoun
Lochwinnoch	scotsName	Lochineuch
Barrhead	scotsName	Baurheid
Longniddry	scotsName	Langniddry
Lesmahagow	scotsName	Lismahagie or The Gow
Baillieston	scotsName	Bailiestoun or Bylliestoun
Larkhall	scotsName	Larkhauch
Giffnock	scotsName	Giffnock
Cults, Aberdeen	scotsName	Cults
Dungannon	scotsName	Rathgannon
Bothwell	scotsName	Boddle
Rosehearty	scotsName	Rizartie
Stenhousemuir	scotsName	Stennymuir
Dyce	scotsName	Dyce
Kilwinning	scotsName	Kilwinnin
Findochty	scotsName	Finichty
Strathaven	scotsName	Straiven
Peterculter	scotsName	Petercouter
Holywood	scotsName	Halywid
Hillhead	scotsName	Hullheid
Townhead	scotsName	Tounheid
Cowcaddens	scotsName	Coucaddens
Johnstone	scotsName	Johnstoun
Ardrossan	scotsName	Ardrussan
Wishaw	scotsName	Wishae
Badachro	scotsName	Bad a' Chrò
Polmont	scotsName	Powmont
Howwood	scotsName	The Howewid
Bishopton, Renfrewshire	scotsName	Bishoptoun or Beeshoptoun
Shettleston	scotsName	Shuttlestoun
Aboyne	scotsName	Abyne
Woodlands, Glasgow	scotsName	Widlaunds
Summerston	scotsName	Simmerstoun
Anderston	scotsName	Anderstoun
Aberchirder	scotsName	Foggieloan/Aberchirder
Auchtermuchty	scotsName	Auchtermuchtie, Muchtie
Bathgate	scotsName	Bathket or Bathkit
Bellshill	scotsName	Bellshull
Cockenzie and Port Seton	scotsName	Cockennie
Dalbeattie	scotsName	Dawbeattie
Anstruther	scotsName	Ainster
Tillicoultry	scotsName	Tillicoultry, Tilly
Tomintoul	scotsName	Tamintowl
Parkhead	scotsName	Pairkheid
Portpatrick	scotsName	Portpaitrick
Crianlarich	scotsName	Crianlarich
Dunkeld	scotsName	Dunkell
Bridgeton, Glasgow	scotsName	Brigtoun
Auchinleck	scotsName	Affleck
Wick, Caithness	scotsName	Week
Auchenshuggle	scotsName	Auchenshoogle
Turriff	scotsName	Turra
Antrim, County Antrim	scotsName	Antrìm, Anthrim or Entrim
Ballymena	scotsName	Bellamaina, Bellamena
Ballymena	scotsName	or Seiven Tours
Ballymoney	scotsName	Bellymoney
Magherafelt	scotsName	Macherafelt
Greater Glasgow	scotsName	Muckler Glesca
Crookston, Glasgow	scotsName	Cruixtoun
Halfway, Glasgow	scotsName	Haufwey
Kelso, Scottish Borders	scotsName	Kelsae
Derrygonnelly	scotsName	Derrygonlie
Alford, Aberdeenshire	scotsName	Aaford or Awfort
Larbert	scotsName	Lairbert
Stevenston	scotsName	Steenstoun
Hurlford	scotsName	Hulfurt
Darvel	scotsName	Dairvel
Coldingham	scotsName	Cowjum
Haddington, East Lothian	scotsName	Haidintoun
Uddingston	scotsName	Uddinstoun
Old Aberdeen	scotsName	Auld Aiberdeen
Balmullo	scotsName	Bawmullo
St Margaret's Hope	scotsName	Saunt Marget's
Annan, Dumfries and Galloway	scotsName	Annan
Gibshill	scotsName	the Ponderosa
Tranent	scotsName	Turnent
Tayport	scotsName	Tayport
Laurencekirk	scotsName	Lowrenkirk
Falkland, Fife	scotsName	Fauklan
Fairlie, North Ayrshire	scotsName	Fairlie
Cairnryan	scotsName	The Cairn
Mount Florida	scotsName	Munt Floridae
Arden, Glasgow	scotsName	Airden
Glenarm	scotsName	Glenairm
Dundonald	scotsName	Dundonal or Dundoanal
Croftfoot	scotsName	Croaftfuit
Craigton, Glasgow	scotsName	Craigtoun
Renton, West Dunbartonshire	scotsName	The Renton
Gardenstown	scotsName	Gamrie
Pennan	scotsName	Peenan
Balquhidder	scotsName	Bawhidder
Earlston	scotsName	Yerlston
Darnley	scotsName	Dernly
Jamestown, West Dunbartonshire	scotsName	Jeamstoun
Bonhill	scotsName	B'nill
Hillington, Scotland	scotsName	Hullintoun
Lenzie	scotsName	Lennie or Lenyie
Fauldhouse	scotsName	Fauldhoose
Crossmyloof	scotsName	Crossmaluif
Hilton of Cadboll	scotsName	Hilton
Newbuildings	scotsName	Newbigging
Loughinisland	scotsName	Lochinislann
Strangford	scotsName	Strangfurd
Old Kilpatrick	scotsName	Auld Kilpaitrick
Livingston Village	scotsName	Leivinstoun Veilage
Denholm	scotsName	Denholm
Aberlady	scotsName	Aiberleddy
Addiewell	scotsName	Aidieswall
Calton, Glasgow	scotsName	Caltoun
Carntyne	scotsName	Cairntyne
Finnieston	scotsName	Finniestoun
Dennistoun	scotsName	Danzielstoun
Garrowhill	scotsName	Garraehill
Easterhouse	scotsName	Easterhoose or Eisterhoose
Possilpark	scotsName	Possilpairk
Sighthill, Glasgow	scotsName	Sichthull
Yorkhill	scotsName	Yorkhull
Ruchill	scotsName	Rochhull
Cowglen	scotsName	Couglen
Battlefield, Glasgow	scotsName	Battilfield
Carnwadric	scotsName	Carndouk
Crosshill	scotsName	Croashull
Hillpark	scotsName	Hullpairk
Govanhill	scotsName	Gouanhull
South Nitshill	scotsName	Sooth Nitshull
Hutchesontown	scotsName	Hutchesontoun
Langside	scotsName	Langsyde or Langside
Kennishead	scotsName	Kennisheid
Mansewood	scotsName	Mansewid
Bowling, West Dunbartonshire	scotsName	Bowlin
Carrbridge	scotsName	Carrbrig
Rosemarkie	scotsName	Rossmartnie
Portuairk	scotsName	The Port
Merchant City	scotsName	Merchand Ceity
Avonbridge	scotsName	Snout capital ae Scotland
Beauly	scotsName	Beauly, Beuly
Newcastleton	scotsName	Copshaw Howm, colloquially Copshie
Ladybank	scotsName	Leddybank
Oldhamstocks	scotsName	Aldhamstocks
Kinning Park	scotsName	Kinning Pairk
Dalmellington	scotsName	Dawmellinton
St Boswells	scotsName	Bosells
Claudy	scotsName	Tha Strang-rinnin Wattèr
Claudy	scotsName	or Claudy
Neilston	scotsName	Neilstoun
Corkerhill	scotsName	Coarkerhull
Shieldaig	scotsName	Shieldaig
Ballycarry	scotsName	Ballycarrie
Ballyhalbert	scotsName	Talbotstoun
Ballywalter	scotsName	Whitkirk
Carnlough	scotsName	Carnloch
Crawfordsburn	scotsName	Crawford's burn
Greyabbey	scotsName	Greba
Cushendun	scotsName	Cushenduin
Peterhead	scotsName	Peterheid, The Blue Toun
Currie	scotsName	Curry
Raploch	scotsName	The Raploch
Armadale, West Lothian	scotsName	Airmadale
Rathven	scotsName	Raffin
Pomeroy, County Tyrone	scotsName	Aipplescaw
Newstead, Scottish Borders	scotsName	Newstead
Bonnybridge	scotsName	Bonniebrig
Barrowfield	scotsName	Barraefield
Blackhill, Glasgow	scotsName	Blackhull or Mirkhull
King's Park, Glasgow	scotsName	Keeng's Pairk
Athelstaneford	scotsName	Atholstanefuird or Elshinthurd
Newcraighall	scotsName	Newcraighauch
Andersonstown	scotsName	Andersontoon
Maryhill Park	scotsName	Maryhull Pairk
Buchlyvie	scotsName	Buchlyvie
Woodside, Glasgow	scotsName	Widside
Middletown, County Armagh	scotsName	Middletoun or Mïddletoon
Garelochhead	scotsName	Garelochheid
High Ruchill	scotsName	Hie Rochhull
Park, County Londonderry	scotsName	Tha Fiel
Killearn	scotsName	Killern, orig. Kynhern
Kippford	scotsName	The Scaur
Torry	scotsName	Torry
Markinch	scotsName	Merkinch
Holytown	scotsName	Holytown
Mid Calder	scotsName	Mid Cauder
Ninewells	scotsName	Ninewalls
Foresterhill	scotsName	Foresterhill
Douglas, South Lanarkshire	scotsName	Douglas
Footdee	scotsName	Fittie
Stoneyburn	scotsName	Stanyburn
Methven, Perth and Kinross	scotsName	Meffin
Buckhaven	scotsName	Buckhyne
Chryston	scotsName	Chrystoun
West Calder	scotsName	Wast Cauder
Linlithgow	scotsName	Lithgae
Doonfoot	scotsName	Doonfit
Partickhill	scotsName	Pairtickhull
Park District, Glasgow	scotsName	Pairk Destrict
Ardgay	scotsName	Airdgay
Longcroft, Falkirk	scotsName	Langcraft
Thornwood, Glasgow	scotsName	Thornwid
Dunlop, East Ayrshire	scotsName	Dunlap
Edzell	scotsName	Aigle
Dalmally	scotsName	Dulmally
St Cyrus	scotsName	Saunt Ceerus
Waterfoot, East Renfrewshire	scotsName	Watterfit
Camelon	scotsName	Caimlan
Pirnmill	scotsName	Punmill
Wilton Dean	scotsName	Wulton Dean
Bridge of Don	scotsName	Brig o' Don
Stenton	scotsName	Staneton
Blackridge, West Lothian	scotsName	Blackrig
Kirknewton, West Lothian	scotsName	Kirknewtoun
Polbeth	scotsName	Polbeth
Guardbridge	scotsName	Gaire Brig
Teviothead	scotsName	Teviotheid
Kershopefoot	scotsName	Kershopefit
Tibbermore	scotsName	Tibbermore
Auldhouse	scotsName	Auldhoose
Ardross, Highland	scotsName	Mandeep
Caldercruix	scotsName	Cauldercruix
Banbridge	scotsName	Bannbrig
Eddleston	scotsName	Eddleston
Broomridge	scotsName	Broomrigg
Bonnyton, East Ayrshire	scotsName	Bonnietoun
Riccarton, Ayrshire	scotsName	Riccartoun
Muirhead	scotsName	Mairheid
Redgorton	scotsName	Rochgorton
Charlestown, Fife	scotsName	Chairlstoun
Bonchester Bridge	scotsName	Binster Brig
Roberton, Scottish Borders	scotsName	Raberton
Southdean	scotsName	Soothdean
Roberton, South Lanarkshire	scotsName	Robertin
Stuartfield	scotsName	Crichie
Udny Station	scotsName	Widnie
Barrhill, South Ayrshire	scotsName	Baurhill
Carnalbanagh	scotsName	Carn Albanach
Randalstown	scotsName	Randalstoon
Scone, Perth and Kinross	scotsName	Scuin
Oban	scotsName	Oban
Inchree	scotsName	Inchrigh
Carronshore	scotsName	Gods Village
California, Falkirk	scotsName	Californie
Armadale, Sutherland	scotsName	Airmadale
Gowkhall	scotsName	Gowkhauch
Ardoch, Perth and Kinross	scotsName	help
Maddiston	scotsName	Maudirstoun
Limerigg	scotsName	snoutland ae X
Newmill-on-Teviot	scotsName	Newmill
Netherton, Glasgow	scotsName	Nethertoun
Burnfoot, Scottish Borders	scotsName	Burnfit
Whappstown	scotsName	Whaupstoun
Muirdrum	scotsName	Muirdrum
Kinnesswood	scotsName	Kinaskit
Overtown, North Lanarkshire	scotsName	Overton
Canisbay	scotsName	Canisbay
Clarkston, East Renfrewshire	scotsName	Clairkstoun
Stoneywood, Falkirk	scotsName	Stanywid
Hillhead	scotsName	Hullheid
Craigton	scotsName	Craigtoun
Govan	scotsName	Govan
Partick West	scotsName	Pairtick Wast
City	scotsName	Anderstoun/Ceitie
Kelvin	scotsName	Maryhull/Kelvin
Kirkcolm	scotsName	Kirkcaum
Brow, Dumfries and Galloway	scotsName	Brow
Shettleston	scotsName	Shuttlestoun
Druminargal, County Armagh	scotsName	Drumawnargall
Makerstoun	scotsName	Makerstoun
Brannock, County Armagh	scotsName	Branoch
Lands of Borland	scotsName	Boarland
