African National Congress	secretaryGeneral	Gwede Mantashe
Democratic Progressive Party	secretaryGeneral	Hung Yao-fu
Hezbollah	secretaryGeneral	Hassan Nasrallah
Kuomintang	secretaryGeneral	Mo Tien-hu
Party of European Socialists	secretaryGeneral	Achim Post
Social Democratic Party of Germany	secretaryGeneral	Katarina Barley
American Popular Revolutionary Alliance	secretaryGeneral	Jorge del Castillo
American Popular Revolutionary Alliance	secretaryGeneral	Omar Quesada
Barisan Nasional	secretaryGeneral	Tengku Adnan Tengku Mansor
National Rainbow Coalition	secretaryGeneral	Fidelis Mueke Nguli
Kenya African National Union	secretaryGeneral	Nick Salat
Komeito	secretaryGeneral	Yoshihisa Inoue
Liberal Democratic Party	secretaryGeneral	Toshihiro Nikai
Polisario Front	secretaryGeneral	Brahim Ghali
Swedish Social Democratic Party	secretaryGeneral	Lena Rådström Baastad
SWAPO	secretaryGeneral	Nangolo Mbumba
People's Mujahedin of Iran	secretaryGeneral	Zohreh Akhyani
Bangladesh Nationalist Party	secretaryGeneral	Mirza Fakhrul Islam Alamgir
Guatemalan National Revolutionary Unity	secretaryGeneral	Gregorio Chay
Revolutionary Front for an Independent East Timor	secretaryGeneral	Mari Alkatiri
Democratic Party of Japan	secretaryGeneral	Yukio Edano
Portuguese Communist Party	secretaryGeneral	Jerónimo de Sousa
Japanese Communist Party	secretaryGeneral	Akira Koike
United Malays National Organisation	secretaryGeneral	Tengku Adnan Tengku Mansor
Republican Left of Catalonia	secretaryGeneral	Marta Rovira
Social Democratic Party	secretaryGeneral	Seiji Mataichi
Pan-Malaysian Islamic Party	secretaryGeneral	Takiyuddin Hassan
Socialist Party	secretaryGeneral	António Costa
National Rally for Democracy	secretaryGeneral	Ahmed Ouyahia
People's Party	secretaryGeneral	María Dolores de Cospedal
Republican People's Party	secretaryGeneral	Kamil Okyay Sındır
Bangladesh Awami League	secretaryGeneral	Sayed Ashraful Islam
Social Democratic Party	secretaryGeneral	José Matos Rosa
Communist Party of Belarus	secretaryGeneral	Igor Karpenko
Croatian People's Party – Liberal Democrats	secretaryGeneral	Srećko Ferenčak
Pakistan Peoples Party	secretaryGeneral	Latif Khosa
Pakistan Muslim League	secretaryGeneral	Mushahid Hussain Syed
Pakistan Muslim League	secretaryGeneral	Iqbal Zafar Jhagra
New Communist Party of Britain	secretaryGeneral	Andy Brooks
The Workers' Party	secretaryGeneral	Low Thia Khiang
Malaysian Chinese Association	secretaryGeneral	Ong Ka Chuan
People's Justice Party	secretaryGeneral	Rafizi Ramli
Pertubuhan Kebangsaan Melayu Singapura	secretaryGeneral	Muhammad Hairullah Ahmad
Parti Rakyat Malaysia	secretaryGeneral	Al Jafree Md Yusop
Puerto Rican Independence Party	secretaryGeneral	Juan Dalmau
Puerto Rican Independence Party	secretaryGeneral	Manuel Rodríguez Orellana
Sierra Leone People's Party	secretaryGeneral	Sulaiman Banja Tejan-Sie
Tiako I Madagasikara	secretaryGeneral	Ivohasina Razafimahefa
Kenya African Democratic Union	secretaryGeneral	Masinde Muliro
Initiative for Catalonia Greens	secretaryGeneral	Josep Vendrell
Independent Democrats	secretaryGeneral	Haniff Hoosen
United Democratic Movement	secretaryGeneral	Bongani Msomi
Socialists' Party of Catalonia	secretaryGeneral	Miquel Iceta
Centre Democrats	secretaryGeneral	Wil Schuurman
Socialist Action	secretaryGeneral	Jeff Mackler
Scottish Labour Party	secretaryGeneral	Keir Hardie
Seychelles National Party	secretaryGeneral	Nicholas Prea
Democratic Revolutionary Party	secretaryGeneral	Carlos Perez Herrera
Grand National Alliance	secretaryGeneral	Jaime Martínez Lohayza
Convergence for Social Democracy	secretaryGeneral	Andres Esono Ondo
Parti Gerakan Rakyat Malaysia	secretaryGeneral	Liang Teck Meng
Liberal Party	secretaryGeneral	Takeshi Noda
Singapore Democratic Party	secretaryGeneral	Chee Soon Juan
Democrat Party	secretaryGeneral	Chalermchai Sri-on
Civic United Front	secretaryGeneral	Seif Shariff Hamad
Chunta Aragonesista	secretaryGeneral	Juan Martín Expósito
All People's Congress	secretaryGeneral	Alhaji
All People's Congress	secretaryGeneral	Osman Foday Yansaneh
Azanian People's Organisation	secretaryGeneral	Manku Noruka
National Umma Party	secretaryGeneral	Siidig El Nour
Botswana Congress Party	secretaryGeneral	Dr Kesitegile Gobotswang
Barisan Sosialis	secretaryGeneral	Lim Chin Siong
National Solidarity Party	secretaryGeneral	Lim Tean
Singapore People's Party	secretaryGeneral	Chiam See Tong
Democratic Progressive Party	secretaryGeneral	Benjamin Pwee
Socialist Party of Azania	secretaryGeneral	Ashraf Jooma
Tamil National Alliance	secretaryGeneral	Mavai Senathirajah
Hezbollah Movement in Iraq	secretaryGeneral	Hassan Al-Sari
Democratic Progressive Party	secretaryGeneral	Jean Kalilani
People's Party of Galicia	secretaryGeneral	Alfonso Rueda Valenzuela
Japan Renewal Party	secretaryGeneral	Ichirō Ozawa
Conservative Party	secretaryGeneral	Damian Florea
Parti Pesaka Bumiputera Bersatu	secretaryGeneral	Stephen Rundi Utom
National Democratic Congress	secretaryGeneral	Johnson Asiedu-Nketia
Communist Party of Castile-La Mancha	secretaryGeneral	Jorge Vega Martín
Workers' Party of Spain–Communist Unity	secretaryGeneral	Santiago Carrillo
Progressive Democratic Tribune	secretaryGeneral	Hassan Madan
Militant Socialist Movement	secretaryGeneral	Nando Bodha
Golden Dawn	secretaryGeneral	Nikolaos Michaloliakos
Ecologist Party of Romania	secretaryGeneral	Ionel Goidescu
Progressive Party	secretaryGeneral	Tan Chye Cheng
Croatian Party of Rights of Bosnia and Herzegovina	secretaryGeneral	Petar Milić
Sarawak United Peoples' Party	secretaryGeneral	Sebastian Ting Chiew Yew
Sabah Progressive Party	secretaryGeneral	Richard Yong We Kong
People's Progressive Party	secretaryGeneral	Mohan Kandasamy
Union of Democratic Forces	secretaryGeneral	Ahmed Ould Daddah
United People's Freedom Alliance	secretaryGeneral	Mahinda Amaraweera
Sri Lanka Freedom Party	secretaryGeneral	Duminda Dissanayake
Workers' Revolutionary Party	secretaryGeneral	Mario Roberto Santucho
National Republican Greek League	secretaryGeneral	Komninos Pyromaglou
Independent Movement of Absolute Renovation	secretaryGeneral	Gloria Stella Díaz
Islamic Society of Engineers	secretaryGeneral	Mohammad Reza Bahonar
Republican Left of the Valencian Country	secretaryGeneral	Núria Arnau
Socialist Party of Catalonia-Congress	secretaryGeneral	Joan Reventós
National Movement for the Development of Society	secretaryGeneral	Albadé Abouba
Party of Labour of Spain	secretaryGeneral	Eladio Garcia Castro
Workers' Revolutionary Organization	secretaryGeneral	José Sanroma Aldea camarada Intxausti
Catalan Workers' Left	secretaryGeneral	Miquel Mayol i Raynal
Communist Movement	secretaryGeneral	Eugenio del Río
Sahrawi National Union Party	secretaryGeneral	Khelli Henna Ould Rachid
Sahrawi National Union Party	secretaryGeneral	Dueh Sidna Naucha
Commoners' Land	secretaryGeneral	Luis Marcos Naveira
Euskal Iraultzarako Alderdia	secretaryGeneral	Mario Onaindia
Étoile Nord-Africaine	secretaryGeneral	Imache Amar
Youth of the European People's Party	secretaryGeneral	Andrea Vodanović
Beer Lovers Party	secretaryGeneral	Konstantin Argirakov
Beer Lovers Party	secretaryGeneral	Andrey Palchevsky
Action Group	secretaryGeneral	Anthony Enahoro
Action Group	secretaryGeneral	Bola Ige
People's Socialist Revolutionary Party	secretaryGeneral	Alberto Figueroa
People's Socialist Revolutionary Party	secretaryGeneral	Txomin Ziluaga
Islamic Dawa Party – Iraq Organisation	secretaryGeneral	Hashim Al-Mosawy
Extremaduran Coalition	secretaryGeneral	Estanislao Martín
National Solidarity Party	secretaryGeneral	José Luna Gálvez
National Rainbow Coalition – Kenya	secretaryGeneral	Danson Mungatana
Party of Democratic Action of Sandžak	secretaryGeneral	Selma Džinović
Workers' Communist Party	secretaryGeneral	Marco Ferrando
Islamic Union of Iraqi Turkoman	secretaryGeneral	Abbas al-Bayati
Citizens	secretaryGeneral	Matías Alonso Ruiz
Centre of Social Democrats	secretaryGeneral	Jacques Barrot
Centre of Social Democrats	secretaryGeneral	Philippe Douste-Blazy
Democratic Centre	secretaryGeneral	Pierre Abelin
Green Party	secretaryGeneral	Silviu Dumitru
Action Congress of Nigeria	secretaryGeneral	Lawali Shuaibu
Partíu Asturianista	secretaryGeneral	Xesús Cañedo Valle
Arab Socialist Action Party	secretaryGeneral	George Habash
Revolutionary Democratic Party of Yemen	secretaryGeneral	Sultan Omar
Socialist Party of the Valencian Country	secretaryGeneral	Ximo Puig
Wiper Democratic Movement – Kenya	secretaryGeneral	Hassan Omar
Encuentro por Guatemala	secretaryGeneral	Nineth Montenegro
Party of National Unity	secretaryGeneral	Amos Kimunya
KALIBAPI	secretaryGeneral	Pio Duran
Socialist Democratic Unionist Party	secretaryGeneral	Mahfouz Weld al-Azizi
National-Christian Defense League	secretaryGeneral	Nichifor Crainic
Cowry Forces for an Emerging Benin	secretaryGeneral	Timothée Zannou
Liberal Party	secretaryGeneral	Ion Apostol
Sarawak National Party	secretaryGeneral	Frankie Jurem Nyombui
Malaysian Indian Muslim Congress	secretaryGeneral	Anuar Sadad Mohamed Mustafa
Parti Melayu Semangat 46	secretaryGeneral	Suhaimi Kamaruddin
People's Party of Catalonia	secretaryGeneral	Jordi Cornet i Serra
All People's Party	secretaryGeneral	Mukuve Marcellus Mudumbi
National Front for the Salvation of Iraq	secretaryGeneral	Sheikh Ali Hatem al-Suleiman
Congress of the People	secretaryGeneral	Lyndall Shope-Mafole
Boston Tea Party	secretaryGeneral	Brandi Duncan
National Trust Party	secretaryGeneral	Mehdi Karroubi
Ethiopian Democratic Party	secretaryGeneral	Mesfin Mengistu
Liberal Democratic Party of Moldova	secretaryGeneral	Victor Roşca
United Democratic Movement	secretaryGeneral	Martin Ole Kamwaro
Socialist Party of Vietnam	secretaryGeneral	Phan Tử Nghĩa
Socialist Party of Vietnam	secretaryGeneral	Nguyễn Xiển
Socialist Party of Vietnam	secretaryGeneral	Hoàng Minh Giám
PSM-Nationalist Agreement	secretaryGeneral	Gabriel Barceló
Democratic Party	secretaryGeneral	Ieu Koeus
Democratic Party	secretaryGeneral	Norodom Phurissara
National Moldavian Party	secretaryGeneral	Pan Halippa
Cantonal Party	secretaryGeneral	Salvador Sánchez Cerón
Islamic Coalition Party	secretaryGeneral	Mohammad Nabi Habibi
Democracy Party	secretaryGeneral	Mostafa Kavakebian
Moderation and Development Party	secretaryGeneral	Mohammad Bagher Nobakht
New Iran Party	secretaryGeneral	Manouchehr Kalali
Islamic Labour Party	secretaryGeneral	Hossein Kamali
Sunrise Party	secretaryGeneral	Hiroyuki Sonoda
Tamil National People's Front	secretaryGeneral	Selvarajah Kajendren
Tamil National Liberation Alliance	secretaryGeneral	M. K. Shivajilingam
Osaka Restoration Association	secretaryGeneral	Ichirō Matsui
Malaysian Ceylonese Congress	secretaryGeneral	Mahalingam Sinivasagam
Parti Cinta Malaysia	secretaryGeneral	Loo Kien Seang
Union Solidarity and Development Party	secretaryGeneral	Thet Naing Win
Farmer-Labour Party	secretaryGeneral	Asanuma Inejiro
Democratic Unity Roundtable	secretaryGeneral	Jesús Torrealba
Ganatantri Dal	secretaryGeneral	Mahmud Ali
National Progressive Front	secretaryGeneral	Naim Haddad
Pirate Party of Catalonia	secretaryGeneral	Lurdes Prieto Cano
Serbian Progressive Party in Macedonia	secretaryGeneral	Igor Dimitrijević
Sortu	secretaryGeneral	Arnaldo Otegi
Parti Rakyat Sarawak	secretaryGeneral	Wilfred Rata Nissom
Young Liberal Democracy	secretaryGeneral	Davor M. Kalin
Majlis-e-Ahrar-ul-Islam	secretaryGeneral	Abdul Latif Khalid Cheema
Congress for Progressive Change	secretaryGeneral	Buba Galadima
Asturias Forum	secretaryGeneral	Francisco Álvarez Cascos
Regional Action	secretaryGeneral	José María Ruiz Gallardón
Communist Party of French India	secretaryGeneral	V. Subbiah
Egyptian Social Democratic Party	secretaryGeneral	Mervat Tallawy
Arab Revolutionary Workers Party	secretaryGeneral	Abdul Hafiz Hafiz
Triumph Heritage Empowerment Party	secretaryGeneral	James Kiele
Front of Islamic Revolution Stability	secretaryGeneral	Morteza Agha-Tehrani
New Forum for the Restoration of Democracy–Kenya	secretaryGeneral	Dr. Juma Mukhwana
Syrian National Youth Party	secretaryGeneral	Nabil Merhaj
Solidary Poland	secretaryGeneral	Andrzej Dera
Máis Galiza	secretaryGeneral	Xoán Bascuas
People's Life First	secretaryGeneral	Shōzō Azuma
Civic Force	secretaryGeneral	Ștefan Pirpiliu
Japan Restoration Party	secretaryGeneral	Ichirō Matsui
White Iraqiya Bloc	secretaryGeneral	Jamal al-Bateikh
Tayo	secretaryGeneral	Mohamed Abdullahi Mohamed
Syed Ata-ul-Muhaimin Bukhari	secretaryGeneral	Abdul Latif Khalid Cheema
Social Democratic Union of Bosnia and Herzegovina	secretaryGeneral	Esad Piknjać
Tax Cuts Japan	secretaryGeneral	Shizuka Kamei
Tomorrow Party of Japan	secretaryGeneral	Tetsunari Iida
Liberal Party	secretaryGeneral	Katsumasa Suzuki
Chama Cha Mapinduzi	secretaryGeneral	Abdulrahman Kinana
Mauritanian Regroupment Party	secretaryGeneral	Moktar Ould Daddah
Mauritanian National Renaissance Party	secretaryGeneral	Ahmed Baba Miské
Liberal Socialist Party	secretaryGeneral	Tan Chye Cheng
Patriotic Alliance	secretaryGeneral	Kenny Kunene
National Social Democratic Front	secretaryGeneral	Nguyễn Ngọc Huy
Unity Party	secretaryGeneral	Jiro Ono
Social Democratic Party of Kenya	secretaryGeneral	Benedict Wachira
Vox	secretaryGeneral	Javier Ortega Smith-Molina
Pakistan Liberal Party	secretaryGeneral	Ayaz Nizami
FijiFirst	secretaryGeneral	Aiyaz Sayed-Khaiyum
Party for Japanese Kokoro	secretaryGeneral	Masashi Nakano
Galician Socialist Party	secretaryGeneral	Xosé Manuel Beiras
Social Christian People's Union	secretaryGeneral	Gheorghe Iancu
Spanish Socialist Workers' Party of Andalusia	secretaryGeneral	Susana Díaz
Communist Movement of Galicia	secretaryGeneral	Xesús Veiga Buxán
Spanish Socialist Workers' Party of the Madrid Community	secretaryGeneral	Sara Hernández
Sarawak Workers Party	secretaryGeneral	Munan Laja
United Extremadura	secretaryGeneral	Juan Pedro Domínguez
Papua New Guinea Greens	secretaryGeneral	Andrew Kutapae
Assembly to Energize Japan	secretaryGeneral	Kota Matsuda
National Congress	secretaryGeneral	A. L. M. Athaullah
Communists of Catalonia	secretaryGeneral	Joan Josep Nuet
Socialist Party of National Liberation	secretaryGeneral	Josep Guia
Socialist Party of Catalonia-Regroupment	secretaryGeneral	Josep Pallach i Carolà
Democratic Left of Catalonia	secretaryGeneral	Ramón Trías Fargas
Daljir Party	secretaryGeneral	Ahmed Moalim Fiqi
Andalusian People's Party	secretaryGeneral	Loles López Gabarro
Spanish Social Democratic Union	secretaryGeneral	Dionisio Ridruejo
Socialist Convergence of Catalonia	secretaryGeneral	Joan Reventós
People's Party of the Valencian Community	secretaryGeneral	Eva Ortiz
Christian Democratic Party	secretaryGeneral	Fernando Álvarez de Miranda
Democratic Party	secretaryGeneral	Yoshihiko Noda
Pak Sarzameen Party	secretaryGeneral	Raza Haroon
Islamic Assembly of Ladies	secretaryGeneral	Fatemeh Karroubi
Action and Solidarity	secretaryGeneral	Igor Grosu
Association for Defence of Revolution Values	secretaryGeneral	Mohammad Reyshahri
Islamic Society of Employees	secretaryGeneral	Seyed Kamal Sajjadi
Islamic Association of Physicians of Iran	secretaryGeneral	Shahab od-Din Sadr
Islamic Society of Athletes	secretaryGeneral	Hassan Ghafourifard
National Trust Party	secretaryGeneral	Mohd Anuar Tahir
Communists' Unity Board	secretaryGeneral	Santiago Carrillo
Socialist Party of the Balearic Islands	secretaryGeneral	Francina Armengol
Association of Islamic Revolution Loyalists	secretaryGeneral	Hassan Ghafourifard
Asturian Socialist Federation	secretaryGeneral	Javier Fernández Fernández
