The Pirate Planet	serialName	The Pirate Planet
City of Death	serialName	City of Death
Shada	serialName	Shada
The Robots of Death	serialName	The Robots of Death
Invasion of the Dinosaurs	serialName	Invasion of the Dinosaurs
State of Decay	serialName	State of Decay
Time and the Rani	serialName	Time and the Rani
The Mark of the Rani	serialName	The Mark of The Rani
Doctor Who: The Curse of Fatal Death	serialName	Doctor Who: The Curse of Fatal Death
Delta and the Bannermen	serialName	Delta and the Bannermen
Terminus	serialName	Terminus
Paradise Towers	serialName	Paradise Towers
Remembrance of the Daleks	serialName	Remembrance of the Daleks
The Three Doctors	serialName	The Three Doctors
Dimensions in Time	serialName	Dimensions in Time
K-9 and Company	serialName	A Girl's Best Friend
An Unearthly Child	serialName	An Unearthly Child
Doctor Who	serialName	Doctor Who
The Seeds of Death	serialName	The Seeds of Death
The Mysterious Planet	serialName	The Trial of a Time Lord: The Mysterious Planet
Mindwarp	serialName	The Trial of a Time Lord: Mindwarp
Terror of the Vervoids	serialName	The Trial of a Time Lord: Terror of the Vervoids
The Daleks	serialName	The Daleks
Spearhead from Space	serialName	Spearhead from Space
The Edge of Destruction	serialName	The Edge of Destruction
Marco Polo	serialName	Marco Polo
The Keys of Marinus	serialName	The Keys of Marinus
The Mutants	serialName	The Mutants
Planet of the Daleks	serialName	Planet of the Daleks
The Ultimate Foe	serialName	The Trial of a Time Lord: The Ultimate Foe
Genesis of the Daleks	serialName	Genesis of the Daleks
The War Games	serialName	The War Games
The Caves of Androzani	serialName	The Caves of Androzani
The Evil of the Daleks	serialName	The Evil of the Daleks
Mawdryn Undead	serialName	Mawdryn Undead
The Aztecs	serialName	The Aztecs
Enlightenment	serialName	Enlightenment
Terror of the Autons	serialName	Terror of the Autons
Doctor Who and the Silurians	serialName	Doctor Who and the Silurians
Inferno	serialName	Inferno
Day of the Daleks	serialName	Day of the Daleks
The Dæmons	serialName	The Dæmons
Scream of the Shalka	serialName	Scream of the Shalka
The Deadly Assassin	serialName	The Deadly Assassin
The Tomb of the Cybermen	serialName	The Tomb of the Cybermen
The Five Doctors	serialName	The Five Doctors
The Dalek Invasion of Earth	serialName	The Dalek Invasion of Earth
The War Machines	serialName	The War Machines
Rose	serialName	Rose
Survival	serialName	Survival
Horror of Fang Rock	serialName	Horror of Fang Rock
The Curse of Peladon	serialName	The Curse of Peladon
The Twin Dilemma	serialName	The Twin Dilemma
The Invasion of Time	serialName	The Invasion of Time
The Time Warrior	serialName	The Time Warrior
The Sontaran Experiment	serialName	The Sontaran Experiment
The Two Doctors	serialName	The Two Doctors
Pyramids of Mars	serialName	Pyramids of Mars
The Ark in Space	serialName	The Ark in Space
Mission to the Unknown	serialName	Mission to the Unknown
Logopolis	serialName	Logopolis
Robot	serialName	Robot
The Curse of Fenric	serialName	The Curse of Fenric
Ghost Light	serialName	Ghost Light
Silver Nemesis	serialName	Silver Nemesis
The Tenth Planet	serialName	The Tenth Planet
Planet of the Spiders	serialName	Planet of the Spiders
The Dominators	serialName	The Dominators
The Daleks' Master Plan	serialName	The Daleks' Master Plan
Castrovalva	serialName	Castrovalva
The Mind Robber	serialName	The Mind Robber
The End of the World	serialName	The End of the World
The Unquiet Dead	serialName	The Unquiet Dead
Aliens of London	serialName	Aliens of London
Attack of the Cybermen	serialName	Attack of the Cybermen
World War Three	serialName	World War Three
The Masque of Mandragora	serialName	The Masque of Mandragora
The Sensorites	serialName	The Sensorites
The Web Planet	serialName	The Web Planet
Dalek	serialName	Dalek
Battlefield	serialName	Battlefield
The Reign of Terror	serialName	The Reign of Terror
Planet of Giants	serialName	Planet of Giants
The Long Game	serialName	The Long Game
Carnival of Monsters	serialName	Carnival of Monsters
The Green Death	serialName	The Green Death
The Talons of Weng-Chiang	serialName	The Talons of Weng-Chiang
The Ribos Operation	serialName	The Ribos Operation
The Stones of Blood	serialName	The Stones of Blood
The Androids of Tara	serialName	The Androids of Tara
The Power of Kroll	serialName	The Power of Kroll
The Armageddon Factor	serialName	The Armageddon Factor
The Leisure Hive	serialName	The Leisure Hive
Resurrection of the Daleks	serialName	Resurrection of the Daleks
Earthshock	serialName	Earthshock
The Visitation	serialName	The Visitation
Vengeance on Varos	serialName	Vengeance on Varos
Warriors' Gate	serialName	Warriors' Gate
Frontier in Space	serialName	Frontier in Space
The Brain of Morbius	serialName	The Brain of Morbius
The Android Invasion	serialName	83
The Seeds of Doom	serialName	The Seeds of Doom
Planet of Evil	serialName	Planet of Evil
Revenge of the Cybermen	serialName	Revenge of the Cybermen
Terror of the Zygons	serialName	Terror of the Zygons
The Hand of Fear	serialName	87
The Face of Evil	serialName	The Face of Evil
Revelation of the Daleks	serialName	Revelation of the Daleks
Timelash	serialName	Timelash
Dragonfire	serialName	Dragonfire
The Happiness Patrol	serialName	The Happiness Patrol
The Greatest Show in the Galaxy	serialName	The Greatest Show in the Galaxy
The Claws of Axos	serialName	The Claws of Axos
The Rescue	serialName	The Rescue
The Romans	serialName	The Romans
The Invisible Enemy	serialName	The Invisible Enemy
Image of the Fendahl	serialName	Image of the Fendahl
The Keeper of Traken	serialName	The Keeper of Traken
The Sun Makers	serialName	The Sun Makers
Planet of Fire	serialName	Planet of Fire
Underworld	serialName	Underworld
The Crusade	serialName	The Crusade
The Space Museum	serialName	The Space Museum
The Chase	serialName	The Chase
Full Circle	serialName	Full Circle
Meglos	serialName	Meglos
Four to Doomsday	serialName	Four to Doomsday
The Ark	serialName	The Ark
The Time Meddler	serialName	The Time Meddler
Galaxy 4	serialName	Galaxy 4
Black Orchid	serialName	Black Orchid
The Myth Makers	serialName	The Myth Makers
The Abominable Snowmen	serialName	The Abominable Snowmen
Father's Day	serialName	Father's Day
The Empty Child	serialName	The Empty Child
The Doctor Dances	serialName	The Doctor Dances
Boom Town	serialName	Boom Town
Bad Wolf	serialName	Bad Wolf
The Parting of the Ways	serialName	The Parting of the Ways
The Power of the Daleks	serialName	The Power of the Daleks
The Moonbase	serialName	33
The Massacre of St Bartholomew's Eve	serialName	The Massacre of St Bartholomew's Eve
The Celestial Toymaker	serialName	The Celestial Toymaker
The Gunfighters	serialName	The Gunfighters
The Smugglers	serialName	28
The Savages	serialName	The Savages
Destiny of the Daleks	serialName	Destiny of the Daleks
Death to the Daleks	serialName	Death to the Daleks
Colony in Space	serialName	Colony in Space
The King's Demons	serialName	The King's Demons
The Krotons	serialName	The Krotons
The Christmas Invasion	serialName	The Christmas Invasion
The Horns of Nimon	serialName	The Horns of Nimon
Nightmare of Eden	serialName	Nightmare of Eden
The Creature from the Pit	serialName	The Creature from the Pit
Kinda	serialName	Kinda
Time-Flight	serialName	Time-Flight
Snakedance	serialName	Snakedance
Frontios	serialName	Frontios
The Invasion	serialName	The Invasion
Warriors of the Deep	serialName	Warriors of the Deep
The Awakening	serialName	The Awakening
The Mind of Evil	serialName	The Mind of Evil
The Ambassadors of Death	serialName	The Ambassadors of Death
The Time Monster	serialName	The Time Monster
The Monster of Peladon	serialName	The Monster of Peladon
The Sea Devils	serialName	The Sea Devils
The Ice Warriors	serialName	The Ice Warriors
The Space Pirates	serialName	The Space Pirates
The Underwater Menace	serialName	The Underwater Menace
The Faceless Ones	serialName	The Faceless Ones
The Macra Terror	serialName	34
The Web of Fear	serialName	The Web of Fear
The Enemy of the World	serialName	The Enemy of the World
Fury from the Deep	serialName	Fury from the Deep
The Wheel in Space	serialName	The Wheel in Space
Death Comes to Time	serialName	Death Comes to Time
Slipback	serialName	Slipback
School Reunion	serialName	School Reunion
Tooth and Claw	serialName	Tooth and Claw
The Satan Pit	serialName	The Satan Pit
Army of Ghosts	serialName	Army of Ghosts
New Earth	serialName	New Earth
Downtime	serialName	Downtime
The Girl in the Fireplace	serialName	The Girl in the Fireplace
The Paradise of Death	serialName	The Paradise of Death
Doctor Who and the Pescatons	serialName	Doctor Who and the Pescatons
The Ghosts of N-Space	serialName	The Ghosts of N-Space
Doctor Who: Children in Need	serialName	Doctor Who: Children in Need
Attack of the Graske	serialName	Attack of the Graske
The Idiot's Lantern	serialName	The Idiot's Lantern
Doomsday	serialName	Doomsday
Rise of the Cybermen	serialName	Rise of the Cybermen
Fear Her	serialName	Fear Her
The Age of Steel	serialName	The Age of Steel
Love & Monsters	serialName	Love & Monsters
Shakedown: Return of the Sontarans	serialName	Shakedown: Return of the Sontarans
The Impossible Planet	serialName	The Impossible Planet
Tardisode	serialName	Tardisodes
Wartime	serialName	Wartime
The Highlanders	serialName	The Highlanders
The Runaway Bride	serialName	The Runaway Bride
Greeks Bearing Gifts	serialName	Greeks Bearing Gifts
Small Worlds	serialName	Small Worlds
Out of Time	serialName	Out of Time
Ghost Machine	serialName	Ghost Machine
Day One	serialName	Day One
Combat	serialName	Combat
Everything Changes	serialName	Everything Changes
Smith and Jones	serialName	Smith and Jones
Captain Jack Harkness	serialName	Captain Jack Harkness
Countrycide	serialName	Countrycide
They Keep Killing Suzie	serialName	They Keep Killing Suzie
Cyberwoman	serialName	Cyberwoman
End of Days	serialName	End of Days
Random Shoes	serialName	Random Shoes
Invasion of the Bane	serialName	Invasion of the Bane
The Shakespeare Code	serialName	The Shakespeare Code
Daleks in Manhattan	serialName	Daleks in Manhattan
The Lazarus Experiment	serialName	The Lazarus Experiment
Utopia	serialName	Utopia
The Family of Blood	serialName	The Family of Blood
The Infinite Quest	serialName	The Infinite Quest
42	serialName	42
Human Nature	serialName	Human Nature
Blink	serialName	Blink
The Sound of Drums	serialName	The Sound of Drums
Last of the Time Lords	serialName	Last of the Time Lords
Gridlock	serialName	Gridlock
Evolution of the Daleks	serialName	Evolution of the Daleks
Exploration Earth: The Time Machine	serialName	Exploration Earth: The Time Machine
Voyage of the Damned	serialName	Voyage of the Damned
Planet of the Ood	serialName	Planet of the Ood
Whatever Happened to Sarah Jane%3F	serialName	Whatever Happened to Sarah Jane?
Eye of the Gorgon	serialName	Eye of the Gorgon
Warriors of Kudlak	serialName	Warriors of Kudlak
The Lost Boy	serialName	The Lost Boy
Earth and Beyond	serialName	Bounty
Earth and Beyond	serialName	Dead Time
Earth and Beyond	serialName	The People's Temple
Revenge of the Slitheen	serialName	Revenge of the Slitheen
Time Crash	serialName	Time Crash
Reset	serialName	Reset
Doctor Who: A Celebration	serialName	Doctor Who: A Celebration
Kiss Kiss, Bang Bang	serialName	Kiss Kiss, Bang Bang
Partners in Crime	serialName	Partners in Crime
The Sontaran Stratagem	serialName	The Sontaran Stratagem
Sleeper	serialName	Sleeper
To the Last Man	serialName	To the Last Man
Adam	serialName	Adam
Meat	serialName	Meat
The Unicorn and the Wasp	serialName	The Unicorn and the Wasp
Midnight	serialName	Midnight
Dead Man Walking	serialName	Dead Man Walking
A Day in the Death	serialName	A Day in the Death
The Fires of Pompeii	serialName	The Fires of Pompeii
From Out of the Rain	serialName	From Out of the Rain
Something Borrowed	serialName	Something Borrowed
Adrift	serialName	Adrift
Exit Wounds	serialName	Exit Wounds
Fragments	serialName	Fragments
Silence in the Library	serialName	Silence in the Library
Forest of the Dead	serialName	Forest of the Dead
The Poison Sky	serialName	The Poison Sky
The Doctor's Daughter	serialName	The Doctor's Daughter
Journey's End	serialName	Journey's End
Turn Left	serialName	Turn Left
Pond Life	serialName	Pond Life
The Stolen Earth	serialName	The Stolen Earth
Lost Souls	serialName	Lost Souls
The Next Doctor	serialName	The Next Doctor
Music of the Spheres	serialName	Music of the Spheres
Planet of the Dead	serialName	Planet of the Dead
Doctor Who Prom	serialName	Prom 13: Doctor Who Prom
Secrets of the Stars	serialName	Secrets of the Stars
The Temptation of Sarah Jane Smith	serialName	The Temptation of Sarah Jane Smith
The Mark of the Berserker	serialName	The Mark of the Berserker
The Last Sontaran	serialName	The Last Sontaran
The Day of the Clown	serialName	The Day of the Clown
Arc of Infinity	serialName	Arc of Infinity
From Raxacoricofallapatorius with Love	serialName	From Raxacoricofallapatorius with Love
P.R.O.B.E.	serialName	The Zero Imperative
P.R.O.B.E.	serialName	The Devil of Winterborne
P.R.O.B.E.	serialName	Unnatural Selection
P.R.O.B.E.	serialName	Ghosts of Winterborne
P.R.O.B.E.	serialName	When to Die
The Waters of Mars	serialName	The Waters of Mars
The End of Time	serialName	The End of Time
Dreamland	serialName	Dreamland
Asylum	serialName	Asylum
Golden Age	serialName	Golden Age
The Dead Line	serialName	The Dead Line
Devious	serialName	Devious
The Wedding of Sarah Jane Smith	serialName	The Wedding of Sarah Jane Smith
Prisoner of the Judoon	serialName	Prisoner of the Judoon
Hornets' Nest	serialName	Hornets' Nest
The Mad Woman in the Attic	serialName	The Mad Woman in the Attic
The Gift	serialName	The Gift
Mona Lisa's Revenge	serialName	Mona Lisa's Revenge
The Eternity Trap	serialName	The Eternity Trap
The Beast Below	serialName	The Beast Below
Victory of the Daleks	serialName	Victory of the Daleks
The Eleventh Hour	serialName	The Eleventh Hour
The Time of Angels	serialName	The Time of Angels
Flesh and Stone	serialName	Flesh and Stone
The Vampires of Venice	serialName	The Vampires of Venice
Cold Blood	serialName	Cold Blood
The Pandorica Opens	serialName	The Pandorica Opens
Vincent and the Doctor	serialName	Vincent and the Doctor
Amy's Choice	serialName	Amy's Choice
The Hungry Earth	serialName	The Hungry Earth
The Lodger	serialName	The Lodger
Regeneration	serialName	Regeneration
Liberation	serialName	Liberation
The Korven	serialName	The Korven
The Bounty Hunter	serialName	The Bounty Hunter
Sirens of Ceres	serialName	Sirens of Ceres
Fear Itself	serialName	Fear Itself
The Fall of The House of Gryffen	serialName	The Fall of The House of Gryffen
The Big Bang	serialName	The Big Bang
The Nightmare Man	serialName	The Nightmare Man
The Vault of Secrets	serialName	The Vault of Secrets
The Empty Planet	serialName	The Empty Planet
Goodbye, Sarah Jane Smith	serialName	Goodbye, Sarah Jane Smith
Lost in Time	serialName	Lost in Time
Death of the Doctor	serialName	Death of the Doctor
A Christmas Carol	serialName	A Christmas Carol
Doctor Who Prom	serialName	Proms 10–11: Doctor Who Prom
Demon Quest	serialName	Demon Quest
Dead and Buried	serialName	Dead and Buried
Dæmos Rising	serialName	Dæmos Rising
The Rebel Flesh	serialName	The Rebel Flesh
The God Complex	serialName	The God Complex
The Impossible Astronaut	serialName	The Impossible Astronaut
 Time	serialName	Space\
The Doctor's Wife	serialName	The Doctor's Wife
The Almost People	serialName	The Almost People
The Curse of the Black Spot	serialName	The Curse of the Black Spot
Day of the Moon	serialName	Day of the Moon
Let's Kill Hitler	serialName	Let's Kill Hitler
Night Terrors	serialName	Night Terrors
The New World	serialName	The New World
The Lost Files	serialName	The Lost Files
Rendition	serialName	Rendition
Dead of Night	serialName	Dead of Night
The Girl Who Waited	serialName	The Girl Who Waited
Escape to L.A.	serialName	Escape to L.A.
The Categories of Life	serialName	The Categories of Life
Serpent Crest	serialName	Serpent Crest
The Middle Men	serialName	The Middle Men
Immortal Sins	serialName	Immortal Sins
Closing Time	serialName	Closing Time
The Wedding of River Song	serialName	The Wedding of River Song
End of the Road	serialName	End of the Road
The Gathering	serialName	The Gathering
The Blood Line	serialName	The Blood Line
The Doctor, the Widow and the Wardrobe	serialName	The Doctor, the Widow and the Wardrobe
Death Is the Only Answer	serialName	Death Is the Only Answer
Sky	serialName	Sky
The Curse of Clyde Langer	serialName	The Curse of Clyde Langer
The Man Who Never Was	serialName	The Man Who Never Was
Night and the Doctor	serialName	Night and the Doctor
The Snowmen	serialName	The Snowmen
Asylum of the Daleks	serialName	Asylum of the Daleks
The Bells of Saint John	serialName	The Bells of Saint John
The Crimson Horror	serialName	The Crimson Horror
Dinosaurs on a Spaceship	serialName	Dinosaurs on a Spaceship
A Town Called Mercy	serialName	A Town Called Mercy
The Power of Three	serialName	The Power of Three
The Angels Take Manhattan	serialName	The Angels Take Manhattan
P.S.	serialName	P.S.
Journey to the Centre of the TARDIS	serialName	Journey to the Centre of the TARDIS
A Fix with Sontarans	serialName	A Fix with Sontarans
Good as Gold	serialName	Good as Gold
Enemy of the Bane	serialName	Enemy of the Bane
A Good Man Goes to War	serialName	A Good Man Goes to War
Nightmare in Silver	serialName	Nightmare in Silver
The Rings of Akhaten	serialName	The Rings of Akhaten
Cold War	serialName	Cold War
Hide	serialName	Hide
The Day of the Doctor	serialName	The Day of the Doctor
The Name of the Doctor	serialName	The Name of the Doctor
The Time of the Doctor	serialName	The Time of the Doctor
Doctor Who Prom	serialName	Proms 2–3: Doctor Who Prom
Doctor Who Live: The Next Doctor	serialName	Doctor Who Live: The Next Doctor
The Night of the Doctor	serialName	The Night of the Doctor
The Last Day	serialName	The Last Day
Time Heist	serialName	Time Heist
Flatline	serialName	Flatline
Mummy on the Orient Express	serialName	Mummy on the Orient Express
Listen	serialName	Listen
Deep Breath	serialName	Deep Breath
Into the Dalek	serialName	Into the Dalek
The Caretaker	serialName	The Caretaker
Last Christmas	serialName	Last Christmas
Robot of Sherwood	serialName	Robot of Sherwood
In the Forest of the Night	serialName	In the Forest of the Night
Dark Water	serialName	Dark Water
Kill the Moon	serialName	Kill the Moon
Death in Heaven	serialName	Death in Heaven
The Magician's Apprentice	serialName	The Magician's Apprentice
The Witch's Familiar	serialName	The Witch's Familiar
The Woman Who Lived	serialName	The Woman Who Lived
The Girl Who Died	serialName	The Girl Who Died
The Husbands of River Song	serialName	The Husbands of River Song
Heaven Sent	serialName	Heaven Sent
Sleep No More	serialName	Sleep No More
The Zygon Inversion	serialName	The Zygon Inversion
The Zygon Invasion	serialName	The Zygon Invasion
Under the Lake	serialName	Under the Lake
Before the Flood	serialName	Before the Flood
Face the Raven	serialName	Face the Raven
Hell Bent	serialName	Hell Bent
