Arbor Day	significance	A holiday celebrating trees.
Bastille Day	significance	--07-14
Beltane	significance	beginning of summer
Christmas	significance	Commemoration of the birth of Jesus
Hanukkah	significance	The Maccabees successfully rebelled against Antiochus IV Epiphanes. According to the Talmud, a late text, the Temple was purified and the wicks of the menorah miraculously burned for eight days, even though there was only enough sacred oil for one day's lighting.
German Unity Day	significance	Commemorates the German reunification in 1990
Halloween	significance	First day of Allhallowtide
Imbolc	significance	beginning of spring
Kwanzaa	significance	Celebrates African heritage, unity, and culture.
Passover	significance	Celebrates the Exodus, the freedom from slavery of the Children of Israel from ancient Egypt that followed the Ten Plagues.
Passover	significance	4233600.0
Passover	significance	Connected to barley harvest in spring.
Palm Sunday	significance	commemorates Jesus' triumphal entry into Jerusalem
Pi Day	significance	31
Remembrance of the Dead	significance	Commemorates war dead
Samhain	significance	End of the harvest season, beginning of winter
Sukkot	significance	One of the three pilgrimage festivals
Yule	significance	List of winter festivals
Yom Kippur	significance	Atonement for personal and national sins, fate of each person is sealed for the upcoming year
Mother's Day	significance	Honors mothers and motherhood
Father's Day	significance	Honors fathers and fatherhood
Anzac Day	significance	National day of remembrance and first landing of the Anzacs at Gallipoli
Day of the Dead	significance	Prayer and remembrance of friends and family members who have died
Vesak	significance	The birth, enlightenment and death of Gautama Buddha
Italian unification	significance	--03-17
Remembrance Day	significance	Commemorates Commonwealth war dead
Juneteenth	significance	Emancipation of the last remaining enslaved persons in the United States
Tết	significance	Marks the first day of the lunar new year
Lughnasadh	significance	Beginning of the harvest season
Armistice Day	significance	Commemoration of the armistice signed between the Allies of World War I and Germany at Compiègne, France, for the cessation of hostilities on the Western Front of World War I
Columbus Day	significance	Celebrations honoring Christopher Columbus's Discovery of the Americas in 1492
Shichi-Go-San	significance	Traditional rite of passage and festival day in Japan for three- and seven-year-old girls and three- and five-year-old boys
Japanese New Year	significance	Celebrates the new year
Eid al-Fitr	significance	Marks the end of Ramadan fasting
Christmas Eve	significance	Day or evening preceding the traditional birthday of Jesus
Earth Day	significance	support for environmental protection
New Year's Day	significance	The first day of the Gregorian year
Buy Nothing Day	significance	Protest against consumerism
Saint Patrick's Day	significance	Feast day of Saint Patrick,commemoration of the arrival of Christianity in Ireland
Songkran	significance	Marks the Thai New Year
Valentine's Day	significance	Feast day of Saint Valentine; the celebration of love and affection
Purim	significance	Celebration of Jewish deliverance as told in the Book of Esther
Nowruz	significance	New Year holiday
Vernal Equinox Day	significance	Marks the vernal equinox in Japan Standard Time
Autumnal Equinox Day	significance	Commemorates the autumnal equinox
Victory in Europe Day	significance	End of World War II in Europe
Midsummer	significance	Marks the ancient middle of Summer, astronomical beginning of Summer, and the nativity of St. John the Baptist.
Shavuot	significance	4233600.0
Assumption of Mary	significance	the bodily taking up of the Virgin Mary into Heaven
New Year's Eve	significance	The final day of the Gregorian year
International Women's Day	significance	* Civil awareness day\n* Women and girls day\n*
International Women's Day	significance	Sexism
International Women's Day	significance	day\n* Anti-Discrimination Day
Respect for the Aged Day	significance	Honor elderly citizens
Onam	significance	Harvest festival
Hangul Day	significance	Commemorates the invention of hangeul
Festivus	significance	A holiday celebrated by those seeking an alternative to the commercialism and pressures of the Christmas holiday season.
Tisha B'Av	significance	Mourning the destruction of the ancient Temples and Jerusalem, and other major calamities which have befallen the Jewish people.
Mid-Autumn Festival	significance	Celebrates the end of the autumn harvest
Mahavir Jayanti	significance	Birth Anniversary of Mahavira
Simchat Torah	significance	The culmination of Sukkot and Shemini Atzeret. Final Parsha from Deuteronomy is read in synagogue. Everyone called to the Torah reading. Conclusion of the annual Torah reading cycle.\nRejoicing with the Torah.
Eid al-Adha	significance	* \n*
Thai Pongal	significance	345600.0
March 1st Movement	significance	Marks one of the first public displays of Korean resistance during the Japanese occupation of Korea
Qingming Festival	significance	Remembering past ancestors
Europe Day	significance	Establishment of the Council of Europe / Date of the Schuman Declaration
Thaipusam	significance	The festival commemorates the occasion when Parvati gave Murugan a Vel
Lantern Festival	significance	Marks the end of the Chinese New Year and is the Chinese equivalent of Valentine's Day
Ghost Festival	significance	The opening of the gates of Hell, permitting all ghosts to receive food and drink
Little Christmas	significance	visit of the Three Kings to Jesus, former date of Christmas
Makar Sankranti	significance	Festival of Harvest, Celebration of day after Winter Solstice
Ashura	significance	Marks the martyrdom  of Husayn ibn Ali according to Shi'a Islam; The day that Moses fasted as gratitude for the liberation of the Israelites according to Sunni Islam
Slava	significance	Veneration of the family's patron saint
Bon Festival	significance	Honors the spirits of one's ancestors
Children's Day	significance	Celebrates children's personalities and their happiness
Coming of Age Day	significance	Congratulates and encourages all those who have reached the age of majority  over the past year and celebrates adulthood
The Emperor's Birthday	significance	Marks the birth date of the Emperor of Japan
Setsubun	significance	Day before the beginning of spring
Pioneer Day	significance	--07-24
Thrissur Pooram	significance	Hindu
Thrissur Pooram	significance	Temple Festivals of Kerala
Tenth of Tevet	significance	Remembers the siege of Jerusalem by Nebuchadnezzar II of Babylonia
Seventeenth of Tammuz	significance	Date when the walls of Jerusalem were breached
Jerusalem Day	significance	The reunification of Jerusalem under Israeli control after the Six-Day War. The first time Jews control Jerusalem since the Destruction of the Second Holy Temple by the Romans in 70 AD.
Twelfth Night	significance	evening prior to Epiphany
Norwegian Constitution Day	significance	--05-17
Saint Nicholas Day	significance	Feast day of Saint Nicholas
Fast of Gedalia	significance	Mourning the assassination of Gedaliah
Republic Day	significance	--07-04
Republic Day	significance	Later, celebration of friendship between the peoples of the Philippines and the United States
Independence Day	significance	The day in 1776 that the Declaration of Independence was adopted by the Continental Congress
Kamehameha Day	significance	Unification of the Hawaii by Kamehameha I.
Darwin Day	significance	The day celebrates Darwin's life and work
Chuseok	significance	Celebrates the harvest
Birkat Hachama	significance	Traditionally, the coincidence of the Sun's return to its location during the Creation of the world at the time of the week at which it was created
Alaska Day	significance	Formal transfer of Alaska from Russia to the United States
Prince Kūhiō Day	significance	Birth of Prince Kūhiō and passage of Hawaiian Homelands Act.
Epiphany	significance	In Western Christianity: commemoration of the Adoration of the Magi, with subordinate commemorations of the Baptism of Jesus and the Wedding at Cana. In Eastern Christianity: commemoration of the Baptism of Jesus only.
Trafalgar Day	significance	Commemorates British naval victory over Spanish and French forces in 1805
Black History Month	significance	Celebration of African-American history
Hoshana Rabbah	significance	The culmination of Sukkot.
Trinidad and Tobago Carnival	significance	Week before Lent
Maha Shivaratri	significance	Auspicious day to worship the Lord Shiva beyond birth and death.
Lincoln's Birthday	significance	Honors 16th President of the United States
Bhau-beej	significance	Public holiday in Nepal
Laylat al-Qadr	significance	Night the Quran was revealed;
Laylat al-Qadr	significance	Angels descend to the earth and the annual decree is revealed to them;
Laylat al-Qadr	significance	2.6298E9
Cambodian New Year	significance	Marks the Cambodian New Year
Karthikai Deepam	significance	Formation of Arumugam (Murugan)
Feast of the Immaculate Conception	significance	Belief in the most pure and sinless conception of the Blessed Virgin Mary without Original Sin
Mawlid	significance	Traditional commemoration of the birth of Muhammad
Dongzhi Festival	significance	Marks the winter solstice
Mahamastakabhisheka	significance	Completion of the statue of Gommateshwara
Vaisakhi	significance	The beginning of the harvest season, Punjabi New Year, Solar new year and birth of the Khalsa
Rizal Day	significance	Commemoration of the life and works of José Rizal
International Mother Language Day	significance	\
Lohri	significance	Midwinter festival, celebration of Winter Solstice
Lee–Jackson–King Day	significance	Southern United States
Tsagaan Sar	significance	New Year holiday
Black Day	significance	A third 'day marketing' holiday following Valentine's Day and White Day
Afghan Independence Day	significance	Marks Afghanistan's regaining of full independence from British influence in 1919.
Hari Merdeka	significance	Marks the independence of the Federation of Malaya
Chhath	significance	To thank Surya  for bestowing the bounties of life on earth and fulfilling particular wishes
Seward's Day	significance	Signing of the Alaska Purchase treaty
Lag BaOmer	significance	33
Constitution Day	significance	The anniversary of the signing of the Danish constitution of 1849, which established Denmark as a constitutional monarchy, and honours the constitution of 1953, which was adopted on the same date.
St Mark's Eve	significance	Day before the feast day of St. Mark the Evangelist
Reunification Day	significance	Marks the North Vietnamese capture of Saigon
World Environment Day	significance	This day is observed to create global awareness about environmental problems the world or a specific country is facing.
Fast of the Firstborn	significance	This fast commemorates the salvation of the Israelite firstborns during the Plague of the Firstborn
Gandhi Jayanti	significance	Honours Mohandas Karamchand Gandhi's role in Indian Independence.
Buddha's Birthday	significance	Celebrates the birthday of Gautama Buddha
Shōwa Day	significance	honors the birthday of the Shōwa Emperor , the reigning Emperor from 1926 to 1989
National Sorry Day	significance	Remember and commemorate the mistreatment of the Australia's indigenous population
Aldersgate Day	significance	Commemorates the founding of John Wesley's ministry and the Methodist movement
Union Dissolution Day	significance	remembrance of the Norwegian parliament's 1905 declaration of dissolution of the union with Sweden
Puthandu	significance	Tamil New Year
Memorial Day	significance	Commemorates Newfoundland and Labrador war dead
The Twelfth	significance	Celebration of the Glorious Revolution  and victory of William of Orange at the Battle of the Boyne
Leif Erikson Day	significance	Recognize contributions of Americans of Nordic descent
Kupala Night	significance	celebration relates to the summer solstice
Marine Day	significance	Honors the blessings of the oceans and economic prosperity of maritime Japan
Fast of Esther	significance	Commemorating the three-day fast observed by the Jewish people in the story of Purim
Blessed Rainy Day	significance	marks the end of the monsoon season
Giant Lantern Festival	significance	Celebrates the start of the Christmas season in the Philippines
Nag Panchami	significance	nag-panchami
National Liberation Day of Korea	significance	Commemorates Victory over Japan Day, in which the United States and the Soviet Union liberated Korea from Imperial Japanese colonial rule which lasted from 1910 to 1945.
Royal Hobart Show	significance	Royal Agricultural Society of Tasmania
Unification Day	significance	Honours the Unification of Bulgaria and Eastern Rumelia in 1885
LGBT History Month	significance	Celebration of LGBT history
National Day of Catalonia	significance	Commemorates the fall of Barcelona during the War of the Spanish Succession in 1714 and the subsequent lost of Catalan liberties, institutions and laws.
Freedom Day	significance	In remembrance of the withdrawal of British troops from Malta.
Enkutatash	significance	First day of the Ethiopian year
Fiji Week	significance	anniversary of independence in 1970
Fiestas de Santa Fe	significance	--09-16
Commemoration of Atatürk, Youth and Sports Day	significance	--05-19
Victory Day	significance	In remembrance of the victories in the Sieges of Malta of 1565, 1800 and 1943.
Vimy Ridge Day	significance	Remembrance of the Battle of Vimy Ridge
Defenders Day	significance	Anniversary of the successful defense of the city of Baltimore from an invading British force during the War of 1812.
Evacuation Day	significance	Date when the last British troops left New York
Maryland Day	significance	Anniversary of first colonists landing at St. Clement's Island
In town, without my car!	significance	Bring attention to more environmental-friendly vehicles
National Hispanic Heritage Month	significance	Celebration of Hispanic and Latino Americans contributions
Mid-Sha'ban	significance	Salvation
Gaecheonjeol	significance	Celebrates the myth of the founding of the state of Gojoseon
Native American Day	significance	A day in honor of Native Americans
Mamankam festival	significance	The fortnight when moon waxes in the month of Maagha of Saka calendar
Hōnen Matsuri	significance	Celebrates the blessings of a bountiful harvest and all manner of prosperity and fertility
The event of Ghadir Khumm	significance	Appointment of Ali as the successor of Muhammad according to Shia
Labor Thanksgiving Day	significance	Commemorates labor and production and giving one another thanks; formerly a harvest festival
Culture Day	significance	Promotes culture, the arts, and academic endeavour
Constitution Memorial Day	significance	Celebrates the promulgation of the 1947 Constitution of Japan
National Foundation Day	significance	Celebrates the founding of the nation
Health and Sports Day	significance	commemorates the opening of the 1964 Summer Olympics in Tokyo
Guru Nanak Gurpurab	significance	Guru Nanak's Birth anniversary
Independence Day	significance	The day the Declaration of Independence was adopted by the Parliament of Finland
Irish-American Heritage Month	significance	Celebration of Irish-Americans contributions
Hong Kong Special Administrative Region Establishment Day	significance	Marks the transfer of Hong Kong from the United Kingdom to China
Karnataka Rajyotsava	significance	Unification of Kannada-speaking regions of South India as the state of Karnataka
Songkran	significance	Marks the Lao New Year
Old New Year	significance	The first day of the Julian year
Philippine Independence Day Parade	significance	The celebration of the Philippine Declaration of Independence from Spain
Education and Sharing Day	significance	Celebration of hard work, service and commitment to learning
Maslenitsa	significance	last week before Great Lent
Parinirvana Day	significance	Day when the Buddha is said to have achieved Parinirvana, or complete Nirvana, upon the death of his physical body
Thingyan	significance	Marks the Burmese New Year
19 Kislev	significance	Release of the founder of Chabad Hasidism, Rabbi Shneur Zalman of Liadi, from a Russian prison
Tatiana Day	significance	Russian Students Day
Racial Harmony Day	significance	Commemorates the 1964 race riots
Armenian Genocide Remembrance Day	significance	Commemoration of the Armenian Genocide
Cosmonautics Day	significance	A celebration to commemorate the first manned earth orbit
Isru chag	significance	Follows each of the Three Pilgrimage Festivals. Serves to bridge the respective holidays to the rest of the year.
San Jacinto Day	significance	Battle of San Jacinto in 1836
Maharashtra Day	significance	The day the state of Maharashtra was formed by the Bombay Reorganisation Act, 1960
World Vegetarian Day	significance	First day of Vegetarian Awareness Month
Victory Day	significance	Operation Storm
Filipino American History Month	significance	Celebration of Filipino American history
Battle of Saragarhi	significance	Honors the 21 military Sikh soldiers who died at the Battle of Saragarhi
International Romani Day	significance	Civil awareness day
International Romani Day	significance	Romani society and culture
Sette Giugno	significance	In remembrance of an uprising against profiteering merchants and the British colonial government, seen as the first step towards Maltese Independence.
Independence Day	significance	Declaring Philippine independence from Spain
National Heroes Day	significance	Honours distinguished individuals for significant contributions to the nation
Loving Day	significance	Anniversary of Supreme Court decision Loving v. Virginia
Transfer Day	significance	marks the transfer of the islands from Denmark to the United States that took place in 1917
Statehood Day	significance	commemorate the coronation in 1253 of Mindaugas as the first and only King of Lithuania
Gunla	significance	Celebrates rains retreat started by the Buddha
Nepal Sambat	significance	New Year's Day of Nepal's national lunar calendar
Constitution Day	significance	Marks the proclamation of the South Korean constitution
Workers' Memorial Day	significance	work environment, occupational safety and health
Swiss National Day	significance	Anniversary of the Federal Charter of 1291
Wasshoi Hyakuman Natsumatsuri	significance	Celebrates the 25th anniversary of the creation of the city
Saiō Matsuri	significance	Celebrates the town's history of once being an Imperial residence
Independence Day	significance	National
Nativity of St John the Baptist	significance	Celebrates the birth of John the Baptist, Jesus’ precursor and relative
Pregnancy and Infant Loss Remembrance Day	significance	Recognition and raise awareness of, the prominence of pregnancy loss and infant death with an aim to support families who experience the death of their children and to increase, awareness, remembrance, support programs and services for families who experience bereavement.
Christmas and holiday season	significance	Christian and secular festive season
Bodhi Day	significance	The enlightenment of Buddha
Mimouna	significance	Celebration of the end of prohibition of chametz
Korean New Year	significance	The first day of the Korean calendar
Oktoberfest celebrations	significance	Celebration of the German culture
Fiestas Patrias	significance	Date of the First National Meeting of Government in 1810.
Dhanteras	significance	worship of Dhanvantari
Queene's Day	significance	accession of Queen Elizabeth I to the throne in 1558
Unity Day	significance	Expelling the Polish occupation forces from Moscow in November 1612, end of the Time of Troubles and turning point of the Polish-Muscovite War (1605–1618)
Royal Hobart Regatta	significance	Australia's Largest Aquatic Event
Thanksgiving	significance	A celebration of being thankful for what one has and the bounty of the previous year.
Ferragosto	significance	Catholic feast of the Assumption of Mary
Winter solstice	significance	Astronomically marks the beginning of shortening nights and lengthening days
Day of Arafah	significance	Commemoration of prophet Muhammad's  final sermon and completion of the message of Islam.  Marks the second day of the Pilgrimage or Hajj for the millions of Muslims who make the trip to Makkah each year.  A day on which Muslims who did not go to Hajj fast to repent for their sins.
St. Clement's Day	significance	special holiday for metalworkers and blacksmiths
Day of Remembrance for Truth and Justice	significance	Commemoration of the 1976 Argentine coup d'état
Malaysia Day	significance	Marks the establishment of the Malaysian federation
Sami National Day	significance	--02-06
Finnish Swedish Heritage Day	significance	Date on which King Gustavus Adolphus of Sweden was killed at the Battle of Lützen (1632)
Hadaka Matsuri	significance	Celebrates the blessings of a bountiful harvest and all manner of prosperity and fertility
Western Australia Day	significance	Foundation of Western Australia in 1829
April Fools' Day	significance	Practical Jokes
Royal Ploughing Ceremony	significance	Marks the beginning of the rice growing season
Sanja Matsuri	significance	Honors Hinokuma Hamanari, Hinokuma Takenari and Hajino Nakatomo, the three founders of Sensō-ji
Statehood Day	significance	Admission of Hawaii into the Union.
Geek Pride Day	significance	Non-denominational holiday celebrating geek culture
Bennington Battle Day	significance	commemorating the victory at the Battle of Bennington in 1777
Armed Forces Day	significance	Celebration of the contributions, both past and present, of those who have served in the British Armed Forces
Flag Day	significance	Commemoration of the death of Manuel Belgrano, creator of the Flag of Argentina.
Yaldā Night	significance	Longest night of the year
Hùng Kings' Festival	significance	Anniversary of Hung Vuong
Independence Day	significance	Commemorates the independence of Pakistan
Courir de Mardi Gras	significance	Celebration prior to fasting season of Lent
Royal Geelong Show	significance	Royal Geelong Agricultural & Pastoral Society Incorporated
Yukka Nu Hii	significance	Giving thanks to the sea and agricultural gods and asking for their continued help for the future
Mourning of Muharram	significance	Marks the death of Hussein ibn Ali
National Independence Day	significance	To commemorate the recovery of a sovereign state by the Poles in 1918
Singles' Day	significance	Day for singles to celebrate and socialize
11 Nissan	significance	Birthday of the seventh Rebbe of Chabad Hasidism, Rabbi Menachem Mendel Schneerson
National Youth Day	significance	Birthday of Swami Vivekananda
Festa della Repubblica	significance	Italy became a republic after the results of a constitutional referendum
Federal Territory Day	significance	Marks the establishment of the Federal Territory
Mid-Pentecost	significance	Celebrates Christ as Teacher
Thursday of the Dead	significance	Honours the souls of the dead
Arattupuzha Pooram	significance	oldest temple festival
Royal Launceston Show	significance	Royal National Agricultural and Pastoral Society of Tasmania Limited
Pakistan Day	significance	Commemoration of Pakistan Resolution and Constitution
Shayani Ekadashi	significance	beginning of the chaturmas
DNA Day	significance	The day celebrates the discovery and understanding of DNA and the scientific advances that understanding has made possible.
Star Wars Day	significance	Celebrating Star Wars
Sakela	significance	Worship of Nature and Ancestors.
Guanacaste Day	significance	Celebration of Costa Rican annexation
Virgen de los Angeles	significance	Celebration ofsome of costaricans patron saint
Triumph of the Revolution	significance	Anniversary of 1958 revolution
International Day of United Nations Peacekeepers	significance	Commemorates sacrifice made by UN personnel on peacekeeping missions.
Martyrs' Day	significance	Syrian and Lebanese nationalists executed in Damascus and Beirut by the Ottomans
Samjinnal	significance	Marks arrival of spring
Koninkrijksdag	significance	The commemoration of the signing of the Charter of the Kingdom of the Netherlands
Nuakhai	significance	Harvest festival
Hıdırellez	significance	Prophets Hızır and Ilyas
Women's Equality Day	significance	Anniversary of 19th Amendment giving women the right to vote
Feast of Saint George	significance	Requests from Saint George  for protection
National Day	significance	Commemorates of Singapore's independence from Malaysia in 1965
Haitian Heritage Month	significance	Celebration of Haitian contributions
Gustavus Adolphus Day	significance	Anniversary of the death of King Gustavus Adolphus of Sweden at the Battle of Lützen (1632)
Native American Heritage Day	significance	A day in honor of Native Americans
Día de la Altagracia	significance	feast day for \
Laba Festival	significance	Celebrates the new harvest, etc.
Jewish American Heritage Month	significance	Annual recognition of Jewish American achievements and contributions to the United States.
Australia Day	significance	Date of landing of First Fleet in Port Jackson in 1788
International Francophonie Day	significance	*
International Francophonie Day	significance	French language
International Francophonie Day	significance	* Francophone culture
Revolution Day	significance	Anniversary of the start of the Mexican Revolution, one of five Fiestas Patrias
Prince Rainier Day	significance	anniversary of the coronation of Rainier III, Prince of Monaco
Koliada	significance	celebration of New Year birth
Robert E. Lee Day	significance	Southern United States
Indiana Day	significance	Anniversary of the admission of Indiana into the Union
Statehood Day	significance	commemorate the day in 1878 on which the Berlin Congress recognized Montenegro as an independent state
Yhyakh	significance	Start of the year
World UFO Day	significance	A day celebrating UFOs.
World Contact Day	significance	A day attempting to make ET contact
Kullu Dussehra	significance	Congregation of Deities
Independence Day	significance	The day of the Declaration of Independence of Brazil
Republic Day	significance	The day the Republic of Macedonia proclaimed its statehood in 1944
Republic Day	significance	The day of the Ilinden Uprising and the proclamation of Kruševo Republic in 1903.
Koningsdag	significance	Birthday of King Willem-Alexander of the Netherlands
Varalakshmi Vratam	significance	Religious
Islam Day	significance	Arrival of Mohammad to Medina and recognition of Islam and Muslims.
Indigenous Peoples' Day	significance	A day in honor of Native Americans
Prabodhini Ekadashi	significance	end of the chaturmas
Totensonntag	significance	Remembrance of the Faithful Departed
Mattu Pongal	significance	Part of Harvest festival of Pongal. Thanks giving to Cattle
European Day of Remembrance for Victims of Stalinism and Nazism	significance	Day of remembrance for the victims of totalitarian and authoritarian regimes
Mandi Shivaratri Fair	significance	Shivaratri Puja
Evacuation Day	significance	Evacuation of the last French soldier and Syria's proclamation of full independence
Cinco de Mayo	significance	--05-05
Blasphemy Day	significance	A day celebrating blasphemy
National Public Gardens Day	significance	Celebrate and Recognize Botanic Gardens, Arboreta, and Public Gardens
Independence Day of Republic of Moldova	significance	The day the Declaration of Independence was adopted by the Parliament of the Republic of Moldova
Occupation of the Latvian Republic Day	significance	recall the Soviet occupation of Latvia in 1940
Independence Day of Ukraine	significance	The day the Declaration of Independence was adopted by the Supreme Soviet in 1991
Bhai Phonta	significance	Public holiday in West Bengal
Sitalsasthi	significance	marriage of Shiva and Parvati
Festival Folclórico y Reinado Nacional del Bambuco	significance	Feast of Saint Peter and Saint John.
Groundhog Day	significance	Predicts the arrival of spring
Baci	significance	Celebration of any auspicious event
140th Year Anniversary Celebration of the Emancipation Proclamation	significance	Spirit, strength and legacy of freedom, justice and equality for all people of America
Peter and Fevronia Day	significance	Love and Fidelity celebrated between marrieds
Pana Sankranti	significance	New Year in sidereal and tropical astrology
National Sovereignty Day	significance	The day the Argentine Confederation fought against an Anglo-French navy in the Battle of Vuelta de Obligado, during the Anglo-French blockade of the Río de la Plata
National Day	significance	Marks the UAE's formal nationalisation in 1971.
Albanian Flag Day	significance	The day the Declaration of Independence was adopted by Ismail Qemali
Carnival of Madeira	significance	Four days before Ash Wednesday
National Voters' Day	significance	new voters are enrolled in the electoral rolls
Tu BiShvat	significance	The fruits that ripened from Tu BiShvat on were counted for the following year's tithes if the tree was not in a Sabbatical year. Its role is important to the concept of Chadash.
Rama Navami	significance	Birth day of Rama
Rama Navami	significance	Marriage ceremony of Rama and Sita Sita is the only wife of Rama
Mha Puja	significance	Spiritual purification for new year
Flag Day	significance	Anniversary of the first flying of the Australian National Flag in 1901
The 11-day weekend	significance	Calendar
Saint George's Day in England	significance	Feast day of Saint George  as national saint of England
National Veterans' Day	significance	remembrance day for all the war veterans in Finland
Okinawa Memorial Day	significance	Remembrance of those lost in the Battle of Okinawa
May 3rd Constitution Day	significance	--05-03
Yenya	significance	Unity of Local People of Kathmandu
Martyred Intellectuals Day	significance	commemoration of executions of Bengali intellectuals
Qatar National Day	significance	--12-18
10 Kislev	significance	Release of the second Rebbe of Chabad Hasidism, Rabbi Dovber Schneuri from a Czarist imprisonment
Christmas in Romania	significance	in memory of the birth of Jesus
Akwasidae Festival	significance	Festival of commemoration of ancestors
Independence Day	significance	The day of the Declaration of Independence of Myanmar
Independence Day	significance	The day when citizens of Bosnia and Herzegovina voted for the independence on the independence referendum in 1992.
Maithili New Year	significance	Maithili New Year
Songkran	significance	Marks the new year
Independence Day	significance	The day Eritrea declared independence from Ethiopia
International Day of Radiology	significance	Anniversary of the discovery of the X-ray, raises awareness of the benefits of medical imaging
Day of Victory in the Great Fatherland Liberation War	significance	End of the Korean War
National Day	significance	Declaring Vietnam Independence from French Colonization
Gibraltar Diamond Jubilee Flotilla	significance	Diamond Jubilee of Elizabeth II
National Honey Bee Day	significance	Honoring honey bees and beekeepers
Azores Day	significance	A celebration of the Azores autonomy, following the Carnation Revolution, the holiday transformed into a historical, cultural and social affirmation of the region
Rosh Hashanah LaBehema	significance	Tithing domestic animals
National Honey Month	significance	Celebrating nature’s original sweetener.
Día Mundial de Ponce	significance	Celebration of the historical and cultural heritage of the city and its citizens
Saudi National Day	significance	Establishing of Saudi Arabia
International Day of the Girl Child	significance	Raise awareness of issues facing girls internationally surrounding education, nutrition, child marriage, legal and medical rights
Dev Deepawali	significance	Tripura Purnima or worship of Lord Shiva
Amalaka Ekadashi	significance	Vishnu, Lakshmi, Damodara  and Radha said to reside near the tree
Pausha Putrada Ekadashi	significance	For having a son
Shravana Putrada Ekadashi	significance	Fasting day
Independence Day	significance	The day when the Croatian Parliament cut all relations with the former Yugoslavia
Mokshada Ekadashi	significance	Fasting day
Adae Kese Festival	significance	Festival establishing link and a level of faith and solidarity between the living and the ancestral spirits.
Move Your Domain Day	significance	Caused thousands of domain transfers
Kamada Ekadashi	significance	Fasting day
Ashanti Yam Festival	significance	Festival of Purification
Awukudae Festival	significance	Festival of ancestral rites
Varuthini Ekadashi	significance	Fasting day
Datta Jayanti	significance	Fasting, meditation and prayers day
Tibb's Eve	significance	Beginning of the Christmas season
Dożynki	significance	The end of the harvest crops
Pesach Sheni	significance	Day to make up the Korban Pesach  if missed on Passover
Evelio Javier Day	significance	Marks the day in 1986 that Gov. Javier was assassinated, which led in part to the successful People Power Revolution later that month.
Constitution Day	significance	The anniversary of the signing of the Ukrainian constitution of 1996
Ulcinj Municipality Day	significance	End of olive collection
Ulcinj Municipality Day	significance	Sailor output at the sea
Ulcinj Municipality Day	significance	Touristic season begins
Jana Baha Dyah Jatra	significance	Spreads peace in the city
Siblings Day	significance	Honoring relationships of siblings
Liberation Day	significance	Celebrates the end of the Fascist regime and the end of the Nazi occupation of Italy
Festival Nacional de la Quenepa	significance	The city's official fruit
Independence Day	significance	Establishment of the Somali Republic
Belgian National Day	significance	Anniversary of the date in 1831 that Leopold I swore allegiance to the constitution as the first King of the Belgians
Founder's Day	significance	Honour founding fathers of Ghana
Independence Day	significance	Inauguration of Djibouti as an independent nation.
Veterans' Day	significance	day of remembrance for the country's servicemen
Independence Day	significance	The day the Declaration of Independence was adopted by the Turkmen SSR Supreme Soviet in 1991
Day of Neutrality	significance	The day the adoption of UN General Assembly Resolution №50/80
National Entrepreneurs' Day	significance	Celebrates the American men and women who promote entrepreneurship, business, innovation, and new jobs
Independence Day	significance	National
National Cat Day	significance	None
Sama Chakeva	significance	signifies the brother and sister relationship
Armed Forces Day	significance	Battle of Warsaw
Fiesta Nacional de la Danza	significance	The city's native musical genre
June 10th Movement	significance	Marks one of the first public displays of Korean resistance during the Japanese occupation of Korea organized by students
Bhogi	significance	Midwinter festival
National Brush Day	significance	To reinforce the importance of children’s oral health
Father's Day	significance	Honors fathers and fatherhood
Independence Day	significance	commemorate Independence from the United Kingdom
Lal Loi	significance	Midwinter festival, celebration of Winter Solstice
Feria de Artesanías de Ponce	significance	Indigenous and native traditions
Davao City Torotot Festival	significance	The final day and first day of the Gregorian year, Firecracker ban
Bunga Dyah Jatra	significance	Spreads peace in the city
22 Shvat	significance	Passing of Rebbetzin Chaya Mushka Schneerson, the wife of Rabbi Menachem Mendel Schneerson, seventh Rebbe of Chabad Hasidism
12-13 Tammuz	significance	Release of the sixth Rebbe of Chabad Hasidism, Rabbi Yosef Yitzchak Schneersohn from a Soviet imprisonment
1 Kislev	significance	Recovery of the seventh Rebbe of Chabad Hasidism, Rabbi Menachem Mendel Schneerson from a heart attack
Independence Day	significance	Act of Independence of Georgia
Sarawak Self-government Day	significance	Marks the establishment of the self-government in Sarawak
Unity Day	significance	anti-bullying, bullying awareness, solidarity with victims of bullying
North Borneo Self-government Day	significance	Marks the establishment of the self-government North Borneo
Chandeshwori Jatra	significance	Victory over demon Chandasur
Sangken	significance	Marks the New Year
Quds Day	significance	Demonstrations against the existence of Israel, and its control of Jerusalem; solidarity with the Palestinian people
Agrasen Jayanti	significance	Birth Anniversary of Agrasena
Rashtriya Ekta Diwas	significance	Celebrating the birthday of Vallabhbhai Patel
International Yoga Day	significance	Official United Nations promotion of global health, harmony and peace
Bal Diwas	significance	Birthday of Jawahar Lal Nehru
Evolution Day	significance	The anniversary of the initial publication of Darwin's Origin of Species, which introduced the concepts of evolution and natural selection to the public.
Blue Mass	significance	Honor veterans of the Public Safety field
Good Governance Day	significance	Birth anniversary of Atal Bihari Vajpayee
World Religion Day	significance	Interfaith celebration of the oneness of religion and its role in human society
Kansas Day	significance	Admission of Kansas into the Union.
Las Mañanitas	significance	Celebration in honor of Our Lady of Guadalupe, the patron lady of the city
National Sanitation Day	significance	Clean-up exercise across Ghana
Mesha Sankranti	significance	Solar new year. Regional new year festivals.
Day of the Sun	significance	Birth of Kim Il-sung
Liberation Day	significance	commemorates liberation from Japanese occupation
Menstrual hygiene day	significance	To break taboos surrounding menstruation, raise awareness of the importance of good menstrual hygiene management worldwide.
Remembrance Day	significance	Commemorates the war dead
Commemoration Day	significance	Marked annually from 2015, remembering fallen soldiers
Higalaay Festival	significance	feast day of St. Augustine, patron saint of the city
Party Foundation Day	significance	Founding of the North Korea Bureau of the Communist Party of Korea , a predecessor to the Workers' Party of Korea
Marathwada Liberation Day	significance	Marathwada became part of India
Royal Toowoomba Show	significance	Royal Agricultural Society of Queensland
Independence Day	significance	Independence from the United Kingdom in 1966.
Batik Day	significance	The day that UNESCO recognized batik
Pope John Paul II Day	significance	Commemorates the election of Cardinal Karol Wojtyła to become Pope
Sovereignty Day	significance	Last Yugoslav soldier left Slovenia in 1991
Beñesmen	significance	Harvest Festival, New Year
Constitution Day	significance	India adopted constitution in 1949
Limassol Carnival Festival	significance	Social
Limassol Carnival Festival	significance	Religious
Limassol Carnival Festival	significance	Economic
Pusnâ	significance	Marks the arrival of spring
Lui Ngai Ni	significance	Seed sowing festival of the Nagas in Manipur
Flag Day	significance	Anniversary of the inauguration of Sheikh Khalifa bin Zayed Al Nahyan as President, Commemoration of the founders of UAE.
International Book Year	significance	Raise awareness about the heritage value of the book for humanity.
Sekrenyi festival	significance	New Year
SumBingTik Festival	significance	The town's delicacies, suman, bibingka, and latik
Feast of Our Lady of the Hens	significance	Feast day of the Madonna delle Galline , commemoration of the finding of the miraculous Marian icon
Day of Songun	significance	Beginning of the Songun leadership of Kim Jong-il
Yom HaAliyah	significance	Celebrating Aliyah as a core value of the Jewish People and honoring the ongoing contributions of Olim to Israeli society. On the tenth of the Hebrew month of Nisan according to the Bible, Joshua and the Israelites crossed the Jordan River at Gilgal into the Promised Land.
Carnival in Belize	significance	Celebration of life using astounding colors
