John Woo	simpchinesename	吴宇森
Jet Li	simpchinesename	李连杰
Chow Yun-fat	simpchinesename	周润发
Sammo Hung	simpchinesename	洪金宝
Roman Tam	simpchinesename	罗文
Michelle Yeoh	simpchinesename	杨紫琼
Zhang Yimou	simpchinesename	张艺谋
Wayne Wang	simpchinesename	王颖
Leslie Cheung	simpchinesename	张国荣
Brandon Lee	simpchinesename	李国豪
Tony Leung Chiu-wai	simpchinesename	梁朝伟
Ge You	simpchinesename	葛优
Joseph Koo	simpchinesename	顾嘉辉
Joan Chen	simpchinesename	陈冲
Lai Man-Wai	simpchinesename	黎民伟
Chang Chen	simpchinesename	张震
Christopher Doyle	simpchinesename	杜可风
Chen Kaige	simpchinesename	陈凯歌
Michael Hui	simpchinesename	许冠文
Stanley Kwan	simpchinesename	关锦鹏
Sally Yeh	simpchinesename	叶倩文
Teresa Teng	simpchinesename	邓丽君
Priscilla Chan	simpchinesename	陈慧娴
William Hung	simpchinesename	孔庆翔
Jing Tian	simpchinesename	景甜
A-mei	simpchinesename	张惠妹
Josie Ho	simpchinesename	何超仪
King Hu	simpchinesename	胡金铨
MC Jin	simpchinesename	欧阳靖
Bai Ling	simpchinesename	白灵
Stephen Chow	simpchinesename	周星驰
Jay Chou	simpchinesename	周杰伦
Yuen Biao	simpchinesename	元彪
Joey Yung	simpchinesename	容祖儿
Teresa Cheung	simpchinesename	张德兰
Juno Mak	simpchinesename	麦浚龙
Gigi Leung	simpchinesename	梁咏琪
Vanness Wu	simpchinesename	吴建豪
Deep Ng	simpchinesename	吴浩康
Evonne Hsu	simpchinesename	许慧欣
Stephanie Cheng	simpchinesename	郑融
Samuel Hui	simpchinesename	许冠杰
Gregory Charles Rivers	simpchinesename	河国荣
John Lone	simpchinesename	尊龙
Chen Daoming	simpchinesename	陈道明
Maggie Lau	simpchinesename	刘思惠
Miriam Yeung	simpchinesename	杨千嬅
Stefanie Sun	simpchinesename	孙燕姿
Ann Hui	simpchinesename	许鞍华
Carina Lau	simpchinesename	刘嘉玲
Danny Chan	simpchinesename	陈百强
Rebecca Pan	simpchinesename	潘迪华
Eason Chan	simpchinesename	陈奕迅
Angie Cheong	simpchinesename	张慧仪
Chang Cheh	simpchinesename	张彻
James Wong	simpchinesename	黄沾
Vangie Tang	simpchinesename	邓颖芝
Yuen Wah	simpchinesename	元华
Ma Sanli	simpchinesename	马三立
F.I.R.	simpchinesename	飞儿乐团
Y2J	simpchinesename	神木与瞳
Felix Wong	simpchinesename	黄日华
Alan Tam	simpchinesename	谭咏麟
Adam Cheng	simpchinesename	郑少秋
Wong Ka Kui	simpchinesename	黄家驹
Wong Ka Keung	simpchinesename	黄家强
Paul Wong	simpchinesename	黄贯中
Yip Sai Wing	simpchinesename	叶世荣
Tony Leung Ka-fai	simpchinesename	梁家辉
Kit Chan	simpchinesename	陈洁仪
Anita Yuen	simpchinesename	袁咏仪
Richard Lam	simpchinesename	林振强
Paula Tsui	simpchinesename	徐小凤
Sean Lau	simpchinesename	刘青云
Francis Ng	simpchinesename	吴镇宇
Feng Xiaogang	simpchinesename	冯小刚
Simon Yam	simpchinesename	任达华
Deanie Ip	simpchinesename	叶德娴
Ann Mui	simpchinesename	梅爱芳
Hou Hsiao-Hsien	simpchinesename	侯孝贤
Bruce Li	simpchinesename	黎小龙
Ricky Hui	simpchinesename	许冠英
Josephine Siao	simpchinesename	萧芳芳
Brigitte Lin	simpchinesename	林青霞
Ekin Cheng	simpchinesename	郑伊健
Patty Hou	simpchinesename	侯佩岑
Liu Ye	simpchinesename	刘烨
Jia Zhangke	simpchinesename	贾樟柯
Raymond To	simpchinesename	杜国威
Felicia Chin	simpchinesename	陈凤玲
Christy Chung	simpchinesename	钟丽缇
Feng Feng	simpchinesename	冯峰
Sun Daolin	simpchinesename	孙道临
Yuen Qiu	simpchinesename	元秋
Michelle Chong	simpchinesename	庄米雪
Wu Tianming	simpchinesename	吴天明
Benny Chan	simpchinesename	陈木胜
Anthony Wong	simpchinesename	黄耀明
Jade Kwan	simpchinesename	关心妍
Shannon Lee	simpchinesename	李香凝
Silver Ash	simpchinesename	银色灰尘
Rainie Yang	simpchinesename	杨丞琳
Liu Kai-chi	simpchinesename	廖启智
Wong Jing	simpchinesename	王晶
Jeanette Aw	simpchinesename	欧萱
Eric Moo	simpchinesename	巫启贤
Wilber Pan	simpchinesename	潘玮柏
Shawn Yue	simpchinesename	余文乐
Eric Tsang	simpchinesename	曾志伟
Raymond Chow	simpchinesename	邹文怀
Roger Kwok	simpchinesename	郭晋安
Alexander Fu Sheng	simpchinesename	傅声
Race Wong	simpchinesename	黄婉伶
Adia Chan	simpchinesename	陈松伶
Louis Koo	simpchinesename	古天乐
Yoshiko Yamaguchi	simpchinesename	李香兰
Shirley Kwan	simpchinesename	关淑怡
Amy Yip	simpchinesename	叶子楣
Wang Luobin	simpchinesename	王洛宾
Liu Xiao Ling Tong	simpchinesename	六小龄童
Kenny Bee	simpchinesename	锺镇涛
Karl Maka	simpchinesename	麦嘉
Wakin Chau	simpchinesename	周华健
Jerry Lamb	simpchinesename	林晓峰
Chin Ka-lok	simpchinesename	钱嘉乐
Fei Yu-ching	simpchinesename	费玉清
Wu Ma	simpchinesename	午马
Gordon Liu	simpchinesename	刘家辉
Yumiko Cheng	simpchinesename	郑希怡
Yu So-chow	simpchinesename	于素秋
Agnes Chan	simpchinesename	陈美龄
Liu Yifei	simpchinesename	刘亦菲
Wei Wei	simpchinesename	韦唯
Vivian Wu	simpchinesename	邬君梅
Tat Ming Pair	simpchinesename	达明一派
Julian Cheung	simpchinesename	张智霖
Chapman To	simpchinesename	杜汶泽
Jim Chim	simpchinesename	詹瑞文
Adrian Pang	simpchinesename	彭耀顺
Gallen Lo	simpchinesename	罗嘉良
Sandy Lam	simpchinesename	林忆莲
Kelly Poon	simpchinesename	潘嘉丽
Chingmy Yau	simpchinesename	邱淑贞
Melissa Ng	simpchinesename	吴美珩
Lawrence Ng	simpchinesename	吴启华
Charmaine Sheh	simpchinesename	佘诗曼
Liu Xiaoqing	simpchinesename	刘晓庆
Patrick Tam	simpchinesename	谭耀文
Daniel Wu	simpchinesename	吴彦祖
Landy Wen	simpchinesename	温岚
Maggie Cheung Ho-yee	simpchinesename	张可颐
Danny Chan Kwok-kwan	simpchinesename	陈国坤
Joyce Cheng	simpchinesename	郑欣宜
Sunny Chan	simpchinesename	陈锦鸿
JJ Lin	simpchinesename	林俊杰
Lee San-san	simpchinesename	李珊珊
Zhang Yuan	simpchinesename	张元
Kwong Wa	simpchinesename	江华
Allen Fong	simpchinesename	方育平
Bobo Chan	simpchinesename	陈文媛
Patrick Tse	simpchinesename	谢贤
Jane Zhang	simpchinesename	张靓颖
Yim Ho	simpchinesename	严浩
Kenneth Chan Kai-tai	simpchinesename	陈启泰
Dicky Cheung	simpchinesename	张卫健
Steven Cheung	simpchinesename	张致恒
Chen Hao	simpchinesename	陈好
Shirley Yeung	simpchinesename	杨思琦
Lau Kar-leung	simpchinesename	刘家良
Kenny Kwan	simpchinesename	关智斌
Frances Yip	simpchinesename	叶丽仪
Zhou Xiaowen	simpchinesename	周晓文
Xie Shaoguang	simpchinesename	谢韶光
Tay Ping Hui	simpchinesename	郑斌辉
Xie Jin	simpchinesename	谢晋
Wang Xiaoshuai	simpchinesename	王小帅
Stephy Tang	simpchinesename	邓丽欣
Theresa Fu	simpchinesename	傅颖
Kary Ng	simpchinesename	吴雨霏
Miki Yeung	simpchinesename	杨爱瑾
Denise Ho	simpchinesename	何韵诗
Dayo Wong	simpchinesename	黄子华
Kelvin Tan	simpchinesename	陈伟联
Ning Jing	simpchinesename	宁静
Xia Meng	simpchinesename	夏梦
Marco Ngai	simpchinesename	魏骏杰
Ivy Lee	simpchinesename	李锦梅
Andrew Seow	simpchinesename	肖乙铭
Kent Tong	simpchinesename	汤镇业
Christopher Lee	simpchinesename	李铭顺
Niki Chow	simpchinesename	周丽淇
Bosco Wong	simpchinesename	黄宗泽
Jimmy Lin	simpchinesename	林志颖
Kellyjackie	simpchinesename	陈晓琪
Moses Chan	simpchinesename	陈豪
Charlie Cho	simpchinesename	曹查理
Angelica Lee	simpchinesename	李心洁
Karena Lam	simpchinesename	林嘉欣
Tavia Yeung	simpchinesename	杨怡
Back Dorm Boys	simpchinesename	后舍男生
Joey Leung	simpchinesename	梁荣忠
Ellen Joyce Loo	simpchinesename	卢凯彤
Ocean Ou	simpchinesename	欧得洋
Deric Wan	simpchinesename	温兆伦
Jackie Chan Stunt Team	simpchinesename	成家班
Stanley Huang	simpchinesename	黄立行
Janice Vidal	simpchinesename	卫兰
Carman Lee	simpchinesename	李若彤
Derek Kok	simpchinesename	郭政鸿
Loletta Lee	simpchinesename	李丽珍
Jeff Chang	simpchinesename	张信哲
Derek Yee	simpchinesename	尔冬升
Nora Miao	simpchinesename	苗可秀
Huang Biren	simpchinesename	黄碧仁
Mark Lee	simpchinesename	李国煌
Danny Lee	simpchinesename	李修贤
Fiona Sit	simpchinesename	薛凯琪
Mark Lui	simpchinesename	雷頌德
Aileen Tan	simpchinesename	陈丽贞
Xiang Yun	simpchinesename	向云
Lo Wei	simpchinesename	罗維
Edward Yang	simpchinesename	杨德昌
Wu Nien-jen	simpchinesename	吴念真
Feng Gong	simpchinesename	冯巩
Ching Siu-tung	simpchinesename	程小东
Ron Ng	simpchinesename	吴卓羲
Faith Yang	simpchinesename	杨乃文
Kenji Wu	simpchinesename	吴克群
Ray Lui	simpchinesename	吕良伟
Sharon Au	simpchinesename	欧菁仙
Bernice Liu	simpchinesename	廖碧儿
Collin Chou	simpchinesename	邹兆龙
Xing Yu	simpchinesename	行宇
Peter Chan	simpchinesename	陈可辛
Shih Kien	simpchinesename	石坚
Bobby Au-yeung	simpchinesename	欧阳震华
Lee Hoi-chuen	simpchinesename	李海泉
Adam Chen	simpchinesename	詹金泉
Joshua Ang	simpchinesename	洪赐健
Dasmond Koh	simpchinesename	许振荣
Fei Mu	simpchinesename	费穆
Mandy Chiang	simpchinesename	蒋雅文
Lisa Lu	simpchinesename	卢燕
Myolie Wu	simpchinesename	胡杏儿
Annie Man	simpchinesename	文颂娴
Rui En	simpchinesename	瑞恩
Ella Chen	simpchinesename	陈嘉桦
Song Dandan	simpchinesename	宋丹丹
Flora Chan	simpchinesename	陈慧珊
Chen Hong	simpchinesename	陈红
Kwan Tak-hing	simpchinesename	关德兴
Bibi Zhou	simpchinesename	周笔畅
Chen Hanwei	simpchinesename	陈汉玮
Wu Yonggang	simpchinesename	吴永刚
Sandra Ng	simpchinesename	吴君如
Stephen Fung	simpchinesename	冯德伦
Chen Xiuhuan	simpchinesename	陈秀环
Rebecca Chan	simpchinesename	陈秀珠
Yan Yan Mak	simpchinesename	麦婉欣
Nan Quan Mama	simpchinesename	南拳妈妈
Sammul Chan	simpchinesename	陈键锋
Sharon Chan	simpchinesename	陈敏之
Vincy Chan	simpchinesename	泳儿
Leila Tong	simpchinesename	唐宁
Kee Thuan Chye	simpchinesename	纪传财
Cherrie Ying	simpchinesename	应采儿
Huang Xiaoming	simpchinesename	黄晓明
Linda Chung	simpchinesename	钟嘉欣
Joe Chen	simpchinesename	陈乔恩
Liu Tao	simpchinesename	刘涛
Jiang Qinqin	simpchinesename	蒋勤勤
Shawn Lee	simpchinesename	李创锐
Sheren Tang	simpchinesename	邓萃雯
Steven Ma	simpchinesename	马浚伟
Kevin Cheng	simpchinesename	郑嘉颖
Kaira Gong	simpchinesename	龚诗嘉
Connie Chan	simpchinesename	陈宝珠
Chyi Chin	simpchinesename	齐秦
Tracy Ip	simpchinesename	叶翠翠
Show Luo	simpchinesename	罗志祥
Sylvia Chang	simpchinesename	张艾嘉
Dave Wang	simpchinesename	王杰
Ken Lo	simpchinesename	卢惠光
Fala Chen	simpchinesename	陈法拉
Leanne Li	simpchinesename	李亚男
Zhang Yang	simpchinesename	张扬
Mavis Hee	simpchinesename	许美静
Charlie Young	simpchinesename	杨采妮
Nicky Wu	simpchinesename	吴奇隆
Leon Jay Williams	simpchinesename	立威廉
Ellen Chan	simpchinesename	陈雅伦
Maria Cordero	simpchinesename	玛俐亚
Joe Cheng	simpchinesename	郑元畅
Josephine Koo	simpchinesename	顾美华
William Chan	simpchinesename	陈伟霆
Chelsia Chan	simpchinesename	陈秋霞
Yang Mi	simpchinesename	杨幂
Tse Ling-ling	simpchinesename	谢玲玲
Apple Hong	simpchinesename	洪乙心
Wilson Yip	simpchinesename	叶伟信
Cho Tat-wah	simpchinesename	曹达华
JerryC	simpchinesename	张逸帆
Wai Ka-fai	simpchinesename	韦家辉
Alex Fong	simpchinesename	方中信
Cynthia Koh	simpchinesename	许美珍
Natalis Chan	simpchinesename	陈百祥
Paul Fonoroff	simpchinesename	方保羅
Natalie Wong	simpchinesename	黄𨥈莹
YLK Organization	simpchinesename	余力机构
Megan Zheng	simpchinesename	郑智允
Michelle Ye	simpchinesename	叶璇
Angie Chiu	simpchinesename	赵雅芝
Xu Jinglei	simpchinesename	徐静蕾
Bowie Lam	simpchinesename	林保怡
Elaine Ng Yi-Lei	simpchinesename	吴绮莉
Carrie Lam	simpchinesename	林莉
Kara Hui	simpchinesename	惠英红
Winston Chao	simpchinesename	赵文瑄
Sharon Luk	simpchinesename	陆诗韵
Cherie Chung	simpchinesename	钟楚红
Angela Tong	simpchinesename	汤盈盈
Lawrence Ah Mon	simpchinesename	刘国昌
Jesseca Liu	simpchinesename	刘子绚
Li Jinhui	simpchinesename	黎锦晖
Bowie Tsang	simpchinesename	曾宝仪
Zheng Junli	simpchinesename	郑君里
Tats Lau	simpchinesename	刘以达
Zhao Dan	simpchinesename	赵丹
Emme Wong	simpchinesename	黄伊汶
Leung Siu-lung	simpchinesename	梁小龙
Teresa Carpio	simpchinesename	杜丽莎
Candy Lo	simpchinesename	卢巧音
Hawick Lau	simpchinesename	刘恺威
Bruce Le	simpchinesename	吕小龙
Harlem Yu	simpchinesename	庾澄庆
Ronald Cheng	simpchinesename	郑中基
Michael Kwan	simpchinesename	关正杰
Ady An	simpchinesename	安以轩
Vivien Yeo	simpchinesename	杨秀惠
Teddy Robin	simpchinesename	泰迪罗宾
Edison Chen	simpchinesename	陈冠希
Anne Heung	simpchinesename	向海岚
Françoise Yip	simpchinesename	叶芳华
Frankie Lam	simpchinesename	林文龙
Phyllis Quek	simpchinesename	郭妃丽
Stephen Chan Chi-wan	simpchinesename	陈志云
Chang Chen-yue	simpchinesename	张震岳
Yu Jim-yuen	simpchinesename	于占元
Elaine Jin	simpchinesename	金燕玲
Huang Shengyi	simpchinesename	黄圣依
Sam Chan	simpchinesename	陈宇琛
Richard Low	simpchinesename	刘谦益
Raymond Cho	simpchinesename	曹永廉
Margaret Lee	simpchinesename	李美玲
Benny Chan	simpchinesename	陈浩民
Guo Degang	simpchinesename	郭德纲
Charles Ying	simpchinesename	应昌佑
Pierre Png	simpchinesename	方展发
Mike He	simpchinesename	贺军翔
Koni Lui	simpchinesename	吕慧仪
Liu Huan	simpchinesename	刘欢
Zhou Jie	simpchinesename	周杰
Power Station	simpchinesename	动力火车
Elvin Ng	simpchinesename	黄俊雄
Winnie Lau	simpchinesename	刘小慧
Terence Cao	simpchinesename	曹国辉
Baby Zhang	simpchinesename	张含韵
Sheila Chan	simpchinesename	陈淑兰
Clifton Ko	simpchinesename	高志森
Alien Sun	simpchinesename	孙佳君
Eugenia Yuan	simpchinesename	原丽淇
Ma Ji	simpchinesename	马季
Hui Shiu-hung	simpchinesename	许绍雄
Alex To	simpchinesename	杜德伟
Cheung Siu-fai	simpchinesename	张兆辉
Alan Tern	simpchinesename	唐育书
Zhang Fengyi	simpchinesename	张丰毅
Lo Ta-yu	simpchinesename	罗大佑
Joyce Tang	simpchinesename	滕丽名
Fahrenheit	simpchinesename	飞轮海
Chin Tsi-ang	simpchinesename	钱似莺
Louisa So	simpchinesename	苏玉华
Victor Wong	simpchinesename	黄品冠
Power Chan	simpchinesename	陈国邦
Joanne Tseng	simpchinesename	曾之乔
Matthew Ko	simpchinesename	高钧贤
The Wynners	simpchinesename	温拿
Wilfred Lau	simpchinesename	刘浩龙
Sun Feifei	simpchinesename	孙菲菲
Allan Wu	simpchinesename	吴振天
Shermon Tang	simpchinesename	邓上文
Rayson Tan	simpchinesename	陈泰铭
Jade Seah	simpchinesename	谢美玉
Beatrice Hsu	simpchinesename	许玮伦
Gu Changwei	simpchinesename	顾长卫
Natalie Tong	simpchinesename	唐诗咏
Tang Ti-sheng	simpchinesename	唐涤生
Yam Kim-fai	simpchinesename	任剑辉
Anthony Lun	simpchinesename	伦永亮
Zhang Yaodong	simpchinesename	张耀栋
Lou Ye	simpchinesename	娄烨
Lau Dan	simpchinesename	刘丹
Joey Meng	simpchinesename	万绮雯
Felix Chong	simpchinesename	庄文强
Bill Tung	simpchinesename	董骠
Chang Yu-sheng	simpchinesename	张雨生
Phil Chang	simpchinesename	张宇
Gao Yuanyuan	simpchinesename	高圆圆
He Meitian	simpchinesename	何美钿
Canti Lau	simpchinesename	刘锡明
Cindy Au	simpchinesename	欧倩怡
Sharla Cheung	simpchinesename	张敏
Victor Huang	simpchinesename	黄维德
Ethan Juan	simpchinesename	阮经天
Sun Yu	simpchinesename	孙瑜
Roman and the Four Steps	simpchinesename	罗文四步合唱团
Belinda Hamnett	simpchinesename	韩君婷
Daren Tan	simpchinesename	陈世维 -> 陈轩昱
Lam Chi-chung	simpchinesename	林子聪
Richard Ng	simpchinesename	吴耀汉
Joe Ma	simpchinesename	马德钟
Michael Miu	simpchinesename	苗侨伟
Gong Qiuxia	simpchinesename	龚秋霞
Wu Yingyin	simpchinesename	吴莺音
Li Yang	simpchinesename	李杨
Wallace Huo	simpchinesename	霍建华
Ying Liang	simpchinesename	应亮
Monica Chan	simpchinesename	陈法蓉
Kym Ng	simpchinesename	钟琴
Charles Heung	simpchinesename	向华强
Bryan Leung	simpchinesename	梁家仁
Tiffany Chen	simpchinesename	陈岚
Stanley Fung	simpchinesename	冯淬帆
Philip Chan	simpchinesename	陈欣健
Kathy Chow	simpchinesename	周海媚
Berg Ng	simpchinesename	吴廷烨
Chen Xiaoxu	simpchinesename	陈晓旭
Henry Thia	simpchinesename	程旭辉
Sherman Chung	simpchinesename	钟舒漫
Susanna Kwan	simpchinesename	关菊英
Charlie Chin	simpchinesename	秦祥林
Alan Tang	simpchinesename	邓光荣
Jack Neo	simpchinesename	梁智强
Winnie Hsin	simpchinesename	辛晓琪
Dennis Law	simpchinesename	罗守耀
Max Mok	simpchinesename	莫少聪
Hoyan Mok	simpchinesename	莫可欣
Four Golden Flowers	simpchinesename	四朵金花
Angela Au	simpchinesename	区文诗
Joe Junior	simpchinesename	祖·尊尼亚
Wong Li-Lin	simpchinesename	黄丽玲
Jia Hongsheng	simpchinesename	贾宏声
Bu Wancang	simpchinesename	卜万苍
Deserts Chang	simpchinesename	张悬
Roy Chiu	simpchinesename	邱泽
Lü Yue	simpchinesename	吕乐
Lin Dai	simpchinesename	林黛
Liu Wai-hung	simpchinesename	廖伟雄
Michael & Victor	simpchinesename	无印良品
Wang Baoqiang	simpchinesename	王宝强
Cecilia Yip	simpchinesename	叶童
Ix Shen	simpchinesename	沈倾剡 / 沈倾掞
Lai Lok-yi	simpchinesename	黎诺懿
Ian Gouw	simpchinesename	吴澋滔
Hins Cheung	simpchinesename	张敬轩
Rene Liu	simpchinesename	刘若英
Au Kin-yee	simpchinesename	欧健儿
Law Wing-cheung	simpchinesename	罗永昌
Benjamin Yuen	simpchinesename	袁伟豪
James Tien	simpchinesename	田俊
Chan Kwong-wing	simpchinesename	陈光荣
Tang Guoqiang	simpchinesename	唐国强
Zhao Tao	simpchinesename	赵涛
Chyi Yu	simpchinesename	齐豫
Gwei Lun-Mei	simpchinesename	桂纶镁
Frankie Chan	simpchinesename	陈勋奇
Yao Wenlong	simpchinesename	姚玟隆
Regina Kent	simpchinesename	简慧珍
Hey Girl	simpchinesename	黑Girl
Michael Tse	simpchinesename	谢天华
Bondy Chiu	simpchinesename	赵学而
Pauline Lan	simpchinesename	蓝心湄
Hou Yong	simpchinesename	侯咏
Jacklyn Wu	simpchinesename	吴倩莲
Jimmy Heung	simpchinesename	向华勝
Damian Lau	simpchinesename	刘松仁
Shin	simpchinesename	信乐团
Nick Cheung	simpchinesename	张家辉
Szeto Kam-Yuen	simpchinesename	司徒锦源
Alice Au	simpchinesename	区燕青
Alice Tzeng	simpchinesename	曾恺玹
Gordon Chan	simpchinesename	陈嘉上
Michelle Goh	simpchinesename	吴怡慧
Eileen Yeow	simpchinesename	姚莹莹
Hsieh Ho-hsien	simpchinesename	谢和弦
Chen Yunshang	simpchinesename	陈云裳
Aska Yang	simpchinesename	杨宗纬
Dong Jie	simpchinesename	董洁
Sun Li	simpchinesename	孙俪
Yu Nan	simpchinesename	余男
Liu Fendou	simpchinesename	刘奋斗
Paul Chun	simpchinesename	秦沛
Jeffrey Lau	simpchinesename	刘镇伟
Sarah Chen	simpchinesename	陈淑桦
Bryan Wong	simpchinesename	王禄江
Raymond Wong Ho-yin	simpchinesename	黄浩然
Albert Au	simpchinesename	区瑞强
Kingone Wang	simpchinesename	王传一
John Chong	simpchinesename	庄澄
Patrick Yau	simpchinesename	游达志
Wong Tin-lam	simpchinesename	王天林
Zhang Guoli	simpchinesename	张国立
Michael Tong	simpchinesename	唐文龙
Zhang Jingchu	simpchinesename	张静初
Chen Liping	simpchinesename	陈莉萍
Stephen Wong Ka-lok	simpchinesename	黄嘉乐
Martin Chappell	simpchinesename	卓保怡
Jimmy Nah	simpchinesename	蓝钦喜
Jim Tang	simpchinesename	邓永健
Lu Xuechang	simpchinesename	路学长
He Saifei	simpchinesename	何赛飞
Esther Kwan	simpchinesename	关咏荷
Lowell Lo	simpchinesename	卢冠廷
Jiang Ying	simpchinesename	蒋英
Softhard	simpchinesename	软硬天师
Chen Shucheng	simpchinesename	陈澍城
Lu Yi-ching	simpchinesename	陆弈静
Zhao Xiaoding	simpchinesename	赵小丁
Yonfan	simpchinesename	杨凡
Jolene Chin	simpchinesename	陈影雯
Dante Lam	simpchinesename	林超贤
Matt Chow	simpchinesename	邹凯光
Jam Hsiao	simpchinesename	萧敬腾
Yu Lik-wai	simpchinesename	余力为
Chung King-fai	simpchinesename	钟景辉
Yang Shu	simpchinesename	杨述
Wu Di	simpchinesename	邬迪
Zheng Geping	simpchinesename	郑各评
Kathy Yuen	simpchinesename	汤怡
Tiger Hu	simpchinesename	胡彦斌
Jacob Cheung	simpchinesename	張之亮
Ning Ying	simpchinesename	宁瀛
Jason Hsu	simpchinesename	许孟哲
Kent Cheng	simpchinesename	郑则士
Ivy Ho	simpchinesename	岸西
Ma Liwen	simpchinesename	马俪文
Sa Dingding	simpchinesename	萨顶顶
Pace Wu	simpchinesename	吴佩慈
Lily Li	simpchinesename	李丽丽
John Shum	simpchinesename	岑建勋
Han Sanping	simpchinesename	韩三平
Su Rui	simpchinesename	苏芮
Pai Ping-ping	simpchinesename	白冰冰
Zhang Yibai	simpchinesename	张一白
Priscelia Chan	simpchinesename	曾诗梅
Lung Fong	simpchinesename	龙方
Ning Hao	simpchinesename	宁浩
Nat Ho	simpchinesename	鹤天赐
Barry Wong	simpchinesename	黄炳耀
Julian Hee	simpchinesename	许立桦
Dong Yong	simpchinesename	董勇
Wong Cho-lam	simpchinesename	王祖蓝
Xu Jiao	simpchinesename	徐娇
Alan Dawa Dolma	simpchinesename	阿兰·达瓦卓玛
Chen Tianwen	simpchinesename	陈天文
Marcus Chin	simpchinesename	陈建彬
Law Kar-ying	simpchinesename	罗家英
Choi Kwok-wai	simpchinesename	蔡国威
Jack Wu	simpchinesename	胡诺言
Hsu Wei-ning	simpchinesename	许玮宁
Zhang Jizhong	simpchinesename	张纪中
Eric Kot	simpchinesename	葛民辉
Deng Jie	simpchinesename	邓婕
John Cheng	simpchinesename	钟耀南
Wu Yigong	simpchinesename	吴贻弓
Daniel Chan	simpchinesename	陈晓东
Dominic Lam	simpchinesename	林嘉华
Cass Phang	simpchinesename	彭羚
Grace Chang	simpchinesename	葛兰
Claire Kuo	simpchinesename	郭静
Arthur Wong	simpchinesename	黃岳泰
Huang Jianxin	simpchinesename	黄建新
Wang Fuli	simpchinesename	王馥荔
Corinna Chamberlain	simpchinesename	陈明恩
Wang Gang	simpchinesename	王刚
Christine Ng	simpchinesename	伍咏薇
Yan Shunkai	simpchinesename	严顺开
Sire Ma	simpchinesename	马赛
Yammie Lam	simpchinesename	蓝洁瑛
Candy Chu	simpchinesename	朱婉仪
Liu Wen Zheng	simpchinesename	刘文正
Loretta Yang	simpchinesename	杨惠姗
Yang Peiyi	simpchinesename	杨沛宜
Jiang Wenli	simpchinesename	蒋雯丽
Cao Fang	simpchinesename	曹方
Elvina Kong	simpchinesename	江欣燕
Stephen Au	simpchinesename	欧锦棠
Pauline Chan Bo-Lin	simpchinesename	陈宝莲
Paul Chung	simpchinesename	钟保罗
Soh Hang-suen	simpchinesename	苏杏璇
Cheung Tat-ming	simpchinesename	张达明
Peter Ho	simpchinesename	何润东
Patricia Mok	simpchinesename	莫小玲
Cheng Gwan-min	simpchinesename	郑君绵
Vincent Zhao	simpchinesename	赵文卓
Wei Te-Sheng	simpchinesename	魏德圣
He Jianjun	simpchinesename	何建军
Paige Chua	simpchinesename	蔡琦慧
Patrick Kong	simpchinesename	叶念琛
Sun Nan	simpchinesename	孙楠
Shaun Chen	simpchinesename	陈泓宇
Ma Tianyu	simpchinesename	马天宇
Bowie Wu	simpchinesename	胡枫
Liu Hao	simpchinesename	刘浩
Yuen Cheung-yan	simpchinesename	袁祥仁
Alex Man	simpchinesename	万梓良
Lau Ka-ho	simpchinesename	刘家豪
Felix Lok	simpchinesename	骆应钧
Karl Dominik	simpchinesename	凯洱
Lau Kar-wing	simpchinesename	刘家荣
Charlene Tse	simpchinesename	谢宁
Song Zude	simpchinesename	宋祖德
Edmund Chen	simpchinesename	陈之财
Cutie Mui	simpchinesename	梅小惠
Gilbert Lam	simpchinesename	林韦辰
Chen Guohua	simpchinesename	陈国华
Ong Ai Leng	simpchinesename	王爱玲
Rosanne Wong	simpchinesename	黄婉君
Prudence Liew	simpchinesename	刘美君
Lee Heung-kam	simpchinesename	李香琴
Wu Hsing-kuo	simpchinesename	吴兴国
Paisley Wu	simpchinesename	胡蓓蔚
William So	simpchinesename	苏永康
Kimberley Chen	simpchinesename	陈芳语
Huang Yi	simpchinesename	黄奕
He Jie	simpchinesename	何洁
Leonard Ho	simpchinesename	何冠昌
Zhao Fei	simpchinesename	趙非
Lau Kong	simpchinesename	刘江
Top Combine	simpchinesename	至上励合
Roy Chiao	simpchinesename	乔宏
Fiona Xie	simpchinesename	谢宛谕
Mona Fong	simpchinesename	方逸华
Susan Wong	simpchinesename	黄翠珊
Wu Ziniu	simpchinesename	吴子牛
Lu Chuan	simpchinesename	陆川
Moses Lim	simpchinesename	林益民
Chen Chusheng	simpchinesename	陈楚生
Willie Chan	simpchinesename	陈自强
Chen Kuan-tai	simpchinesename	陈观泰
Lo Mang	simpchinesename	罗莽
Liu Bingjian	simpchinesename	刘冰鉴
Yoyo Chen	simpchinesename	陈自瑶
Suki Chui	simpchinesename	徐淑敏
Vivian Lai	simpchinesename	赖怡伶
Zhang Jianya	simpchinesename	張建亞
Tang Pik-wan	simpchinesename	邓碧云
Bak Man-biu	simpchinesename	白文彪
Xia Gang	simpchinesename	夏钢
Elliot Ngok	simpchinesename	岳华
Liu Miaomiao	simpchinesename	刘苗苗
Baron Chen	simpchinesename	陈楚河
Superband	simpchinesename	纵贯线
FAMA	simpchinesename	农夫
Mickey Huang	simpchinesename	黄子佼
Sun Ma Sze Tsang	simpchinesename	新马师曾
Leung Sing-Bor	simpchinesename	梁醒波
Loong Kin Sang	simpchinesename	龙剑笙
Sun Rui	simpchinesename	孙锐
Ting-Ting Hu	simpchinesename	胡婷婷
Law Lan	simpchinesename	罗兰
Dean Shek	simpchinesename	石天
Patrick Tang	simpchinesename	邓健泓
Chan Hung-lit	simpchinesename	陈鸿烈
Robert Lee	simpchinesename	李振辉
Lawrence Cheng	simpchinesename	郑丹瑞
Chin Siu-ho	simpchinesename	钱小豪
Chieh Yuan	simpchinesename	解元
Kwan Hoi-san	simpchinesename	关海山
Zhang Junzhao	simpchinesename	张军钊
Paw Hee-ching	simpchinesename	鲍起静
Joan Lin	simpchinesename	林凤娇
Mark Kwok	simpchinesename	郭耀明
Carol Cheng	simpchinesename	郑裕玲
Hsiao Huang-Chi	simpchinesename	萧煌奇
Wang Luoyong	simpchinesename	王洛勇
Jacky Wong	simpchinesename	王树熹
Lo Hoi-pang	simpchinesename	卢海鹏
Xiao Xun	simpchinesename	黄瀞怡
Anthony Chan	simpchinesename	陳友
Jian Yi	simpchinesename	简艺
Wong Jinglun	simpchinesename	黄靖伦
Fan Wei	simpchinesename	范伟
Alien Huang	simpchinesename	黄鸿升
Celest Chong	simpchinesename	张玉华
Cynthia Khan	simpchinesename	杨丽菁
Zhang Yuqi	simpchinesename	张雨绮
Chen Sicheng	simpchinesename	陈思诚
Crowd Lu	simpchinesename	卢广仲
Zheng Zhengqiu	simpchinesename	郑正秋
Tony Liu	simpchinesename	刘永
Edwin Siu	simpchinesename	萧正楠
Shui Hua	simpchinesename	水华
Shi Hui	simpchinesename	石挥
Unicorn Chan	simpchinesename	小麒麟
Mars	simpchinesename	火星
Ellesmere Choi	simpchinesename	蔡子健
Michelle Wai	simpchinesename	衛詩雅
Carole Lin	simpchinesename	林晓佩
Eelyn Kok	simpchinesename	郭蕙雯
Mark Cheng	simpchinesename	郑浩南
Janine Chang	simpchinesename	张钧甯
Shi Dongshan	simpchinesename	史东山
Louis Yuen	simpchinesename	阮兆祥
Stephanie Che	simpchinesename	车婉婉
Dexter Young	simpchinesename	杨天经
Huang Zhizhong	simpchinesename	黄志忠
Xiao Man	simpchinesename	王淑萱/王婧乔/王承嫣
Jack Kao	simpchinesename	高捷
Janice Man	simpchinesename	文咏珊
Niu Ben	simpchinesename	牛犇
Zhang Guoqiang	simpchinesename	张国强
Hsiao Hung-jen	simpchinesename	萧闳仁
Ng Hui	simpchinesename	黄慧
Carrie Ng	simpchinesename	吴家丽
Johnny Ngan	simpchinesename	颜国梁
Linda Wong	simpchinesename	王馨平
Amy Kwok	simpchinesename	郭蔼明
Liu Xijun	simpchinesename	刘惜君
Chen Kuo-Fu	simpchinesename	陈国冨
Yi Jet Qi	simpchinesename	易桀齐
Xiaoshenyang	simpchinesename	小沈阳
Gill Mohindepaul Singh	simpchinesename	乔宝宝
Michelle Saram	simpchinesename	郑雪儿
Chen Lin	simpchinesename	陈琳
Nana Lee	simpchinesename	李千娜
Susan Tse	simpchinesename	谢雪心
Chiang Sheng	simpchinesename	江生
Liu Yonghong	simpchinesename	刘勇宏
Louis Cheung	simpchinesename	张继聪
Mary Hon	simpchinesename	韩马利
Evergreen Mak Cheung-ching	simpchinesename	麦长青
Liu Peiqi	simpchinesename	刘佩琦
Ocean Hai	simpchinesename	海鸣威
Zhang Tielin	simpchinesename	张铁林
Lin Meijiao	simpchinesename	林梅娇
Derrick Hoh	simpchinesename	何维健
Shen Xiling	simpchinesename	沈西苓
Reen Yu	simpchinesename	喻虹渊
Chen Baoguo	simpchinesename	陈宝国
Wayne Chua	simpchinesename	蔡佩璇
Yang Lina	simpchinesename	杨莉娜
Alfred Hsing	simpchinesename	邢思杰
Tina Leung	simpchinesename	狄娜
Lin Yu-chun	simpchinesename	林育群
Osman Hung	simpchinesename	洪智杰
Him Law	simpchinesename	罗仲谦
Mark Chao	simpchinesename	赵又廷
Macy Chan	simpchinesename	陈美诗
Tong Dawei	simpchinesename	佟大为
Feng Xiaoning	simpchinesename	冯小宁
Yu Rongguang	simpchinesename	于荣光
Jess Sum	simpchinesename	沈卓盈
Feng Shaofeng	simpchinesename	冯绍峰
Kenny Ho	simpchinesename	何家劲
Quan Yi Fong	simpchinesename	权怡凤
Go Go Club	simpchinesename	兄弟联
Andrea Chen	simpchinesename	陈匡怡
James Lye	simpchinesename	赖兴祥
Wang Chong	simpchinesename	王翀
Chen Zeyu	simpchinesename	陈泽宇
Terri Kwan	simpchinesename	关颖
JuJu Chan	simpchinesename	陈钰芸
May Lo	simpchinesename	罗美薇
Joel Chan	simpchinesename	陈山聪
Kingdom Yuen	simpchinesename	苑琼丹
One-Fang	simpchinesename	万芳
Luo Jin	simpchinesename	罗晋
Keith Chan Fai-young	simpchinesename	陈辉阳
Russell Cheung	simpchinesename	张智轩
Liu Shishi	simpchinesename	刘诗诗
Henry O	simpchinesename	区亨利
Mimi Lo	simpchinesename	罗敏庄
Cruz Teng	simpchinesename	丁志勇
Fiona Fung	simpchinesename	冯曦妤
Eric Li	simpchinesename	李天翔
Cindy Yen	simpchinesename	袁咏琳
Xue Xiaolu	simpchinesename	薛晓璐
Tong Bing Yu	simpchinesename	童冰玉
Yang Pei-An	simpchinesename	杨培安
Pan Hong	simpchinesename	潘虹
Zhao Lirong	simpchinesename	赵丽蓉
Zhu Lin	simpchinesename	朱琳
Billy Chung	simpchinesename	锺少雄
Yuan Wenqing	simpchinesename	原文庆
Ruby Wong	simpchinesename	黄卓玲
Anthony Neely	simpchinesename	倪安东
Fung Bo Bo	simpchinesename	冯宝宝
Emily Chu	simpchinesename	朱宝意
Jin Yan	simpchinesename	金焰
Ashton Chen	simpchinesename	释小龙
Nie Yuan	simpchinesename	聂远
Lee Tim-sing	simpchinesename	李添胜
Suzie Wong	simpchinesename	苏施黄
Song Jia	simpchinesename	宋佳
Wallace Chung	simpchinesename	钟汉良
Zhang Hanyu	simpchinesename	张涵予
Miu Zhu	simpchinesename	朱俐静
JJ Jia	simpchinesename	贾晓晨
James Wen	simpchinesename	温升豪
Sandrine Pinna	simpchinesename	张榕容
Sharon Lee	simpchinesename	李昊嘉
Zhang Ruifang	simpchinesename	张瑞芳
Zhu Xijuan	simpchinesename	祝希娟
Zhang Yu	simpchinesename	张瑜
Li Xiuming	simpchinesename	李秀明
Fang Shu	simpchinesename	方舒
Meeia Foo	simpchinesename	符琼音
Yao Chen	simpchinesename	姚晨
Wu Tsing-Fong	simpchinesename	吴青峰
Yu Lan	simpchinesename	于藍
Wang Xiaotang	simpchinesename	王曉棠
Ni Ping	simpchinesename	倪萍
A-Lin	simpchinesename	黄丽玲
Hiro Hayama	simpchinesename	叶山豪
Chi Kuan-chun	simpchinesename	戚冠军
Kanny Theng	simpchinesename	邓晴冰
Candy Hsu	simpchinesename	许雅涵
Goh Eng Wah	simpchinesename	吴荣华
Chong Wai-kin	simpchinesename	庄伟建
Li Chen	simpchinesename	李晨
Li Shaohong	simpchinesename	李少红
Shu Chang	simpchinesename	舒畅
Liu Yuxin	simpchinesename	刘雨欣
Hans Zhang	simpchinesename	张翰
JPM	simpchinesename	JPM
Lee Teng	simpchinesename	李腾
Zheng Shuang	simpchinesename	郑爽
Zhao Yihuan	simpchinesename	赵奕欢
Alyssa Chia	simpchinesename	贾静雯
Ivy Chen	simpchinesename	陈意涵
Eddie Peng	simpchinesename	彭于晏
Duan Linxi	simpchinesename	段林希
Dong Zhen	simpchinesename	董贞
Chen Zhihui	simpchinesename	陈之辉
Bao Guo'an	simpchinesename	鲍国安
Yan Yikuan	simpchinesename	严屹宽
Qiao Zhenyu	simpchinesename	乔振宇
Kwok Fung	simpchinesename	郭峰
Wu Yue	simpchinesename	吴樾
Qian Zhijun	simpchinesename	钱志君
Xue Zhiqian	simpchinesename	薛之谦
Sammy Sum	simpchinesename	沈震轩
Dennis Chew	simpchinesename	周崇庆
Melvin Sia	simpchinesename	谢佳见
Kelly Cheung	simpchinesename	张曦雯
Alfred Hui	simpchinesename	许廷铿
Cilla Kung	simpchinesename	乐瞳
Diana Ser	simpchinesename	徐秀盈
Kitty Yuen	simpchinesename	阮小仪
Stanley Cheung	simpchinesename	张景淳
Vincent Ng	simpchinesename	翁清海
Astrid Chan	simpchinesename	陈芷菁
Griselda Yeung	simpchinesename	杨卓娜
Qin Lan	simpchinesename	秦岚
Casper Chan	simpchinesename	陈思齐
Brian Tse	simpchinesename	谢东闵
Hou Baolin	simpchinesename	侯宝林
Ma Su	simpchinesename	马苏
Xu Huanshan	simpchinesename	许还山
Du Zhiguo	simpchinesename	杜志国
Chen Zihan	simpchinesename	陈紫函
Connie Mak Kit-man	simpchinesename	麦洁文
Jiang Kun	simpchinesename	姜昆
Romeo Tan	simpchinesename	陈罗密欧
Andie Chen	simpchinesename	陈邦鋆
Tracy Lee	simpchinesename	李美玲
Dai Xiangyu	simpchinesename	戴向宇
Kate Pang	simpchinesename	庞蕾馨
Yuan Shuai	simpchinesename	袁帅
Desmond Tan	simpchinesename	陈泂江
Ben Yeo	simpchinesename	杨志龙
Zhang Zhenhuan	simpchinesename	张振寰
Darryl Yong	simpchinesename	杨子文
Sora Ma	simpchinesename	马艺瑄
Jeff Wang	simpchinesename	王建复
Zen Chong	simpchinesename	章证翔
Fan Hung-hsuan	simpchinesename	范鸿轩
Jerry Yeo	simpchinesename	杨伟烈
Darren Lim	simpchinesename	林明伦
Nick Shen	simpchinesename	沈炜竣
William San	simpchinesename	辛伟廉
Wee Kheng Ming	simpchinesename	黄启铭
Cavin Soh	simpchinesename	苏梽诚
Zhang Lei	simpchinesename	张磊
Moo Yan Yee	simpchinesename	巫恩仪
Tiffany Leong	simpchinesename	梁丽芳
Gary Yap	simpchinesename	叶俊岑
Eliza Sam	simpchinesename	岑丽香
Yan Bingliang	simpchinesename	严丙量
Zhou Ying	simpchinesename	周颖
Stella Chung	simpchinesename	钟晓玉
Michelle Chia	simpchinesename	谢韵仪
Yang Libing	simpchinesename	杨莉冰
Florence Tan	simpchinesename	陈秀丽
Kerry Berry Brogan	simpchinesename	凯瑞
Debbie Goh	simpchinesename	吴天瑜
Evelyn Tan	simpchinesename	陈毓芸
Xu Qing	simpchinesename	许晴
Pamelyn Chee	simpchinesename	齐騛
Renée Chen	simpchinesename	陈嘉唯
Angel Chiang	simpchinesename	蒋家旻
Vincent Wan	simpchinesename	溫家恆
Lee Wei	simpchinesename	李威
Lily Chan	simpchinesename	陈洁丽
Nicola Cheung	simpchinesename	张燊悦
Yisa Yu	simpchinesename	郁可唯
Daniel Lee Chee Hun	simpchinesename	李桀汉
Lana Lo	simpchinesename	罗蓝亚
Li Shuangjiang	simpchinesename	李双江
Meng Ge	simpchinesename	梦鸽
Annie Liu	simpchinesename	刘心悠
Wu Mochou	simpchinesename	吴莫愁
Lan Cheng-lung	simpchinesename	蓝正龙
Sita Chan	simpchinesename	陈僖仪
Jonathan Chik	simpchinesename	戚其义
Wyman Wong	simpchinesename	黄伟文
Chen Jianbin	simpchinesename	陈建斌
Chao Chuan	simpchinesename	赵传
Ivy Tan	simpchinesename	陈艾薇
Wang Luodan	simpchinesename	王珞丹
Leon Dai	simpchinesename	戴立忍
Esther Eng	simpchinesename	伍锦霞
Anthony Chen	simpchinesename	陈哲艺
Yang Li-hua	simpchinesename	杨丽花
Samuel So	simpchinesename	苏文星
Butterford Wong	simpchinesename	黄黄油福特
Ann	simpchinesename	白安
Huang Yali	simpchinesename	黄雅莉
Yu Junjian	simpchinesename	郁钧剑
Zeng Yi	simpchinesename	曾毅
Yangwei Linghua	simpchinesename	杨魏玲花
Pang Long	simpchinesename	庞龙
Li Guyi	simpchinesename	李谷一
Jin Tielin	simpchinesename	金铁霖
Zu Hai	simpchinesename	祖海
Yan Weiwen	simpchinesename	阎维文
Zhang Ye	simpchinesename	张也
Chang Sisi	simpchinesename	常思思
Tang Can	simpchinesename	汤灿
Chen Lili	simpchinesename	陈笠笠
Lü Jihong	simpchinesename	吕继宏
Grace Chan	simpchinesename	陈凯琳
Crystal Ong	simpchinesename	王雪晶
Angeline Khoo	simpchinesename	邱燕妮、小妮妮
Queenz Cheng	simpchinesename	庄群施
Cass Chin	simpchinesename	陈金燕
Jayden Yuan	simpchinesename	袁晓超
Jiang Xin	simpchinesename	蒋欣
Sharon Kwan	simpchinesename	关诗敏
Lisa Cheng	simpchinesename	郑丽莎
Jeannie Hsieh	simpchinesename	谢金燕
Zhu Yudong	simpchinesename	朱昱东
Bennett Pang	simpchinesename	彭健新
Angel Lai Wei Li	simpchinesename	黎玮妮
Yako Chan	simpchinesename	詹雅文/詹子晴/丫头
Yao Yao	simpchinesename	郭書瑤
Celine Ma	simpchinesename	马蹄露
Huang Ying	simpchinesename	黄英
Mini Chang	simpchinesename	张筱婕/张宁儿
Steven Ma	simpchinesename	马振翼
Larisa Bakurova	simpchinesename	瑞莎
Zhang Meng	simpchinesename	张猛
Jeannie Chan	simpchinesename	陈滢
Zhang Jin	simpchinesename	张晋
Steve Ma	simpchinesename	马景涛
Han Xue	simpchinesename	韩雪
Betty Chung	simpchinesename	钟玲玲
Jonathan Wong	simpchinesename	王梓轩
Shane Pow	simpchinesename	包勋评
Jiang Dawei	simpchinesename	蒋大为
Tony Hung	simpchinesename	洪永城
Jacqueline Wong	simpchinesename	黄心颖
Wuershan	simpchinesename	乌尔善
Yang Zishan	simpchinesename	杨子姗
Marc Ma	simpchinesename	马浴柯
Richard Juan	simpchinesename	范鸿志
Kandy Wong	simpchinesename	黄山怡
Sebastian Poon	simpchinesename	潘云峰
Yang Yang	simpchinesename	杨洋
Wan Jen	simpchinesename	万仁
Jacelyn Tay	simpchinesename	郑秀珍
Li Daimo	simpchinesename	李代沫
Zhang Bichen	simpchinesename	张碧晨
Wong Yat-fei	simpchinesename	黄一飞
Janet Yang	simpchinesename	杨燕子
Kenny Wong	simpchinesename	黄德斌
A-fu	simpchinesename	邓福如
Alfred Sim	simpchinesename	沈志豪
Chloe Wang	simpchinesename	王乐妍
Zheng Kai	simpchinesename	郑恺
Jerry Huang	simpchinesename	黄志玮
Aenie Wong	simpchinesename	王淑君
Jinny Ng	simpchinesename	吴若希
Yao Beina	simpchinesename	Zh-tw:姚贝娜
Matt Wu	simpchinesename	吴中天
Mariane Chan	simpchinesename	陈妙瑛
Sisley Choi	simpchinesename	蔡思贝
Ya Hui	simpchinesename	雅慧
Lai Ying Tong	simpchinesename	赖映彤
Liu Hua	simpchinesename	刘桦
Gregory Wong	simpchinesename	王宗尧
Wang Sen	simpchinesename	王森
Jolin Chien	simpchinesename	简宏霖
Li Yifeng	simpchinesename	李易峰
Tang Kee-chan	simpchinesename	邓寄尘
Karsin Bak	simpchinesename	白嘉倩
Du Yulu	simpchinesename	杜雨露
Cher Ng	simpchinesename	黃子荣
Bai Fan	simpchinesename	白凡
Francis Lee	simpchinesename	李焯雄
May Chan	simpchinesename	陈嘉佳
Carat Cheung	simpchinesename	张名雅
Zhang Lei	simpchinesename	张磊
Yan Su	simpchinesename	阎肃
Zhou Xiaoyan	simpchinesename	周小燕
Ludi Lin	simpchinesename	林路迪
Yin Xiangjie	simpchinesename	尹相杰
Chang Hsiao-yen	simpchinesename	张小燕
Roxanne Tong	simpchinesename	汤洛雯
Ram Chiang	simpchinesename	蒋志光
Mao Ning	simpchinesename	毛宁
Chen Xuedong	simpchinesename	陈学冬
Vivian Sung	simpchinesename	宋芸桦
Belinda Lee	simpchinesename	李心钰
Jiang Chao	simpchinesename	姜潮
Sheila Sim	simpchinesename	沈琳宸
Hua Chenyu	simpchinesename	华晨宇
Jeremy Chan	simpchinesename	田铭耀
Huang Xuan	simpchinesename	黄轩
Zoe Tay	simpchinesename	郑惠玉
Han Ying-chieh	simpchinesename	韩英杰
Joanna Dong	simpchinesename	董姿彦
Wang Ping	simpchinesename	王苹
Huang Tsung Hsing	simpchinesename	黃宗迅
Zeng Yanfen	simpchinesename	曾艳芬
Huang An	simpchinesename	黄安
Ju Jingyi	simpchinesename	鞠婧祎
Lam Kwok-Hung	simpchinesename	林国雄
Zhao Jiamin	simpchinesename	赵嘉敏
Zhu Lan Qing	simpchinesename	朱岚清
Zhu Shaowen	simpchinesename	朱绍文
Li Yitong	simpchinesename	李艺彤
Yuen Shun-yi	simpchinesename	袁信义
Huang Tingting	simpchinesename	黄婷婷
Chan Wui-ngai	simpchinesename	陈会毅
Fei Qinyuan	simpchinesename	费沁源
James Ng	simpchinesename	吴业坤
Dominic Zhai	simpchinesename	翟士诚
Qiu Xinyi	simpchinesename	邱欣怡
Andrew Yuen Man-kit	simpchinesename	袁文杰
Tang Anqi	simpchinesename	唐安琪
Xavier Ong	simpchinesename	王胜宇
Liya A	simpchinesename	阿丽亚
Law Lok-lam	simpchinesename	罗乐林
Zhang Yuge	simpchinesename	张语格
Wu Yue	simpchinesename	吴越
Moon Lau	simpchinesename	刘佩玥
Zoie Tam	simpchinesename	谭凯琪
Xu Jiaqi	simpchinesename	许佳琪
Zhao Yue	simpchinesename	赵粤
Li Ruijun	simpchinesename	李睿珺
Hong Peiyun	simpchinesename	洪珮雲
