Amu Darya	source1Region	Pamir Mountains
Missouri River	source1Region	Yellowstone National Park
Missouri River	source1Region	Wyoming
Rhine	source1Region	Graubünden
Delaware River	source1Region	Delaware County, New York
Ob River	source1Region	Altai Republic
Amur River	source1Region	Khentii Province
River Tyne	source1Region	Northumberland
River Mersey	source1Region	Greater Manchester
River Tweed	source1Region	Northumberland
Red River	source1Region	Dali Bai Autonomous Prefecture
Susquehanna River	source1Region	Cambria County, Pennsylvania
Platte River	source1Region	Park County, Colorado
Platte River	source1Region	Colorado
Big Sandy River	source1Region	Buchanan County, Virginia
Váh	source1Region	Vysoké Tatry
River Tame, West Midlands	source1Region	Walsall
Genesee River	source1Region	Potter County, Pennsylvania
Schuylkill River	source1Region	Schuylkill County, Pennsylvania
New River	source1Region	Watauga County, North Carolina
Saint John River	source1Region	Quebec
Sun River	source1Region	Lewis and Clark County, Montana
Little Tennessee River	source1Region	Georgia
French Broad River	source1Region	North Carolina
Kanawha River	source1Region	Pocahontas County, West Virginia
Beaver River	source1Region	Lawrence County, Pennsylvania
Brandywine Creek	source1Region	Chester County, Pennsylvania
White Clay Creek	source1Region	Chester County, Pennsylvania
Clark Fork River	source1Region	Granite County, Montana
Holston River	source1Region	Virginia
Walker River	source1Region	California
Peace River	source1Region	British Columbia
Feather River	source1Region	Plumas County, California
Little Pigeon River	source1Region	Tennessee
Nolichucky River	source1Region	North Carolina
Pigeon River	source1Region	North Carolina
Paraguay River	source1Region	Mato Grosso
San Gabriel River	source1Region	San Gabriel Mountains
Farmington River	source1Region	Hartford County, Connecticut
Vils	source1Region	Lower Bavaria
Shade River	source1Region	Athens County, Ohio
Black Fork	source1Region	Tucker County, West Virginia
Williams River	source1Region	Pocahontas County, West Virginia
Río Negro	source1Region	Neuquén Province
Twelvepole Creek	source1Region	Mingo County, West Virginia
Little River	source1Region	Floyd County, Virginia
Seneca Creek	source1Region	Pocahontas County, West Virginia
Glady Fork	source1Region	Randolph County, West Virginia
Breakneck Creek	source1Region	Butler County, Pennsylvania
Bybrook River	source1Region	South Gloucestershire
River Wey	source1Region	West Sussex
Wiscoy Creek	source1Region	Wyoming County, New York
American River	source1Region	El Dorado County, California
Clearwater River	source1Region	Idaho County
Jiloca	source1Region	Teruel
Siston Brook	source1Region	South Gloucestershire
Lam Brook	source1Region	South Gloucestershire
Otter Creek	source1Region	Frontenac County, Ontario
Cow Creek	source1Region	Umpqua National Forest
Xin River	source1Region	Pucheng County, Fujian
Nakara River	source1Region	Iriomote-jima
Nakama River	source1Region	Iriomote-jima
Asheldham Brook	source1Region	Maldon District
Asheldham Brook	source1Region	Essex
Big Harts Creek	source1Region	Logan County, West Virginia
Kiah Creek	source1Region	Lincoln County, West Virginia
