John Woo	tradchinesename	吳宇森
Jet Li	tradchinesename	李連杰
Chow Yun-fat	tradchinesename	周潤發
Ringo Lam	tradchinesename	林嶺東
Sammo Hung	tradchinesename	洪金寶
Roman Tam	tradchinesename	羅文
Michelle Yeoh	tradchinesename	楊紫瓊
Maggie Cheung	tradchinesename	張曼玉
Wayne Wang	tradchinesename	王穎
Leslie Cheung	tradchinesename	張國榮
Brandon Lee	tradchinesename	李國豪
Ge You	tradchinesename	葛優
Anita Mui	tradchinesename	梅艷芳
Joseph Koo	tradchinesename	顧嘉煇
Joan Chen	tradchinesename	陳冲
Lai Man-Wai	tradchinesename	黎民偉
Chang Chen	tradchinesename	張震
Christopher Doyle	tradchinesename	杜可風
Chen Kaige	tradchinesename	陳凱歌
Michael Hui	tradchinesename	許冠文
Stanley Kwan	tradchinesename	關錦鵬
Sally Yeh	tradchinesename	葉蒨文
Priscilla Chan	tradchinesename	陳慧嫻
William Hung	tradchinesename	孔慶翔
A-mei	tradchinesename	張惠妹
Josie Ho	tradchinesename	何超儀
King Hu	tradchinesename	胡金銓
MC Jin	tradchinesename	歐陽靖
Bai Ling	tradchinesename	白靈
Stephen Chow	tradchinesename	周星馳
Jay Chou	tradchinesename	周杰倫
Yuen Biao	tradchinesename	元彪
Joey Yung	tradchinesename	容祖兒
Teresa Cheung	tradchinesename	張德蘭
Lazy Mutha Fucka	tradchinesename	大懶堂
Juno Mak	tradchinesename	麥浚龍
Gigi Leung	tradchinesename	梁詠琪
Vanness Wu	tradchinesename	吳建豪
Johnnie To	tradchinesename	杜琪峯
Deep Ng	tradchinesename	吳浩康
Evonne Hsu	tradchinesename	許慧欣
Stephanie Cheng	tradchinesename	鄭融
Gillian Chung	tradchinesename	鍾欣潼
Samuel Hui	tradchinesename	許冠傑
Gregory Charles Rivers	tradchinesename	河國榮
John Lone	tradchinesename	尊龍
Shu Qi	tradchinesename	舒淇
Chen Daoming	tradchinesename	陳道明
Maggie Lau	tradchinesename	劉思惠
Miriam Yeung	tradchinesename	楊千嬅
Stefanie Sun	tradchinesename	孫燕姿
Ann Hui	tradchinesename	許鞍華
Carina Lau	tradchinesename	劉嘉玲
Danny Chan	tradchinesename	陳百強
Rebecca Pan	tradchinesename	潘迪華
Eason Chan	tradchinesename	陳奕迅
Jaycee Chan	tradchinesename	房祖名
Angie Cheong	tradchinesename	張慧儀
Chang Cheh	tradchinesename	張徹
James Wong	tradchinesename	黃霑
Anthony Wong	tradchinesename	黃秋生
Vangie Tang	tradchinesename	鄧穎芝
Yuen Wah	tradchinesename	元華
Michael Wong	tradchinesename	王敏德
Ma Sanli	tradchinesename	馬三立
Andy Hui	tradchinesename	許志安
F.I.R.	tradchinesename	飛兒樂團
Y2J	tradchinesename	神木與瞳
Felix Wong	tradchinesename	黃日華
Alan Tam	tradchinesename	譚詠麟
Adam Cheng	tradchinesename	鄭少秋
Wong Ka Kui	tradchinesename	黃家駒
Wong Ka Keung	tradchinesename	黃家強
Paul Wong	tradchinesename	黃貫中
Yip Sai Wing	tradchinesename	葉世榮
Tony Leung Ka-fai	tradchinesename	梁家輝
Kit Chan	tradchinesename	陳潔儀
Anita Yuen	tradchinesename	袁詠儀
Richard Lam	tradchinesename	林振強
Paula Tsui	tradchinesename	徐小鳳
Sean Lau	tradchinesename	劉青雲
Francis Ng	tradchinesename	吳鎮宇
Feng Xiaogang	tradchinesename	馮小剛
Simon Yam	tradchinesename	任達華
Deanie Ip	tradchinesename	葉德嫻
Corey Yuen	tradchinesename	元奎
Ann Mui	tradchinesename	梅愛芳
Hou Hsiao-Hsien	tradchinesename	侯孝賢
Bruce Li	tradchinesename	黎小龍
Ricky Hui	tradchinesename	許冠英
Josephine Siao	tradchinesename	蕭芳芳
Brigitte Lin	tradchinesename	林青霞
Ekin Cheng	tradchinesename	鄭伊健
Patty Hou	tradchinesename	侯佩岑
Liu Ye	tradchinesename	劉燁
Jia Zhangke	tradchinesename	賈樟柯
Leo Ku	tradchinesename	古巨基
Raymond To	tradchinesename	杜國威
Christy Chung	tradchinesename	鍾麗緹
Feng Feng	tradchinesename	馮峰
Sun Daolin	tradchinesename	孫道臨
Yuen Qiu	tradchinesename	元秋
Michelle Chong	tradchinesename	莊米雪
Wu Tianming	tradchinesename	吳天明
Benny Chan	tradchinesename	陳木勝
Anthony Wong	tradchinesename	黃耀明
Jade Kwan	tradchinesename	關心妍
Shannon Lee	tradchinesename	李香凝
Silver Ash	tradchinesename	銀色灰塵
Chthonic	tradchinesename	閃靈
Rainie Yang	tradchinesename	楊丞琳
Liu Kai-chi	tradchinesename	廖啟智
Wong Jing	tradchinesename	王晶
Jeanette Aw	tradchinesename	歐萱
Eric Moo	tradchinesename	巫啟賢
Wilber Pan	tradchinesename	潘瑋柏
Shawn Yue	tradchinesename	余文樂
Eric Tsang	tradchinesename	曾志偉
Raymond Chow	tradchinesename	鄒文懐
Roger Kwok	tradchinesename	郭晉安
Alexander Fu Sheng	tradchinesename	傅聲
Race Wong	tradchinesename	黃婉伶
Adia Chan	tradchinesename	陳松伶
Ashin	tradchinesename	陳信宏
Louis Koo	tradchinesename	古天樂
Yoshiko Yamaguchi	tradchinesename	李香蘭
Shirley Kwan	tradchinesename	關淑怡
Amy Yip	tradchinesename	葉子楣
Wang Luobin	tradchinesename	王洛賓
Liu Xiao Ling Tong	tradchinesename	六小齡童
Kenny Bee	tradchinesename	鍾鎮濤
Karl Maka	tradchinesename	麦嘉
Wakin Chau	tradchinesename	周華健
Jerry Lamb	tradchinesename	林曉峰
Chin Ka-lok	tradchinesename	錢嘉樂
Fei Yu-ching	tradchinesename	費玉清
Wu Ma	tradchinesename	午馬
Gordon Liu	tradchinesename	劉家輝
Yumiko Cheng	tradchinesename	鄭希怡
Yu So-chow	tradchinesename	于素秋
Agnes Chan	tradchinesename	陳美齡
Liu Yifei	tradchinesename	劉亦菲
Wei Wei	tradchinesename	韋唯
Vivian Wu	tradchinesename	鄔君梅
Edmond Leung	tradchinesename	梁漢文
Tat Ming Pair	tradchinesename	達明一派
Julian Cheung	tradchinesename	張智霖
Chapman To	tradchinesename	杜汶澤
Jim Chim	tradchinesename	詹瑞文
Peter Pau	tradchinesename	鮑德熹
Adrian Pang	tradchinesename	彭耀順
Gallen Lo	tradchinesename	羅嘉良
Sandy Lam	tradchinesename	林憶蓮
Vivian Chow	tradchinesename	周慧敏
Kelly Poon	tradchinesename	潘嘉麗
Chingmy Yau	tradchinesename	邱淑貞
Melissa Ng	tradchinesename	吳美珩
Lawrence Ng	tradchinesename	吳啟華
Charmaine Sheh	tradchinesename	佘詩曼
Liu Xiaoqing	tradchinesename	劉曉慶
Patrick Tam	tradchinesename	譚耀文
Daniel Wu	tradchinesename	吳彥祖
Landy Wen	tradchinesename	溫嵐
Maggie Cheung Ho-yee	tradchinesename	張可頤
Danny Chan Kwok-kwan	tradchinesename	陳國坤
Joyce Cheng	tradchinesename	鄭欣宜
Sunny Chan	tradchinesename	陳錦鴻
JJ Lin	tradchinesename	林俊傑
Lee San-san	tradchinesename	李珊珊
Zhang Yuan	tradchinesename	張元
Kwong Wa	tradchinesename	江華
Allen Fong	tradchinesename	方育平
Bobo Chan	tradchinesename	陳文媛
Patrick Tse	tradchinesename	謝賢
Jane Zhang	tradchinesename	張靚穎
Yim Ho	tradchinesename	嚴浩
Chiu Chi-ling	tradchinesename	趙志淩
Kenneth Chan Kai-tai	tradchinesename	陳啟泰
Dicky Cheung	tradchinesename	張衛健
Steven Cheung	tradchinesename	張致恆
Chen Hao	tradchinesename	陳好
Shirley Yeung	tradchinesename	楊思琦
Lau Kar-leung	tradchinesename	劉家良
Kenny Kwan	tradchinesename	關智斌
Frances Yip	tradchinesename	葉麗儀
Zhou Xiaowen	tradchinesename	周曉文
Xie Shaoguang	tradchinesename	謝韶光
Tay Ping Hui	tradchinesename	鄭斌輝
Xie Jin	tradchinesename	謝晉
Wang Xiaoshuai	tradchinesename	王小帥
Stephy Tang	tradchinesename	鄧麗欣
Theresa Fu	tradchinesename	傅穎
Kary Ng	tradchinesename	吳雨霏
Miki Yeung	tradchinesename	楊愛瑾
Denise Ho	tradchinesename	何韻詩
Li Han-hsiang	tradchinesename	李翰祥
Dayo Wong	tradchinesename	黃子華
Ning Jing	tradchinesename	寧靜
Xia Meng	tradchinesename	夏夢
Marco Ngai	tradchinesename	魏駿傑
Ivy Lee	tradchinesename	李錦梅
Andrew Seow	tradchinesename	蕭乙銘
Justin Lo	tradchinesename	側田
Kent Tong	tradchinesename	湯鎮業
Christopher Lee	tradchinesename	李銘順
Niki Chow	tradchinesename	周麗淇
Bosco Wong	tradchinesename	黃宗澤
Jimmy Lin	tradchinesename	林志穎
Kellyjackie	tradchinesename	陳曉琪
Moses Chan	tradchinesename	陳豪
Charlie Cho	tradchinesename	曹查理
Angelica Lee	tradchinesename	李心潔
Karena Lam	tradchinesename	林嘉欣
Tavia Yeung	tradchinesename	楊怡
Back Dorm Boys	tradchinesename	後舍男生
Chet Lam	tradchinesename	林一峰
Joey Leung	tradchinesename	梁榮忠
Ellen Joyce Loo	tradchinesename	盧凱彤
Ocean Ou	tradchinesename	歐得洋
Deric Wan	tradchinesename	溫兆倫
Jackie Chan Stunt Team	tradchinesename	成家班
Stanley Huang	tradchinesename	黃立行
Janice Vidal	tradchinesename	衛蘭
Carman Lee	tradchinesename	李若彤
Derek Kok	tradchinesename	郭政鴻
Loletta Lee	tradchinesename	李麗珍
Jeff Chang	tradchinesename	張信哲
Derek Yee	tradchinesename	爾冬陞
Nora Miao	tradchinesename	苗可秀
Huang Biren	tradchinesename	黃碧仁
Mark Lee	tradchinesename	李國煌
Danny Lee	tradchinesename	李修賢
Fiona Sit	tradchinesename	薛凱琪
Mark Lui	tradchinesename	雷頌德
Aileen Tan	tradchinesename	陳麗貞
Xiang Yun	tradchinesename	向雲
Lo Wei	tradchinesename	羅維
Edward Yang	tradchinesename	楊德昌
Wu Nien-jen	tradchinesename	吳念真
Feng Gong	tradchinesename	馮鞏
Ching Siu-tung	tradchinesename	程小東
Ron Ng	tradchinesename	吳卓羲
Faith Yang	tradchinesename	楊乃文
Kenji Wu	tradchinesename	吳克群
Ray Lui	tradchinesename	呂良偉
Bernice Liu	tradchinesename	廖碧兒
Collin Chou	tradchinesename	鄒兆龍
Xing Yu	tradchinesename	行宇
Peter Chan	tradchinesename	陳可辛
Shih Kien	tradchinesename	石堅
Bobby Au-yeung	tradchinesename	歐陽震華
Lee Hoi-chuen	tradchinesename	李海泉
Joshua Ang	tradchinesename	洪賜健
Dasmond Koh	tradchinesename	許振榮
Fei Mu	tradchinesename	費穆
Mandy Chiang	tradchinesename	蔣雅文
Lisa Lu	tradchinesename	盧燕
Myolie Wu	tradchinesename	胡杏兒
Annie Man	tradchinesename	文頌嫻
Flora Chan	tradchinesename	陳慧珊
Chen Hong	tradchinesename	陳紅
Kwan Tak-hing	tradchinesename	關德興
Bibi Zhou	tradchinesename	周筆暢
Chen Hanwei	tradchinesename	陳漢瑋
Wu Yonggang	tradchinesename	吳永剛
Sandra Ng	tradchinesename	吳君如
Stephen Fung	tradchinesename	馮德倫
Chen Xiuhuan	tradchinesename	陳秀環
Rebecca Chan	tradchinesename	陳秀珠
Yan Yan Mak	tradchinesename	麥婉欣
Nan Quan Mama	tradchinesename	南拳媽媽
Charmaine Li	tradchinesename	李思欣
Jill Vidal	tradchinesename	衛詩
Raymond Lam	tradchinesename	林峯
Sammul Chan	tradchinesename	陳鍵鋒
Sharon Chan	tradchinesename	陳敏之
Vincy Chan	tradchinesename	泳兒
Leila Tong	tradchinesename	唐寧
Kee Thuan Chye	tradchinesename	紀傳財
Cherrie Ying	tradchinesename	應采兒
Huang Xiaoming	tradchinesename	黃曉明
Linda Chung	tradchinesename	鍾嘉欣
Joe Chen	tradchinesename	陳喬恩
Liu Tao	tradchinesename	劉濤
Jiang Qinqin	tradchinesename	蔣勤勤
Shawn Lee	tradchinesename	李創銳
Sheren Tang	tradchinesename	鄧萃雯
Steven Ma	tradchinesename	馬浚偉
Kevin Cheng	tradchinesename	鄭嘉穎
Kaira Gong	tradchinesename	龔詩嘉
Wan Kwong	tradchinesename	尹光
Connie Chan	tradchinesename	陳寶珠
Chyi Chin	tradchinesename	齊秦
Freya Lim	tradchinesename	林凡
Tracy Ip	tradchinesename	葉翠翠
Show Luo	tradchinesename	羅志祥
Sylvia Chang	tradchinesename	張艾嘉
Dave Wang	tradchinesename	王傑
Ken Lo	tradchinesename	盧惠光
Fala Chen	tradchinesename	陳法拉
Gloria Yip	tradchinesename	葉蘊儀
Leanne Li	tradchinesename	李亞男
Zhang Yang	tradchinesename	張揚
Mavis Hee	tradchinesename	許美靜
Alan Ko	tradchinesename	柯有倫
Charlie Young	tradchinesename	楊采妮
Nicky Wu	tradchinesename	吳奇隆
Ellen Chan	tradchinesename	陳雅倫
Maria Cordero	tradchinesename	瑪俐亞
Joe Cheng	tradchinesename	鄭元暢
Josephine Koo	tradchinesename	顧美華
William Chan	tradchinesename	陳偉霆
Chelsia Chan	tradchinesename	陳秋霞
Yang Mi	tradchinesename	楊冪
Tse Ling-ling	tradchinesename	謝玲玲
Wilson Yip	tradchinesename	葉偉信
Cho Tat-wah	tradchinesename	曹達華
JerryC	tradchinesename	張逸帆
Wai Ka-fai	tradchinesename	韋家輝
Alex Fong	tradchinesename	方中信
Cynthia Koh	tradchinesename	許美珍
Natalis Chan	tradchinesename	陳百祥
Paul Fonoroff	tradchinesename	方保羅
Natalie Wong	tradchinesename	黃𨥈瑩
YLK Organization	tradchinesename	余力機構
Michelle Ye	tradchinesename	葉璇
Angie Chiu	tradchinesename	趙雅芝
Xu Jinglei	tradchinesename	徐靜蕾
Bowie Lam	tradchinesename	林保怡
Elaine Ng Yi-Lei	tradchinesename	吳綺莉
Carrie Lam	tradchinesename	林莉
Kara Hui	tradchinesename	惠英紅
Winston Chao	tradchinesename	趙文瑄
Sharon Luk	tradchinesename	陸詩韻
Aimee Chan	tradchinesename	陳茵媺
Zhu Xu	tradchinesename	朱旭
Cherie Chung	tradchinesename	鍾楚紅
Angela Tong	tradchinesename	湯盈盈
Lawrence Ah Mon	tradchinesename	劉國昌
Li Jinhui	tradchinesename	黎錦暉
Bowie Tsang	tradchinesename	曾寶儀
Zheng Junli	tradchinesename	鄭君里
Tats Lau	tradchinesename	劉以達
Zhao Dan	tradchinesename	趙丹
Emme Wong	tradchinesename	黃伊汶
Leung Siu-lung	tradchinesename	梁小龍
Teresa Carpio	tradchinesename	杜麗莎
Candy Lo	tradchinesename	盧巧音
Hawick Lau	tradchinesename	劉愷威
Bruce Le	tradchinesename	呂小龍
Harlem Yu	tradchinesename	庾澄慶
Ronald Cheng	tradchinesename	鄭中基
Michael Kwan	tradchinesename	關正傑
Ady An	tradchinesename	安以軒
Vivien Yeo	tradchinesename	楊秀惠
Teddy Robin	tradchinesename	泰迪羅賓
Anne Heung	tradchinesename	向海嵐
Françoise Yip	tradchinesename	葉芳華
Frankie Lam	tradchinesename	林文龍
Phyllis Quek	tradchinesename	郭妃麗
Stephen Chan Chi-wan	tradchinesename	陳志雲
Chang Chen-yue	tradchinesename	張震嶽
Yu Jim-yuen	tradchinesename	于占元
Elaine Jin	tradchinesename	金燕玲
Huang Shengyi	tradchinesename	黃聖依
Sam Chan	tradchinesename	陳宇琛
Richard Low	tradchinesename	劉謙益
Raymond Cho	tradchinesename	曹永廉
Benny Chan	tradchinesename	陳浩民
Guo Degang	tradchinesename	郭德綱
Charles Ying	tradchinesename	應昌佑
Pierre Png	tradchinesename	方展發
Mike He	tradchinesename	賀軍翔
Koni Lui	tradchinesename	呂慧儀
Liu Huan	tradchinesename	劉歡
Power Station	tradchinesename	動力火車
Winnie Lau	tradchinesename	劉小慧
Terence Cao	tradchinesename	曹國輝
Baby Zhang	tradchinesename	張含韻
Raymond Wong Pak-ming	tradchinesename	黃百鳴
Sheila Chan	tradchinesename	陳淑蘭
Clifton Ko	tradchinesename	高志森
Alien Sun	tradchinesename	孫佳君
Eugenia Yuan	tradchinesename	原麗淇
Ma Ji	tradchinesename	馬季
Hui Shiu-hung	tradchinesename	許紹雄
Alex To	tradchinesename	杜德偉
Cheung Siu-fai	tradchinesename	張兆輝
Alan Tern	tradchinesename	唐育書
Zhang Fengyi	tradchinesename	張豐毅
Lo Ta-yu	tradchinesename	羅大佑
Joyce Tang	tradchinesename	滕麗名
Chin Tsi-ang	tradchinesename	錢似鶯
Louisa So	tradchinesename	蘇玉華
Victor Wong	tradchinesename	黃品冠
Power Chan	tradchinesename	陳國邦
Joanne Tseng	tradchinesename	曾之喬
Matthew Ko	tradchinesename	高鈞賢
The Wynners	tradchinesename	溫拿
Wilfred Lau	tradchinesename	劉浩龍
Sun Feifei	tradchinesename	孫菲菲
Shermon Tang	tradchinesename	鄧上文
Rayson Tan	tradchinesename	陳泰銘
Jade Seah	tradchinesename	謝美玉
Beatrice Hsu	tradchinesename	許瑋倫
Gu Changwei	tradchinesename	顧長衛
Natalie Tong	tradchinesename	唐詩詠
Tang Ti-sheng	tradchinesename	唐滌生
Yam Kim-fai	tradchinesename	任劍輝
Anthony Lun	tradchinesename	倫永亮
Shing Fui-On	tradchinesename	成奎安
Zhang Yaodong	tradchinesename	張耀棟
Lou Ye	tradchinesename	婁燁
Lau Dan	tradchinesename	劉丹
Joey Meng	tradchinesename	萬綺雯
Sodagreen	tradchinesename	蘇打綠
Felix Chong	tradchinesename	莊文強
Bill Tung	tradchinesename	董驃
Chang Yu-sheng	tradchinesename	張雨生
Phil Chang	tradchinesename	張宇
Gao Yuanyuan	tradchinesename	高圓圓
He Meitian	tradchinesename	何美鈿
Canti Lau	tradchinesename	劉錫明
Cindy Au	tradchinesename	歐倩怡
Zero Chou	tradchinesename	周美玲
Sharla Cheung	tradchinesename	張敏
Victor Huang	tradchinesename	黃維德
Ethan Juan	tradchinesename	阮經天
Sun Yu	tradchinesename	孫瑜
Kelvin Kwan	tradchinesename	關楚耀
Roman and the Four Steps	tradchinesename	羅文四步合唱團
Belinda Hamnett	tradchinesename	韓君婷
Lam Chi-chung	tradchinesename	林子聰
Richard Ng	tradchinesename	吳耀漢
Joe Ma	tradchinesename	馬德鐘
Michael Miu	tradchinesename	苗僑偉
Gong Qiuxia	tradchinesename	龔秋霞
Wu Yingyin	tradchinesename	吳鶯音
Li Yang	tradchinesename	李楊
Wallace Huo	tradchinesename	霍建華
Ying Liang	tradchinesename	應亮
Monica Chan	tradchinesename	陳法蓉
Annie Wu	tradchinesename	吳辰君
Charles Heung	tradchinesename	向華強
Bryan Leung	tradchinesename	梁家仁
Tiffany Chen	tradchinesename	陳嵐
Stanley Fung	tradchinesename	馮淬帆
Philip Chan	tradchinesename	陳欣健
Kathy Chow	tradchinesename	周海媚
Berg Ng	tradchinesename	吳廷燁
Chen Xiaoxu	tradchinesename	陳曉旭
Henry Thia	tradchinesename	程旭輝
Sherman Chung	tradchinesename	鍾舒漫
Susanna Kwan	tradchinesename	關菊英
Charlie Chin	tradchinesename	秦祥林
Alan Tang	tradchinesename	鄧光榮
Jack Neo	tradchinesename	梁智強
Winnie Hsin	tradchinesename	辛曉琪
Dennis Law	tradchinesename	羅守耀
Max Mok	tradchinesename	莫少聰
Hoyan Mok	tradchinesename	莫可欣
Four Golden Flowers	tradchinesename	四朵金花
Angela Au	tradchinesename	區文詩
Joe Junior	tradchinesename	祖·尊尼亞
Jia Hongsheng	tradchinesename	賈宏聲
Bu Wancang	tradchinesename	卜萬蒼
Deserts Chang	tradchinesename	張懸
Roy Chiu	tradchinesename	邱澤
Lü Yue	tradchinesename	呂樂
Lin Dai	tradchinesename	林黛
Liu Wai-hung	tradchinesename	廖偉雄
Michael & Victor	tradchinesename	無印良品
Wang Baoqiang	tradchinesename	王寶強
Halina Tam	tradchinesename	譚小環
Cecilia Yip	tradchinesename	葉童
Ix Shen	tradchinesename	瀋傾剡 / 瀋傾掞
Kit Hung	tradchinesename	洪榮杰
Lai Lok-yi	tradchinesename	黎諾懿
Ian Gouw	tradchinesename	吳澋滔
Hins Cheung	tradchinesename	張敬軒
Ken Hung	tradchinesename	洪卓立
Rene Liu	tradchinesename	劉若英
Au Kin-yee	tradchinesename	歐健兒
Law Wing-cheung	tradchinesename	羅永昌
Benjamin Yuen	tradchinesename	袁偉豪
James Tien	tradchinesename	田俊
Chan Kwong-wing	tradchinesename	陳光榮
Tang Guoqiang	tradchinesename	唐國強
Chyi Yu	tradchinesename	齊豫
Gwei Lun-Mei	tradchinesename	桂綸鎂
Frankie Chan	tradchinesename	陳勳奇
Regina Kent	tradchinesename	簡慧珍
Hey Girl	tradchinesename	黑Girl
Michael Tse	tradchinesename	謝天華
Bondy Chiu	tradchinesename	趙學而
Pauline Lan	tradchinesename	藍心湄
Hou Yong	tradchinesename	侯詠
An Youqi	tradchinesename	安又琪
Jacklyn Wu	tradchinesename	吳倩蓮
Jimmy Heung	tradchinesename	向華勝
Damian Lau	tradchinesename	劉松仁
Shin	tradchinesename	信樂團
Nick Cheung	tradchinesename	張家輝
Tony Yang	tradchinesename	楊祐寧
Szeto Kam-Yuen	tradchinesename	司徒錦源
Alice Au	tradchinesename	區燕青
Alice Tzeng	tradchinesename	曾愷玹
Gordon Chan	tradchinesename	陳嘉上
Eileen Yeow	tradchinesename	姚瑩瑩
Jason Chan	tradchinesename	陳柏宇
Hsieh Ho-hsien	tradchinesename	謝和弦
Aska Yang	tradchinesename	楊宗緯
Dong Jie	tradchinesename	董潔
Sun Li	tradchinesename	孫儷
Huang Wenyong	tradchinesename	黃文永
Liu Fendou	tradchinesename	劉奮斗
Paul Chun	tradchinesename	秦沛
Jeffrey Lau	tradchinesename	劉鎮偉
Sarah Chen	tradchinesename	陳淑樺
Bryan Wong	tradchinesename	王祿江
Raymond Wong Ho-yin	tradchinesename	黃浩然
Albert Au	tradchinesename	區瑞強
Kingone Wang	tradchinesename	王傳一
John Chong	tradchinesename	莊澄
Patrick Yau	tradchinesename	游達志
Wong Tin-lam	tradchinesename	王天林
Zhang Guoli	tradchinesename	張國立
Michael Tong	tradchinesename	唐文龍
Zhang Jingchu	tradchinesename	張靜初
Chen Liping	tradchinesename	陳莉萍
Stephen Wong Ka-lok	tradchinesename	黃嘉樂
Martin Chappell	tradchinesename	卓保怡
Chen Shiang-chyi	tradchinesename	陳湘琪
Jimmy Nah	tradchinesename	藍顉嘻
Jim Tang	tradchinesename	鄧永健
Lu Xuechang	tradchinesename	路學長
He Saifei	tradchinesename	何賽飛
Esther Kwan	tradchinesename	關詠荷
Lowell Lo	tradchinesename	盧冠廷
Jiang Ying	tradchinesename	蔣英
Softhard	tradchinesename	軟硬天師
Chen Shucheng	tradchinesename	陳澍城
Lu Yi-ching	tradchinesename	陸弈靜
Zhao Xiaoding	tradchinesename	趙小丁
Amber Kuo	tradchinesename	郭采潔
Yonfan	tradchinesename	楊凡
Jolene Chin	tradchinesename	陳影雯
Dante Lam	tradchinesename	林超賢
Matt Chow	tradchinesename	鄒凱光
Jam Hsiao	tradchinesename	蕭敬騰
Yu Lik-wai	tradchinesename	余力爲
Chung King-fai	tradchinesename	鍾景輝
Yang Shu	tradchinesename	楊述
Wu Di	tradchinesename	鄔迪
Zheng Geping	tradchinesename	鄭各評
Kathy Yuen	tradchinesename	湯怡
Tiger Hu	tradchinesename	胡彥斌
Jacob Cheung	tradchinesename	張之亮
Ning Ying	tradchinesename	寧瀛
Jason Hsu	tradchinesename	許孟哲
Kent Cheng	tradchinesename	鄭則士
Florence Kwok	tradchinesename	郭少芸
Ivy Ho	tradchinesename	岸西
Ma Liwen	tradchinesename	馬儷文
Sa Dingding	tradchinesename	薩頂頂
Pace Wu	tradchinesename	吳佩慈
Lily Li	tradchinesename	李麗麗
John Shum	tradchinesename	岑建勳
Han Sanping	tradchinesename	韓三平
Su Rui	tradchinesename	蘇芮
Pai Ping-ping	tradchinesename	白冰冰
Zhang Yibai	tradchinesename	張一白
Priscelia Chan	tradchinesename	曾詩梅
Lung Fong	tradchinesename	龍方
Ning Hao	tradchinesename	甯浩
Barry Wong	tradchinesename	黃炳耀
Dong Yong	tradchinesename	董勇
Wong Cho-lam	tradchinesename	王祖藍
Xu Jiao	tradchinesename	徐嬌
Alan Dawa Dolma	tradchinesename	阿蘭·達瓦卓瑪
Chen Tianwen	tradchinesename	陳天文
Marcus Chin	tradchinesename	陳建彬
Joanna Wang	tradchinesename	王若琳
Law Kar-ying	tradchinesename	羅家英
Choi Kwok-wai	tradchinesename	蔡國威
Jack Wu	tradchinesename	胡諾言
Stefan Wong	tradchinesename	黃長興
Hsu Wei-ning	tradchinesename	許瑋甯
Zhang Jizhong	tradchinesename	張紀中
Eric Kot	tradchinesename	葛民輝
Deng Jie	tradchinesename	鄧婕
John Cheng	tradchinesename	鍾耀南
Wu Yigong	tradchinesename	吳貽弓
Daniel Chan	tradchinesename	陳曉東
Dominic Lam	tradchinesename	林嘉華
Chan Shen	tradchinesename	詹森
Cass Phang	tradchinesename	彭羚
Grace Chang	tradchinesename	葛蘭
Claire Kuo	tradchinesename	郭靜
Tan Kun-giok	tradchinesename	陳君玉
Arthur Wong	tradchinesename	黃岳泰
Huang Jianxin	tradchinesename	黃建新
Wang Fuli	tradchinesename	王馥荔
Corinna Chamberlain	tradchinesename	陳明恩
Wang Gang	tradchinesename	王剛
Christine Ng	tradchinesename	伍詠薇
Yan Shunkai	tradchinesename	嚴順開
Sire Ma	tradchinesename	馬賽
Yammie Lam	tradchinesename	藍潔瑛
Candy Chu	tradchinesename	朱婉儀
Liu Wen Zheng	tradchinesename	劉文正
Loretta Yang	tradchinesename	楊惠姍
Yang Peiyi	tradchinesename	楊沛宜
Jiang Wenli	tradchinesename	蔣雯麗
Cao Fang	tradchinesename	曹方
Sun-sun	tradchinesename	純純
Elvina Kong	tradchinesename	江欣燕
Stephen Au	tradchinesename	歐錦棠
Paul Chung	tradchinesename	鍾保羅
Soh Hang-suen	tradchinesename	蘇杏璇
Cheung Tat-ming	tradchinesename	張達明
Peter Ho	tradchinesename	何潤東
Patricia Mok	tradchinesename	莫小玲
Cheng Gwan-min	tradchinesename	鄭君綿
Vincent Zhao	tradchinesename	趙文卓
Wei Te-Sheng	tradchinesename	魏德聖
He Jianjun	tradchinesename	何建軍
Patrick Kong	tradchinesename	葉念琛
Sun Nan	tradchinesename	孫楠
Shaun Chen	tradchinesename	陳泓宇
Ma Tianyu	tradchinesename	馬天宇
Bowie Wu	tradchinesename	胡楓
Bowie Wu	tradchinesename	胡繼修
Liu Hao	tradchinesename	劉浩
Yuen Cheung-yan	tradchinesename	袁祥仁
Alex Man	tradchinesename	萬梓良
Lau Ka-ho	tradchinesename	劉家豪
Felix Lok	tradchinesename	駱應鈞
Karl Dominik	tradchinesename	凱洱
Lau Kar-wing	tradchinesename	劉家榮
Charlene Tse	tradchinesename	謝寧
Chen Ying-Git	tradchinesename	陳盈潔
Candice Yu	tradchinesename	余安安
Edmund Chen	tradchinesename	陳之財
Cutie Mui	tradchinesename	楳小惠
Wallis Pang	tradchinesename	彭子晴
Gilbert Lam	tradchinesename	林韋辰
Chen Guohua	tradchinesename	陳國華
Rosanne Wong	tradchinesename	黃婉君
Kuei Chih-Hung	tradchinesename	桂治洪
Prudence Liew	tradchinesename	劉美君
Lee Heung-kam	tradchinesename	李香琴
Noel Leung	tradchinesename	梁小冰
Wu Hsing-kuo	tradchinesename	吳興國
Paisley Wu	tradchinesename	胡蓓蔚
William So	tradchinesename	蘇永康
Kimberley Chen	tradchinesename	陳芳語
Huang Yi	tradchinesename	黃奕
He Jie	tradchinesename	何潔
Leonard Ho	tradchinesename	何冠昌
Keith Chan Siu-kei	tradchinesename	陳少琪
Jane Huang	tradchinesename	黃美珍
Zhao Fei	tradchinesename	赵非
Lau Kong	tradchinesename	劉江
Gui Gui	tradchinesename	鬼鬼
G.E.M.	tradchinesename	鄧紫棋
Top Combine	tradchinesename	至上勵合
Roy Chiao	tradchinesename	喬宏
Fiona Xie	tradchinesename	謝宛諭
Mona Fong	tradchinesename	方逸華
Susan Wong	tradchinesename	黃翠珊
Wu Ziniu	tradchinesename	吳子牛
Lu Chuan	tradchinesename	陸川
Chen Chusheng	tradchinesename	陳楚生
Willie Chan	tradchinesename	陳自強
Chen Kuan-tai	tradchinesename	陳觀泰
Lo Mang	tradchinesename	羅莽
Liu Bingjian	tradchinesename	劉冰鑒
Tsui Ping	tradchinesename	崔萍
Yoyo Chen	tradchinesename	陳自瑤
Suki Chui	tradchinesename	徐淑敏
Vivian Lai	tradchinesename	賴怡伶
Zhang Jianya	tradchinesename	张建亚
Tang Pik-wan	tradchinesename	鄧碧雲
Bak Man-biu	tradchinesename	白文彪
Xia Gang	tradchinesename	夏鋼
Elliot Ngok	tradchinesename	岳華
Liu Miaomiao	tradchinesename	劉苗苗
Baron Chen	tradchinesename	陳楚河
Superband	tradchinesename	縱貫線
FAMA	tradchinesename	農夫
Mickey Huang	tradchinesename	黃子佼
Sun Ma Sze Tsang	tradchinesename	新馬師曾
Leung Sing-Bor	tradchinesename	梁醒波
Loong Kin Sang	tradchinesename	龍劍笙
Sun Rui	tradchinesename	孫銳
Ting-Ting Hu	tradchinesename	胡婷婷
Law Lan	tradchinesename	羅蘭
Dean Shek	tradchinesename	石天
Patrick Tang	tradchinesename	鄧健泓
Chan Hung-lit	tradchinesename	陳鴻烈
Robert Lee	tradchinesename	李振輝
Lawrence Cheng	tradchinesename	鄭丹瑞
Chin Siu-ho	tradchinesename	錢小豪
Chieh Yuan	tradchinesename	解元
Kwan Hoi-san	tradchinesename	關海山
Zhang Junzhao	tradchinesename	張軍釗
Paw Hee-ching	tradchinesename	鮑起靜
Joan Lin	tradchinesename	林鳳嬌
Mark Kwok	tradchinesename	郭耀明
Carol Cheng	tradchinesename	鄭裕玲
Hsiao Huang-Chi	tradchinesename	蕭煌奇
Wang Luoyong	tradchinesename	王洛勇
Jacky Wong	tradchinesename	王樹熹
Lo Hoi-pang	tradchinesename	盧海鵬
Xiao Xun	tradchinesename	黃瀞怡
Anthony Chan	tradchinesename	陳友
Jian Yi	tradchinesename	簡藝
Wong Jinglun	tradchinesename	黃靖倫
Fan Wei	tradchinesename	范偉
Alien Huang	tradchinesename	黃鴻升
Celest Chong	tradchinesename	張玉華
Cynthia Khan	tradchinesename	楊
Zhang Yuqi	tradchinesename	張雨綺
Chen Sicheng	tradchinesename	陳思诚
Crowd Lu	tradchinesename	盧廣仲
Zheng Zhengqiu	tradchinesename	鄭正秋
Tony Liu	tradchinesename	劉永
Edwin Siu	tradchinesename	蕭正楠
Shui Hua	tradchinesename	水華
Shi Hui	tradchinesename	石揮
Unicorn Chan	tradchinesename	小麒麟
Mars	tradchinesename	火星
Ellesmere Choi	tradchinesename	蔡子健
Michelle Wai	tradchinesename	衛詩雅
Mark Cheng	tradchinesename	鄭浩南
Janine Chang	tradchinesename	張鈞甯
Shi Dongshan	tradchinesename	史東山
Louis Yuen	tradchinesename	阮兆祥
Stephanie Che	tradchinesename	車婉婉
Dexter Young	tradchinesename	楊天經
Huang Zhizhong	tradchinesename	黃志忠
Xiao Man	tradchinesename	王淑萱/王婧喬/王承嫣
Jack Kao	tradchinesename	高捷
Janice Man	tradchinesename	文詠珊
Niu Ben	tradchinesename	牛犇
Zhang Guoqiang	tradchinesename	張國強
Hsiao Hung-jen	tradchinesename	蕭閎仁
Carrie Ng	tradchinesename	吳家麗
Johnny Ngan	tradchinesename	顏國樑
Linda Wong	tradchinesename	王馨平
Amy Kwok	tradchinesename	郭藹明
Liu Xijun	tradchinesename	劉惜君
Bobby Chen	tradchinesename	陳昇
Chen Kuo-Fu	tradchinesename	陳國富
Yi Jet Qi	tradchinesename	易桀齊
Xiaoshenyang	tradchinesename	小沈陽
Gill Mohindepaul Singh	tradchinesename	喬寶寶
Michelle Saram	tradchinesename	鄭雪兒
Chen Lin	tradchinesename	陳琳
Nana Lee	tradchinesename	李千娜
Susan Tse	tradchinesename	謝雪心
Liu Yonghong	tradchinesename	劉勇宏
Louis Cheung	tradchinesename	張繼聰
Mary Hon	tradchinesename	韓馬利
Evergreen Mak Cheung-ching	tradchinesename	麥長青
Tsui Wing	tradchinesename	徐榮
Liu Peiqi	tradchinesename	劉佩琦
Ocean Hai	tradchinesename	海鳴威
Zhang Tielin	tradchinesename	張鐵林
Lin Meijiao	tradchinesename	林梅嬌
Derrick Hoh	tradchinesename	何維健
Shen Xiling	tradchinesename	沈西苓
Mary Jean Reimer	tradchinesename	翁靜晶
Reen Yu	tradchinesename	喻虹淵
Angelababy	tradchinesename	楊穎
Chen Baoguo	tradchinesename	陳寶國
Yang Lina	tradchinesename	楊莉娜
Alfred Hsing	tradchinesename	邢思傑
Tina Leung	tradchinesename	狄娜
Lin Yu-chun	tradchinesename	林育羣
writer)	tradchinesename	云翔
Osman Hung	tradchinesename	洪智傑
Him Law	tradchinesename	羅仲
Mark Chao	tradchinesename	趙又廷
Macy Chan	tradchinesename	陳美詩
Tong Dawei	tradchinesename	佟大為
Feng Xiaoning	tradchinesename	馮小寧
Yu Rongguang	tradchinesename	于榮光
Jess Sum	tradchinesename	沈卓盈
Thomas Ho	tradchinesename	何兆鴻
Feng Shaofeng	tradchinesename	馮紹峰
Kenny Ho	tradchinesename	何家勁
Serena Fang	tradchinesename	房思瑜
Quan Yi Fong	tradchinesename	權怡鳳
Go Go Club	tradchinesename	兄弟聯
Andrea Chen	tradchinesename	陳匡怡
James Lye	tradchinesename	賴興祥
Chen Zeyu	tradchinesename	陳澤宇
Terri Kwan	tradchinesename	關穎
JuJu Chan	tradchinesename	陳鈺芸
May Lo	tradchinesename	羅美薇
Joel Chan	tradchinesename	陳山聰
Kingdom Yuen	tradchinesename	苑瓊丹
One-Fang	tradchinesename	萬芳
Luo Jin	tradchinesename	羅晉
Keith Chan Fai-young	tradchinesename	陳輝陽
Russell Cheung	tradchinesename	張智軒
Liu Shishi	tradchinesename	劉詩詩
Henry O	tradchinesename	區亨利
Mimi Lo	tradchinesename	羅敏莊
Fiona Fung	tradchinesename	馮曦妤
Eric Li	tradchinesename	李天翔
Cindy Yen	tradchinesename	袁詠琳
Xue Xiaolu	tradchinesename	薛曉璐
Yang Pei-An	tradchinesename	楊培安
Cary Kwok	tradchinesename	郭紹恆
Pan Hong	tradchinesename	潘虹
Billy Chung	tradchinesename	鍾少雄
Yuan Wenqing	tradchinesename	原文慶
Ruby Wong	tradchinesename	黃卓玲
Anthony Neely	tradchinesename	倪安東
Fung Bo Bo	tradchinesename	馮寶寶
Emily Chu	tradchinesename	朱寶意
Bii	tradchinesename	畢書盡
Jin Yan	tradchinesename	金焰
Ashton Chen	tradchinesename	釋小龍
Yen-j	tradchinesename	嚴爵
Nie Yuan	tradchinesename	聶遠
Lee Tim-sing	tradchinesename	李添勝
Suzie Wong	tradchinesename	蘇施黃
Wallace Chung	tradchinesename	鍾漢良
Zhang Hanyu	tradchinesename	張涵予
Miu Zhu	tradchinesename	朱俐靜
JJ Jia	tradchinesename	賈曉晨
James Wen	tradchinesename	溫昇豪
Sandrine Pinna	tradchinesename	張榕容
Sharon Lee	tradchinesename	李昊嘉
Zhang Ruifang	tradchinesename	張瑞芳
Zhu Xijuan	tradchinesename	祝希娟
Zhang Yu	tradchinesename	張瑜
Li Xiuming	tradchinesename	李秀明
Fang Shu	tradchinesename	方舒
Meeia Foo	tradchinesename	符瓊音
Wu Tsing-Fong	tradchinesename	吳青峯
Yu Lan	tradchinesename	于蓝
Wang Xiaotang	tradchinesename	王晓棠
Ni Ping	tradchinesename	倪萍
William Wei	tradchinesename	韋禮安
A-Lin	tradchinesename	黃麗玲
Hiro Hayama	tradchinesename	葉山豪
Chi Kuan-chun	tradchinesename	戚冠軍
Kanny Theng	tradchinesename	邓晴冰
Candy Hsu	tradchinesename	許雅涵
Goh Eng Wah	tradchinesename	吳榮華
Chong Wai-kin	tradchinesename	莊偉建
Li Chen	tradchinesename	李晨
Li Shaohong	tradchinesename	李少紅
Shu Chang	tradchinesename	舒暢
Liu Yuxin	tradchinesename	劉雨欣
Hans Zhang	tradchinesename	張翰
JPM	tradchinesename	JPM
Lee Teng	tradchinesename	李騰
Zheng Shuang	tradchinesename	鄭爽
Zhao Yihuan	tradchinesename	趙奕歡
Alyssa Chia	tradchinesename	賈靜雯
Ivy Chen	tradchinesename	陳意涵
Eddie Peng	tradchinesename	彭于晏
Dong Zhen	tradchinesename	董貞
Chen Zhihui	tradchinesename	陳之輝
Bao Guo'an	tradchinesename	鮑國安
Yan Yikuan	tradchinesename	嚴屹寬
Qiao Zhenyu	tradchinesename	喬振宇
Kwok Fung	tradchinesename	郭鋒
Wu Yue	tradchinesename	吳樾
Qian Zhijun	tradchinesename	錢志君
Xue Zhiqian	tradchinesename	薛之謙
Sammy Sum	tradchinesename	沈震軒
Dennis Chew	tradchinesename	周崇慶
Kelly Cheung	tradchinesename	張曦雯
Alfred Hui	tradchinesename	許廷鏗
Chow Chung	tradchinesename	周驄
Cilla Kung	tradchinesename	樂瞳
Kitty Yuen	tradchinesename	阮小儀
Stanley Cheung	tradchinesename	張景淳
Vincent Ng	tradchinesename	翁清海
Mui Siu-ching	tradchinesename	梅小青
Astrid Chan	tradchinesename	陳芷菁
Griselda Yeung	tradchinesename	楊卓娜
Qin Lan	tradchinesename	秦嵐
Casper Chan	tradchinesename	陳思齊
Brian Tse	tradchinesename	謝東閔
Hou Baolin	tradchinesename	侯寶林
Ma Su	tradchinesename	馬蘇
Xu Huanshan	tradchinesename	許還山
Du Zhiguo	tradchinesename	杜志國
Chen Zihan	tradchinesename	陳紫函
Connie Mak Kit-man	tradchinesename	麥潔文
Dai Xiangyu	tradchinesename	戴向宇
Kate Pang	tradchinesename	龐蕾馨
Yuan Shuai	tradchinesename	袁帥
Desmond Tan	tradchinesename	陳泂江
Ben Yeo	tradchinesename	楊志龍
Sora Ma	tradchinesename	馬藝瑄
Fan Hung-hsuan	tradchinesename	范鴻軒
Jerry Yeo	tradchinesename	楊偉烈
Darren Lim	tradchinesename	林明倫
Nick Shen	tradchinesename	沈煒竣
Constance Song	tradchinesename	宋怡霏
William San	tradchinesename	辛偉廉
Wee Kheng Ming	tradchinesename	黃啟銘
Cavin Soh	tradchinesename	蘇智誠
Zhang Lei	tradchinesename	張磊
Moo Yan Yee	tradchinesename	巫恩儀
Gary Yap	tradchinesename	葉俊岑
Eliza Sam	tradchinesename	岑麗香
Yan Bingliang	tradchinesename	嚴丙量
Stella Chung	tradchinesename	鍾曉玉
Michelle Chia	tradchinesename	謝韻儀
Samuel Tai	tradchinesename	邰正宵
Yang Libing	tradchinesename	楊莉冰
Florence Tan	tradchinesename	陳秀麗
Debbie Goh	tradchinesename	吴天瑜
Xu Qing	tradchinesename	許晴
Pamelyn Chee	tradchinesename	齊騛
Lini Evans	tradchinesename	伊韻絲
Renée Chen	tradchinesename	陳嘉唯
Anthelion	tradchinesename	幻日
Angel Chiang	tradchinesename	蔣家旻
Vincent Wan	tradchinesename	溫家恆
Lee Wei	tradchinesename	李威
Lily Chan	tradchinesename	陳潔麗
Nicola Cheung	tradchinesename	張燊悅
Daniel Lee Chee Hun	tradchinesename	李桀漢
Lana Lo	tradchinesename	羅藍亞
Li Shuangjiang	tradchinesename	李雙江
Meng Ge	tradchinesename	夢鴿
Annie Liu	tradchinesename	小人*^o^*
Wu Mochou	tradchinesename	吳莫愁
Lan Cheng-lung	tradchinesename	藍正龍
Sita Chan	tradchinesename	陳僖儀
Jonathan Chik	tradchinesename	戚其義
Wyman Wong	tradchinesename	黃偉文
Chen Jianbin	tradchinesename	陳建斌
Chao Chuan	tradchinesename	趙傳
Wang Luodan	tradchinesename	王珞丹
Leon Dai	tradchinesename	戴立忍
Esther Eng	tradchinesename	伍錦霞
Anthony Chen	tradchinesename	陳哲藝
Yang Li-hua	tradchinesename	楊麗花
Samuel So	tradchinesename	蘇文星
Butterford Wong	tradchinesename	黄黄油福特
Ann	tradchinesename	白安
Huang Yali	tradchinesename	黃雅莉
Yu Junjian	tradchinesename	鬱鈞劍
Zeng Yi	tradchinesename	曾毅
Yangwei Linghua	tradchinesename	楊魏玲花
Pang Long	tradchinesename	龐龍
Li Guyi	tradchinesename	李穀一
Jin Tielin	tradchinesename	金鐵霖
Zu Hai	tradchinesename	祖海
Yan Weiwen	tradchinesename	閻維文
Zhang Ye	tradchinesename	張也
Chang Sisi	tradchinesename	常思思
Tang Can	tradchinesename	湯燦
Chen Lili	tradchinesename	陳笠笠
Lü Jihong	tradchinesename	呂繼宏
Grace Chan	tradchinesename	陳凱琳
Jayden Yuan	tradchinesename	袁曉超
Jiang Xin	tradchinesename	蔣欣
Sharon Kwan	tradchinesename	關詩敏
Lisa Cheng	tradchinesename	鄭麗莎
Jeannie Hsieh	tradchinesename	謝金燕
Zhu Yudong	tradchinesename	朱昱東
Bennett Pang	tradchinesename	彭健新
Yako Chan	tradchinesename	詹雅文/詹子晴/丫頭
Shiga Lin	tradchinesename	連詩雅
Celine Ma	tradchinesename	馬蹄露
Huang Ying	tradchinesename	黃英
Mini Chang	tradchinesename	張筱婕/張甯兒
Larisa Bakurova	tradchinesename	瑞莎
Zhang Meng	tradchinesename	張猛
Jeannie Chan	tradchinesename	陳瀅
Zhang Jin	tradchinesename	張晉
Steve Ma	tradchinesename	馬景濤
Han Xue	tradchinesename	韓雪
Betty Chung	tradchinesename	鍾玲玲
Jonathan Wong	tradchinesename	王梓軒
Jiang Dawei	tradchinesename	蔣大為
Philip Ng	tradchinesename	伍允龍
Tony Hung	tradchinesename	洪永城
Jacqueline Wong	tradchinesename	黃心穎
Wuershan	tradchinesename	烏爾善
Yang Zishan	tradchinesename	楊子姍
Marc Ma	tradchinesename	馬浴柯
Richard Juan	tradchinesename	范鴻志
Kandy Wong	tradchinesename	黃山怡
Sebastian Poon	tradchinesename	潘雲峰
Wan Jen	tradchinesename	萬仁
Lim Kay Tong	tradchinesename	林祺堂
Jasper Liu	tradchinesename	劉以豪
Li Daimo	tradchinesename	李代沫
Zhang Bichen	tradchinesename	張碧晨
Wong Yat-fei	tradchinesename	黃一飛
Janet Yang	tradchinesename	楊燕子
Kenny Wong	tradchinesename	黃德斌
A-fu	tradchinesename	鄧福如
Chloe Wang	tradchinesename	王樂妍
Zheng Kai	tradchinesename	鄭愷
Jerry Huang	tradchinesename	黃志瑋
Pong Nan	tradchinesename	藍奕邦
Aenie Wong	tradchinesename	王淑君
Jinny Ng	tradchinesename	吳若希
Yao Beina	tradchinesename	姚貝娜
Matt Wu	tradchinesename	吳中天
Mariane Chan	tradchinesename	陳妙瑛
Chris Wu	tradchinesename	吳慷仁
Sisley Choi	tradchinesename	蔡思貝
Lai Ying Tong	tradchinesename	賴映彤
Liu Hua	tradchinesename	劉樺
Gregory Wong	tradchinesename	王宗堯
Wang Sen	tradchinesename	王森
Jolin Chien	tradchinesename	簡宏霖
Tang Kee-chan	tradchinesename	鄧寄塵
Jessie Chung	tradchinesename	鍾潔希
Nylon Chen	tradchinesename	陳乃榮
Cher Ng	tradchinesename	黃子榮
Bai Fan	tradchinesename	白凡
Duan Yihong	tradchinesename	段奕宏
Francis Lee	tradchinesename	李焯雄
Vanessa Yeung	tradchinesename	楊崢
Carat Cheung	tradchinesename	張名雅
Li Ronghao	tradchinesename	李荣浩
Candy Yuen	tradchinesename	袁嘉敏
Zhang Lei	tradchinesename	張磊
Yan Su	tradchinesename	閻肅
Zhou Xiaoyan	tradchinesename	周小燕
Ludi Lin	tradchinesename	林路迪
Yin Xiangjie	tradchinesename	尹相傑
Chang Hsiao-yen	tradchinesename	張小燕
Roxanne Tong	tradchinesename	湯洛雯
Mao Ning	tradchinesename	毛寧
Chen Xuedong	tradchinesename	陳學冬
Vivian Sung	tradchinesename	宋芸樺
Jiang Chao	tradchinesename	姜潮
Hua Chenyu	tradchinesename	華晨宇
Jeremy Chan	tradchinesename	田銘耀
Huang Xuan	tradchinesename	黃軒
Zoe Tay	tradchinesename	鄭惠玉
Han Ying-chieh	tradchinesename	韓英傑
Joanna Dong	tradchinesename	董姿彥
Wang Ping	tradchinesename	王蘋
Huang Tsung Hsing	tradchinesename	黃宗迅
Simon Chung	tradchinesename	鐘德勝
Zeng Yanfen	tradchinesename	曾艷芬
Huang An	tradchinesename	黃安
Ju Jingyi	tradchinesename	鞠婧禕
Vivian Qu	tradchinesename	文晏
Lam Kwok-Hung	tradchinesename	林國雄
Zhao Jiamin	tradchinesename	趙嘉敏
Zhu Lan Qing	tradchinesename	朱嵐清
Zhu Shaowen	tradchinesename	朱紹文
Li Yitong	tradchinesename	李藝彤
Yuen Shun-yi	tradchinesename	袁信義
Huang Tingting	tradchinesename	黃婷婷
Chan Wui-ngai	tradchinesename	陳會毅
Fei Qinyuan	tradchinesename	費沁源
James Ng	tradchinesename	吳業坤
Dominic Zhai	tradchinesename	翟士诚
Andrew Yuen Man-kit	tradchinesename	袁文傑
Tang Anqi	tradchinesename	唐安琪
Xavier Ong	tradchinesename	王勝宇
Liya A	tradchinesename	阿麗亞
Nine One One	tradchinesename	玖壹壹
Zhang Yuge	tradchinesename	張語格
Wu Yue	tradchinesename	吳越
Moon Lau	tradchinesename	劉佩玥
Zoie Tam	tradchinesename	譚凱琪
Xu Jiaqi	tradchinesename	許佳琪
Zhao Yue	tradchinesename	趙粵
Karl Ting	tradchinesename	丁子朗
Li Ruijun	tradchinesename	李叡珺
Hong Peiyun	tradchinesename	洪珮雲
