Aberdare	welshName	Aberdâr
Abertillery	welshName	Abertyleri
Abergavenny	welshName	Y Fenni
Monmouth	welshName	Trefynwy
Caernarfon	welshName	Caernarfon
Gower Peninsula	welshName	Penrhyn Gŵyr
Llandaff	welshName	Llandaf
Fishguard	welshName	Abergwaun
St Davids	welshName	Tyddewi
Kilpeck	welshName	Llanddewi Cil Peddeg
Cowbridge	welshName	Y Bont-faen
Hay-on-Wye	welshName	Y Gelli Gandryll
Thornhill, Cardiff	welshName	Draenen Pen-y-graig
Haverfordwest	welshName	Hwlffordd
Farndon, Cheshire	welshName	Rhedynfre
Caerleon	welshName	Caerllion
Holyhead	welshName	Caergybi
Usk	welshName	Brynbuga
Borth	welshName	Y Borth
Hawarden	welshName	Penarlâg
Pontypridd	welshName	Pontypridd
Oswestry	welshName	Croesoswallt
Goodwick	welshName	Wdig
Chepstow	welshName	Cas-gwent
Brecon	welshName	Aberhonddu
Pembroke, Pembrokeshire	welshName	Penfro
Neath	welshName	Castell-nedd
Seven Sisters, Neath Port Talbot	welshName	Blaendulais
Trellech	welshName	Tryleg
Ruthin	welshName	Rhuthun
Caerphilly	welshName	Caerffili
Wrexham	welshName	Wrecsam
Cardiff Bay	welshName	Bae Caerdydd
Merthyr Tydfil	welshName	Merthyr Tudful
Bridgend	welshName	Pen-y-bont ar Ogwr
Ebbw Vale	welshName	Glyn Ebwy
Bishop's Castle	welshName	Trefesgob
Carmarthen	welshName	Caerfyrddin
Bangor-on-Dee	welshName	Bangor-is-y-Coed or Bangor Is-Coed
Ross-on-Wye	welshName	Rhosan ar Wy
Flint, Flintshire	welshName	Y Fflint
Rhyl	welshName	Y Rhyl
Aberbeeg	welshName	Aber-bîg
Buckley	welshName	Bwcle
Gwaelod-y-Garth	welshName	Gwaelod-y-garth
Caldicot, Monmouthshire	welshName	Cil-y-coed
Welshpool	welshName	Y Trallwng
Wick, Vale of Glamorgan	welshName	Y Wig
Ammanford	welshName	Rhydaman
Pontypool	welshName	Pont-y-pŵl
St Asaph	welshName	Llanelwy
Newborough, Anglesey	welshName	Niwbwrch
Beaumaris	welshName	Biwmares
Betws-y-Coed	welshName	Betws-y-Coed
Menai Bridge	welshName	Porthaethwy
Llan Ffestiniog	welshName	Ffestiniog
Bardsey Island	welshName	Ynys Enlli
Criccieth	welshName	Cricieth
Cardigan, Ceredigion	welshName	Aberteifi
Colwyn Bay	welshName	Bae Colwyn
Holywell	welshName	Treffynnon
Caldey Island	welshName	Ynys Bŷr
Newtown, Powys	welshName	Y Drenewydd
New Radnor	welshName	Maesyfed
Rhayader	welshName	Rhaeadr Gwy
Presteigne	welshName	Llanandras
Builth Wells	welshName	Llanfair ym Muallt
Knighton, Powys	welshName	Tref-y-clawdd
Llangammarch Wells	welshName	Llangamarch
Llandrindod Wells	welshName	Llandrindod
Montgomery, Powys	welshName	Trefaldwyn
Denbigh	welshName	Dinbych
Barmouth	welshName	Abermaw
Crickhowell	welshName	Crug Hywel
Chirk	welshName	Y Waun
Ystradfellte	welshName	Ystradfellte
Mold, Flintshire	welshName	Yr Wyddgrug
Lampeter	welshName	Llanbedr Pont Steffan
New Quay	welshName	Ceinewydd
Newcastle Emlyn	welshName	Castellnewydd Emlyn
Bargoed	welshName	Bargod
Maerdy	welshName	Maerdy
Maesteg	welshName	Maesteg
Whitland	welshName	Hendy-gwyn
Blaenavon	welshName	Blaenafon
Burry Port	welshName	Porth Tywyn
Kidwelly	welshName	Cydweli
Milford Haven	welshName	Aberdaugleddau
Llantwit Major	welshName	Llanilltud Fawr
Llandovery	welshName	Llanymddyfri
Newport, Pembrokeshire	welshName	Trefdraeth
Tenby	welshName	Dinbych-y-pysgod
Rhos-on-Sea	welshName	Llandrillo-yn-Rhos
Shell Island	welshName	Mochras
Pontrhydfendigaid	welshName	Pontrhydfendigaid
Pembroke Dock	welshName	Doc Penfro
Laugharne	welshName	Talacharn
Cenarth	welshName	Cenarth
Treorchy	welshName	Treorci
Tintern	welshName	Tyndyrn
St Clears	welshName	Sanclêr
Caersws	welshName	Caersŵs
Loughor	welshName	Casllwchwr
Gorseinon	welshName	Gorseinon
Briton Ferry	welshName	Llansawel
Glynneath	welshName	Glyn-nedd
Manorbier	welshName	Maenorbŷr
Nevern	welshName	Nanyfer
Mountain Ash, Rhondda Cynon Taf	welshName	Aberpennar
Welsh Bicknor	welshName	Llangystennin Garth Brenni
Rhymney	welshName	Rhymni
Ynysybwl	welshName	Ynys-y-bŵl
Risca	welshName	Rhisga
Cathays	welshName	Cathays
St Fagans	welshName	Sain Ffagan
Llanrumney	welshName	Llanrhymni
Lisvane	welshName	Llys-faen
Radyr	welshName	Radur
Gabalfa	welshName	Gabalfa
Cyncoed	welshName	Cyncoed
Michaelston-super-Ely	welshName	Llanfihangel-ar-Elai
St Mellons	welshName	Llaneirwg
Wolf's Castle	welshName	Casblaidd
Aberavon	welshName	Aberafan
Cardiff city centre	welshName	Canol y Ddinas, Caerdydd
Llwynypia	welshName	Llwyn-y-pïa
Colwinston	welshName	Tregolwyn
Crumlin, Caerphilly	welshName	Crymlyn
Skewen	welshName	Sgiwen
Lavernock	welshName	Larnog
Llangynwyd	welshName	Llangynwyd
Treforest	welshName	Trefforest
Aberffraw	welshName	Aberffro
Bala, Gwynedd	welshName	Y Bala
Barry, Vale of Glamorgan	welshName	Y Barri
Rhoose	welshName	Y Rhws
Old Colwyn	welshName	Hen Golwyn
Ruabon	welshName	Rhiwabon
Dolwyddelan	welshName	Dolwyddelan
Tanygrisiau	welshName	Tanygrisiau
Mwnt	welshName	Mwnt
Pembrey	welshName	Pen-bre
Rhydyfelin	welshName	Rhydfelen
Bwlch	welshName	Bwlch
Rhossili	welshName	Rhosili
Trecastle	welshName	Trecastell
Overton-on-Dee	welshName	Owrtyn
Whitchurch, Cardiff	welshName	Yr Eglwys Newydd
Ynyshir	welshName	Ynys-hir
Ogmore-by-Sea	welshName	Aberogwr
Ewloe	welshName	Ewlo
Newbridge, Caerphilly	welshName	Trecelyn
Llandudno Junction	welshName	Cyffordd Llandudno
Blackwood, Caerphilly	welshName	Y Coed Duon
Pentyrch	welshName	Pentyrch
Bettws Cedewain	welshName	Betws Cedewain
Ely, Cardiff	welshName	Trelái
Betws, Carmarthenshire	welshName	Y Betws
Brackla	welshName	Bragle
Crick, Monmouthshire	welshName	Crug
Talybont-on-Usk	welshName	Tal-y-bont ar Wysg
Abermule	welshName	Aber-miwl
Itton	welshName	Llanddinol
Canton, Cardiff	welshName	Treganna
Ferndale, Rhondda Cynon Taf	welshName	Glynrhedynog
Newgale, Pembrokeshire	welshName	Niwgwl
Magor, Monmouthshire	welshName	Magwyr
Berriew	welshName	Aberriw
Birchgrove, Swansea	welshName	Y Gellifedw
Morriston	welshName	Treforys
St Dogmaels	welshName	Llandudoch
Wiston, Pembrokeshire	welshName	Cas-Wis
Cockett	welshName	Y Cocyd
Abbeycwmhir	welshName	Abaty Cwm Hir
Abernant, Rhondda Cynon Taf	welshName	Abernant
Aberaman	welshName	Aberaman
Aberbargoed	welshName	Aberbargod
Abercastle	welshName	Abercastell
Bon-y-maen	welshName	Bôn-y-maen
Penclawdd	welshName	Pen-clawdd
Abercwmboi	welshName	Abercwmboi
Abererch	welshName	Aber-erch
Abergorlech	welshName	Abergorlech
Abertysswg	welshName	Abertyswg
Llandysul	welshName	Llandysul
Gowerton	welshName	Tre-gŵyr
Llangennith	welshName	Llangenydd/Llangynydd
Church Stoke	welshName	Yr Ystog
Crynant	welshName	Y Creunant
Bishopston, Swansea	welshName	Llandeilo Ferwallt
Taff's Well	welshName	Ffynnon Taf
Kingsbridge, Swansea	welshName	Pontybrenin
Hengoed	welshName	Hengoed
Groeslon	welshName	Y Groeslon
Deeside	welshName	Glannau Dyfrdwy
Resolven	welshName	Resolfen
Cwmaman	welshName	Cwmaman
Llanarth, Ceredigion	welshName	Llanarth
Dinas Cross	welshName	Dinas
Beddau	welshName	Y Beddau
Handbridge	welshName	Treboeth
Sealand, Flintshire	welshName	Gwlad-y-Môr
Brynamman	welshName	Brynaman
Heol-y-Cyw	welshName	Heol-y-Cyw
Pantyffynnon	welshName	Pantyffynnon
Narberth, Pembrokeshire	welshName	Arberth
Pentre Halkyn	welshName	Pentre Helygain
Fairwater, Torfaen	welshName	Fairwater
Llantarnam	welshName	Llanfihangel Llantarnam
Coed Eva	welshName	Coed Efa
Underwood, Newport	welshName	Danbren
Pyle	welshName	Y Pîl
Van, Caerphilly	welshName	Y Fan
Chirbury	welshName	Llanffynhonwen
Ferryside	welshName	Glan-y-fferi
Kilgetty	welshName	Cilgeti
Penally	welshName	Penalun
Lamphey	welshName	Llandyfái
Tongwynlais	welshName	Tongwynlais
Fernhill, Wales	welshName	Brynrhedyn
Cwmbach	welshName	Cwmbach
Llwydcoed	welshName	Llwydcoed
Cwmdare	welshName	Cwmdâr
Northop	welshName	Llaneurgain
Penrhiwceiber	welshName	Penrhiw-ceibr
Talgarreg	welshName	Talgarreg
Rhydlafar	welshName	Rhydlafar
Trevethin	welshName	Trefddyn
Aberkenfig	welshName	Abercynffig
Cwmavon, Neath Port Talbot	welshName	Cwmafan
Penparcau	welshName	Penparcau
Y Ferwig	welshName	Y Ferwig
Penywaun	welshName	Pen-y-waun
Tylorstown	welshName	Pendyrus
Bettws, Newport	welshName	Betws
Merthyr Vale	welshName	Ynysowen
Quakers Yard	welshName	Mynwent y Crynwyr
Treharris	welshName	Treharris
Ton Pentre	welshName	Tonpentre
Rumney, Cardiff	welshName	Rhymni
Broughton, Flintshire	welshName	Brychdyn
Penrhyn Bay	welshName	Bae Penrhyn
Minera	welshName	Y Mwynglawdd
Garnant	welshName	Garnant
Penyffordd	welshName	Penyffordd
Undy	welshName	Gwndy
Wilcrick	welshName	Chwilgrug
Llanvaches	welshName	Llanfaches
Shirenewton	welshName	Drenewydd Gelli-farch
Culverhouse Cross	welshName	Croes Cwrlwys
Eglwyscummin	welshName	Eglwys Gymyn
Llandogo	welshName	Llaneuddogwy
Leeswood	welshName	Coed-llai
Hope, Flintshire	welshName	Yr Hob
Burton, Wrexham	welshName	Bwrton
Llanvair Discoed	welshName	Llanfair Is Coed
Corntown	welshName	Corntwn
Bonvilston	welshName	Tresimwn
Raglan, Monmouthshire	welshName	Rhaglan
Nannerch	welshName	Nannerch
St Brides	welshName	Sain Ffraid
Boverton	welshName	Trebefered
Pontprennau	welshName	Pontprennau
Pontprennau	welshName	(\
Gwaun-Cae-Gurwen	welshName	Gwauncaegurwen
Llangain	welshName	Llan-gain
Gorsgoch	welshName	Gorsgoch
Halkyn	welshName	Helygain
Betws Ifan	welshName	Betws Ifan
Coychurch	welshName	Llangrallo
Moylgrove	welshName	Trewyddel
Pontymoile	welshName	Pont-y-moel
Tonyrefail	welshName	Tonyrefail
Alltwen	welshName	Pen yr Alltwen
Cymmer, Neath Port Talbot	welshName	Cymer
Gileston	welshName	Silstwn
Wenvoe	welshName	Gwenfô
Carway	welshName	Carwe
Upper Cwmbran	welshName	Cwmbrân Uchaf
Glyncorrwg	welshName	Glyncorrwg
Rossett	welshName	yr Orsedd
Moss Valley, Wrexham	welshName	Dyffryn Moss
Aberthaw	welshName	Aberddawan
Staylittle	welshName	Penffordd las
Newton, Bridgend	welshName	Drenewydd yn Notais
Erbistock	welshName	Erbistog
Kerry, Powys	welshName	Ceri
Clydach Vale	welshName	Cwmclydach
Camrose, Pembrokeshire	welshName	Camros
Christchurch, Newport	welshName	Eglwys y Drindod
Lower Machen	welshName	Machen Isaf)
Peterstone	welshName	Llanbedr
Castleton, Newport	welshName	Cas-bach
Level of Mendalgief	welshName	Mendelgyf
Goldcliff, Newport	welshName	Allteuryn
Llanharry	welshName	Llanhari
Talbot Green	welshName	Tonysguboriau
Llanddowror	welshName	Maes-y-lan
Llangyndeyrn	welshName	Llangyndeyrn
Llansannor	welshName	Llansanwyr
Llanelltyd	welshName	Llanelltyd
Maesycwmmer	welshName	Maesycwmer
Penmark	welshName	Pen-marc
Summerhill, Wrexham	welshName	Brynhyfryd
Ponthir	welshName	Pont-hir
Towyn	welshName	Tywyn
Walton East	welshName	Waltwn
Brynford	welshName	Brynffordd
Broad Haven	welshName	Aber Llydan
Miskin	welshName	Meisgyn
Southsea, Wrexham	welshName	Glanrafon
Tycroes	welshName	Tycroes
Cwmgors	welshName	Cwm-gors
Brynsadler	welshName	Brynsadler
Ynysmaerdy	welshName	Ynysmaerdy
Ystrad Meurig	welshName	Ystrad Meurig
Comins Coch, Ceredigion	welshName	Comins Coch
Cwmavon, Torfaen	welshName	Cwmafon
Upper Boat	welshName	Glan-Bad
Templeton, Pembrokeshire	welshName	Tredeml
Betws yn Rhos	welshName	Betws yn Rhos
Caerhun	welshName	Caerhûn
Pentrebach	welshName	Pentrebach
Penley	welshName	Llannerch Banna
Borras	welshName	Bwras
Parkmill	welshName	Melin y Parc
Betws Garmon	welshName	Betws Garmon
Llanarth, Monmouthshire	welshName	Llanarth
Llandegla	welshName	Llandegla-yn-Iâl
Greenfield, Flintshire	welshName	Maes-glas
Red Roses	welshName	Rhos-goch
Monkton, Pembroke	welshName	Cil-maen
Cefneithin	welshName	Cefneithin
Rhydowen	welshName	Rhydowen
Clyro	welshName	Cleirwy
Tudweiliog	welshName	Tudweiliog
Llanwonno	welshName	Llanwynno
St Donats	welshName	Sain Dunwyd
Llanfair, Ceredigion	welshName	Llanfair Clydogau
Llay	welshName	Llai
Ogmore Vale	welshName	Cwm Ogwr
Creigiau	welshName	Creigiau
Wentwood	welshName	Pentref Coed Gwent
Meliden	welshName	Gallt Melyd
Bettws, Bridgend	welshName	Betws
Solva	welshName	Solfach
Rhoscrowther	welshName	Rhoscrowdder
Beguildy	welshName	Bugeildy
Llangolman	welshName	Llangolman
Pontyates	welshName	Pont-iets
Gaerwen	welshName	Gaerwen
Knucklas	welshName	Cnwclas
Blaenllechau	welshName	Blaenllechau
Cemmaes Road	welshName	Glantwymyn
Dyserth	welshName	Diserth
Bersham	welshName	Y Bers
Llantwit Fardre	welshName	Llanilltud Faerdref
Leckwith	welshName	Lecwydd
Blaina	welshName	Y Blaenau
Sketty	welshName	Sgeti
Hendy	welshName	Yr Hendy
Llanyre	welshName	Llanyre
Whitford, Flintshire	welshName	Maes Rhydwen
Connah's Quay	welshName	Cei Connah
Landimore	welshName	Llandîmôr
Penmaen, Caerphilly	welshName	Penmaen
Llandow	welshName	Llandw, Llandwy
Gwbert	welshName	Gwbert
Croeserw	welshName	Croeserw
Llanharan	welshName	Llanharan
Backe, Carmarthenshire	welshName	Bace
Kinmel Bay	welshName	Bae Cinmel
Mathern	welshName	Merthyr Tewdrig
Pendoylan	welshName	Pendeulwyn
Maenclochog	welshName	Maenclochog
Beaufort, Blaenau Gwent	welshName	Cendl
Walterston	welshName	Tre-walter
Llampha	welshName	Llanffa
Nantyglo	welshName	Nant-y-glo
Landore	welshName	Glandŵr
Llansaint	welshName	Llansaint
Llangunnor	welshName	Llangynnwr
Whitchurch, Pembrokeshire	welshName	Tregroes
Buttington	welshName	Tal-y-bont
Ambleston	welshName	Treamlod
Dowlais	welshName	Dowlais
Clarbeston	welshName	Treglarbes
Crinow	welshName	Crynwedd
Church Village	welshName	Pentre'r Eglwys
Crunwere	welshName	Cronwern
Tal-y-bont, Ceredigion	welshName	Tal-y-bont
Llandre	welshName	Llanfihangel Genau'r Glyn
Lledrod	welshName	Lledrod
Y Faenor	welshName	Y Faenor
St. George, Conwy	welshName	Llansansiôr
Llanvihangel Crucorney	welshName	Llanfihangel Crucornau
Llantilio Crossenny	welshName	Llandeilo Gresynni
Llantilio Pertholey	welshName	Llandeilo Bertholau
Llangattock Lingoed	welshName	Llangatwg Lingoed
Llangattock-Vibon-Avel	welshName	Llangatwg Feibion Afel
Llanvihangel-Ystern-Llewern	welshName	Llanfihangel-Ystum-Llywern
Dingestow	welshName	Llanddingad
Devauden	welshName	Y Dyfawden
Cwmyoy	welshName	Cwm-iou
Cross Ash	welshName	Croes Onnen
Cwmcarvan	welshName	Cwmcarfan
Mitchel Troy	welshName	Llanfihangel Troddi
Skenfrith	welshName	Ynysgynwraidd
Portskewett	welshName	Porthsgiwed / Porthysgewin
Tredunnock	welshName	Tredynog
Llandenny	welshName	Llandenni
Llanvetherine	welshName	Llanwytherin
St. Arvans	welshName	Llanarfan
Whitebrook	welshName	Gwenffrwd
Llansoy	welshName	Llan-soe
Rockfield, Monmouthshire	welshName	Llanoronwy
Llanfair Kilgeddin	welshName	Llanfair Cilgedin
Dixton	welshName	Llandydiwg
Llanishen, Monmouthshire	welshName	Llanisien
Llangovan	welshName	Llangofen
Kilgwrrwg	welshName	Cilgwrrwg
Newcastle, Monmouthshire	welshName	Castell-newydd
Newchurch, Monmouthshire	welshName	Yr Eglwys Newydd ar y Cefn
Sennybridge	welshName	Pont Senni
Gwehelog	welshName	Gwehelog
Llanfair Talhaiarn	welshName	Llanfair Talhaearn
Panteg	welshName	Pant-teg
Llanllwchaiarn	welshName	Llanllwchaearn
Morfa Bychan	welshName	Morfa Bychan
Pontsian	welshName	Pont-Siân
Llanfihangel y Creuddyn	welshName	Llanfihangel-y-Creuddyn
Hafod Uchtryd	welshName	Hafod Uchtryd
Llanteg	welshName	Llanteg
Llanhilleth	welshName	Llanhiledd
Castlemorris	welshName	Casmorys
Llandygai	welshName	Llandygái
Glasbury	welshName	Y Clas-ar-Wy
Clyne, Neath Port Talbot	welshName	Y Clun
Newbridge-on-Wye	welshName	Pontnewydd ar Wy
Senghenydd	welshName	Senghennydd
Furnace, Ceredigion	welshName	Ffwrnais
Crossgates, Powys	welshName	Y Groes
Marchwiel	welshName	Marchwiail
Willington Worthenbury	welshName	Willington Wrddymbre
Bacheldre	welshName	Bachelldref
Aberbrân	welshName	Aberbrân
St. Nicholas, Vale of Glamorgan	welshName	Sain Nicolas
Lower Brynamman	welshName	Brynaman Isaf
Hawthorn, Rhondda Cynon Taf	welshName	Y Ddraenen Wen
Cilfynydd	welshName	Cilfynydd
Pontygwaith, Rhondda	welshName	Pont-y-gwaith
Glyncoch	welshName	Glyncoch
Blaencwm	welshName	Blaen-y-Cwm
Mumbles	welshName	Y Mwmbwls
Gelli, Rhondda	welshName	Y Gelli
Hopkinstown	welshName	Trehopcyn
Wattstown	welshName	Aberllechau
Williamstown, Rhondda Cynon Taf	welshName	Trewiliam
Cwmfelin	welshName	Cwmfelin
Penterry	welshName	Penteri
Pont-rhyd-y-groes	welshName	Pont-rhyd-y-groes
Cwmystwyth	welshName	Cwmystwyth
St Lythans	welshName	Llwyneliddon
Llanfair-yn-Neubwll	welshName	Llanfair-yn-Neubwll
Llangan	welshName	Llan-gan
Ysbyty Ystwyth	welshName	Ysbyty Ystwyth
Broughton, Wrexham	welshName	Brychdyn
Nash, Newport	welshName	Trefonnen
Trefil	welshName	Trefil
Treffgarne	welshName	Trefgarn
Penydarren	welshName	Pen-y-darren
Tre-Taliesin	welshName	Tre Taliesin
Penmaenpool	welshName	Pwll Penmaen or Llyn Penmaen.
Penrhiwfer	welshName	Penrhiw-fer
Flint Mountain	welshName	Mynydd Y Fflint
Llangian	welshName	Llangïan
Trevor, Wrexham	welshName	Trefor
Coed-Ely	welshName	Coed-Elái
Darran Valley	welshName	Cwm Darran
Llanhamlach	welshName	Llanhamlach
Llantysilio	welshName	Llandysilio-yn-Iâl
Tumble, Carmarthenshire	welshName	Tymbl
Rassau	welshName	Rasa
Betws Gwerfil Goch	welshName	Betws Gwerful Goch
Cwmtillery	welshName	Cwmtyleri
Trallwn, Pontypridd	welshName	Trallwn
Graianrhyd	welshName	Graeanrhyd
Letterston	welshName	Treletert
Puncheston	welshName	Cas-mael
Cwm, Blaenau Gwent	welshName	Y Cwm
Walton, Powys	welshName	Walton
Castle Quarter	welshName	Cwr y Castell
Cyfarthfa	welshName	Cyfarthfa
Park, Merthyr Tydfil	welshName	Y Parc
Lixwm	welshName	Licswm
Castle, Swansea	welshName	Castell
Kentchurch	welshName	Llan-gain
Old Radnor	welshName	Pencraig
Clemenstone	welshName	Treglement
Ynysawdre	welshName	Ynysawdre
Kenfig Hill	welshName	Mynydd Cynffig
Forden	welshName	Ffordun
Llanrhyddlad	welshName	Llan-Rhûddlad
Garn-yr-erw	welshName	Garn-yr-erw
Llandevaud	welshName	Llandevaud
Parc Seymour	welshName	Parc Seymour
New Moat	welshName	Y Mot
Ogmore Valley	welshName	Cwm Ogwr
Trallong	welshName	Y Trallwng
Crosskeys	welshName	Pont-y-cymer
Clytha	welshName	Tir Clidda
Castle Tump	welshName	Trecastell
Goldsland	welshName	Tregold
The Narth	welshName	Pennarth
Rhandirmwyn	welshName	Rhandir-mwyn
Tafarnaubach	welshName	Tafarnau-bach
Draethen	welshName	Draethen
Dyffryn, Vale of Glamorgan	welshName	Dyffryn
Coity Higher	welshName	Coety Uchaf
Coity	welshName	Coety
Laleston	welshName	Trelales
St Bride's Minor	welshName	Llansanffraid-ar-Ogwr
Newcastle Higher	welshName	Y Castellnewydd ar Ogwr
Coychurch Higher	welshName	Llangrallo Uchaf
Coychurch Lower	welshName	Llangrallo Isaf
Bridgend	welshName	Pen-y-Bont ar Ogwr
Llangynwyd Lower	welshName	Llangynwyd Isaf
Llangynwyd Middle	welshName	Llangynwyd
Alltwalis	welshName	Alltwalis
Ffaldybrenin	welshName	Ffaldybrenin
Rhydargaeau	welshName	Rhydargaeau
Pontarsais	welshName	Pontarsais
Capel Dewi, Carmarthenshire	welshName	Capel Dewi
Capel Dewi, Llandysul	welshName	Capel Dewi
Temple Druid	welshName	Temple Druid
Bute Town	welshName	Drenewydd
Aberwheeler	welshName	Aberchwiler
Waen	welshName	Y Waun
Kinmel Bay and Towyn	welshName	Bae Cinmel a Tywyn
Llanddoged and Maenan	welshName	Llanddoged a Maenan
Llanddulas and Rhyd-y-foel	welshName	Llanddulas a Rhyd-y-foel
Cyffylliog	welshName	Y Gyffylliog
Penllyn, Vale of Glamorgan	welshName	Pen-llin
Swyddffynnon	welshName	Swyddffynnon
Aber Valley	welshName	Cwm Aber
Trecwn	welshName	Trecŵn
Dwyriw	welshName	Dwyrhiw
Bettisfield	welshName	Llys Bedydd
Darranlas	welshName	Darranlas
Dol-y-pandy	welshName	Dôl-y-pandy
Falcondale	welshName	Glyn Hebog
Llettum-ddu	welshName	Lletem-ddu
Carreghofa	welshName	Carreghwfa
Lampeter Velfrey	welshName	Llanbedr Felfre
Llantood	welshName	Llantwyd
Gwynfe	welshName	Capel Gwynfe
Penpergwm	welshName	Penpergwm
Coed-y-paen	welshName	Coed-y-paen
Llangower	welshName	LLangywer
Hyssington	welshName	Isatyn
Crosswell	welshName	Ffynnongroes
Granston	welshName	Treopert
Henry's Moat	welshName	Castell Hendre
Monington, Pembrokeshire	welshName	Eglwys Wythwr
Moelfre, Conwy	welshName	Moelfre
Cwmcych	welshName	Glyn Cuch
Morvil	welshName	Morfil
Tythegston	welshName	Llandudwg
Penffordd, Pembrokeshire	welshName	Pen-ffordd
Pontcynon	welshName	Pont Cynon
Garth, Bridgend	welshName	Garth
Glyntawe	welshName	Glyntawe
