Peter Lehmann	wineryName	Peter Lehmann
Château d'Yquem	wineryName	Château d'Yquem
Moët & Chandon	wineryName	Moët et Chandon
Beaujolais nouveau	wineryName	Beaujolais nouveau
San Antonio Winery	wineryName	San Antonio Winery
Rubicon Estate Winery	wineryName	Rubicon Estate Winery
E & J Gallo Winery	wineryName	E & J Gallo Winery
Wolf Blass	wineryName	Wolf Blass
Wente Vineyards	wineryName	Wente Vineyards
Mount Pleasant Winery	wineryName	Mount Pleasant Winery
Moorilla Estate	wineryName	Moorilla Estate
Heidsieck & Co	wineryName	Heidsieck & Co
Torbreck	wineryName	Torbreck
Stag's Leap Wine Cellars	wineryName	Stag's Leap Wine Cellars
Chateau Montelena	wineryName	Chateau Montelena
Freemark Abbey Winery	wineryName	Freemark Abbey Winery
Sterling Vineyards	wineryName	Sterling Vineyards
Chateau Ste. Michelle	wineryName	Chateau Ste. Michelle
Grgich Hills Estate	wineryName	Grgich Hills Estate
Ridge Vineyards	wineryName	Ridge Vineyards
Mayacamas Vineyards	wineryName	Mayacamas Vineyards
Heitz Wine Cellars	wineryName	Heitz Wine Cellars
Clos Du Val Winery	wineryName	Clos Du Val Winery
Château Haut-Bages-Libéral	wineryName	Château Haut-Bages-Libéral
Beaulieu Vineyard	wineryName	Beaulieu Vineyard
Inglenook	wineryName	Inglenook
Stags' Leap Winery	wineryName	Stags' Leap Winery
Trefethen Vineyards	wineryName	Trefethen Vineyards
The Eyrie Vineyards	wineryName	The Eyrie Vineyards
Yalumba	wineryName	Yalumba
Opus One Winery	wineryName	Opus One Winery
Bollinger	wineryName	Bollinger
Kendall-Jackson	wineryName	Kendall-Jackson
Penfolds	wineryName	Penfolds
Caduceus Cellars	wineryName	Caduceus Cellars
Cooper Mountain Vineyards	wineryName	Cooper Mountain Vineyards
Pol Roger	wineryName	Pol Roger
Houghton Wines	wineryName	Houghton Wines
Bien Nacido Vineyards	wineryName	Bien Nacido Vineyards of Rancho Tepusquet
Schloss Johannisberg	wineryName	Schloss Johannisberg
Williamsburg Winery	wineryName	Williamsburg Winery
Accolade Wines	wineryName	Accolade Wines
Carmel Winery	wineryName	Carmel Winery
Antinori	wineryName	Marchesi Antinori Srl
Barkan Wine Cellars	wineryName	Barkan Wine Cellars
Turkey Flat	wineryName	Turkey Flat
Château Cantemerle	wineryName	Château Cantemerle
Markham Vineyards	wineryName	Markham Vineyards
Château Angélus	wineryName	Château Angélus
Abreu Vineyards	wineryName	Abreu Vineyards
B. R. Cohn Winery	wineryName	B.R. Cohn Winery
Annie's Lane	wineryName	Annie's Lane
Château Haut-Marbuzet	wineryName	Château Haut-Marbuzet
Tahbilk	wineryName	Tahbilk
Columbia Winery	wineryName	Columbia Winery
Château Ausone	wineryName	Château Ausone
Central Coast Wine Services	wineryName	Central Coast Wine Services
French Camp Vineyards	wineryName	French Camp Vineyards
Paso Robles Wine Services	wineryName	Paso RoblesWine Services
Domaine Chandon California	wineryName	Domaine Chandon
Les Bourgeois Winery	wineryName	Les Bourgeois Winery
Piper-Heidsieck	wineryName	PIPER-HEIDSIECK
Ceja Vineyards	wineryName	Ceja Vineyards
Pointe of View Winery	wineryName	Pointe of View Winery
Duckhorn Vineyards	wineryName	Duckhorn Vineyards
Wynns	wineryName	Wynns Coonawarra Estate
Château Pavie	wineryName	Château Pavie
Barboursville Vineyards	wineryName	Barboursville Vineyards
Schiller Vineyards	wineryName	Schiller Vineyards
Ingleside Vineyards	wineryName	Ingleside Vineyards
Bridgeview Vineyard and Winery	wineryName	Bridgeview Vineyard and Winery
Twisted Oak Winery	wineryName	Twisted Oak Winery
Olde Lockeford Winery	wineryName	Olde Lockeford Winery
Coriole	wineryName	Coriole
Horton Vineyards	wineryName	Horton Vineyards
Château Ksara	wineryName	Château Ksara
DeLoach Vineyards	wineryName	DeLoach Vineyards
Oak Knoll Winery	wineryName	Oak Knoll Winery
PlumpJack Winery	wineryName	PlumpJack Winery
Château Filhot	wineryName	Château Filhot
Castello di Amorosa	wineryName	Castello di Amorosa
Terhune Orchards	wineryName	Terhune Orchards
Gundlach Bundschu	wineryName	Gundlach Bundschu
Almaden Vineyards	wineryName	Almaden Vineyards
Quixote Winery	wineryName	Quixote Winery
Beringer Vineyards	wineryName	Beringer
Domaine du Castel	wineryName	Domaine du Castel
Golan Heights Winery	wineryName	Golan Heights Winery
Quails' Gate Winery	wineryName	Quails' Gate Winery
L'Aventure	wineryName	L'Aventure
Blue Mountain Vineyard	wineryName	Blue Mountain Vineyard & Cellars
Blue Sky Vineyards	wineryName	Blue Sky Vineyards
Blasted Church Vineyards	wineryName	Blasted Church Vineyards
Alban Vineyards	wineryName	Alban Vineyards
Screaming Eagle Winery and Vineyards	wineryName	Screaming Eagle Winery
Screaming Eagle Winery and Vineyards	wineryName	and Vineyards
Mahogany Mountain Vineyard and Winery	wineryName	Mahogany Mountain Vineyard and Winery
Bodegas Torres	wineryName	Bodegas Torres
Domain Day	wineryName	Domain Day
Chateau Woltner	wineryName	Chateau Woltner
Dominus Estate	wineryName	Dominus Estate
Quilceda Creek Vintners	wineryName	Quilceda Creek Vintners
Simi Winery	wineryName	Simi Winery
Turley Wine Cellars	wineryName	Turley Wine Cellars
Bruny Island Premium Wines	wineryName	Bruny Island Premium Wines
Clarendon Hills	wineryName	Clarendon Hills
Inniskillin	wineryName	Inniskillin Niagara
Inniskillin	wineryName	Inniskillin Okanagan
Windsor Vineyards	wineryName	Windsor Vineyards
Andretti Winery	wineryName	Andretti Winery
Renault Winery	wineryName	Renault Winery
Hernder Estate Wines	wineryName	Hernder Estate Wines
Laurent-Perrier	wineryName	Laurent-Perrier
Schloss Vollrads	wineryName	Schloss Vollrads
Al Este	wineryName	Al Este Bodega y Viñedos
Weingut St. Antony	wineryName	St. Antony
Monticello Wine Company	wineryName	Monticello Wine Company
Château de Fonbel	wineryName	Château de Fonbel
Harlan Estate	wineryName	Harlan Estate
King Estate Winery	wineryName	King Estate Winery
Yatir winery	wineryName	Yatir Winery
Duplin Winery	wineryName	Duplin Winery
Shelton Vineyards	wineryName	Shelton Vineyards
Reif Estate Winery	wineryName	Reif Estate Winery
Vasse Felix	wineryName	Vasse Felix
KitFox Vineyards	wineryName	KitFox Vineyards
Trapiche	wineryName	Trapiche
Frog's Leap Winery	wineryName	Frog's Leap
J Vineyards & Winery	wineryName	J Vineyards & Winery
Howard Park Wines	wineryName	Howard Park, MadFish, & Marchand & Burch Wines
Teperberg 1870	wineryName	Teperberg 1870
Morgan Creek Vineyards	wineryName	Morgan Creek Vineyards
Recanati winery	wineryName	Recanati Winery
Henschke	wineryName	Henschke
Bodega Catena Zapata	wineryName	Bodega Catena Zapata
Seppeltsfield	wineryName	Seppeltsfield
Chateau Morrisette Winery	wineryName	Chateau Morrisette
Pewsey Vale	wineryName	Pewsey Vale
St. James Winery	wineryName	St. James Winery
Messina Hof	wineryName	Messina Hof
Mountadam Vineyards	wineryName	Mountadam Vineyards
Taylor, Fladgate, & Yeatman	wineryName	Taylor, Fladgate & Yeatman
Ruffino	wineryName	Ruffino
Riunite	wineryName	Cantine Cooperative Riunite
Prairie State Winery	wineryName	Prairie State Winery
Fonseca Guimaraens	wineryName	Fonseca Guimaraens
Chaddsford Winery	wineryName	Chaddsford Winery
Nassau Valley Vineyards	wineryName	Nassau Valley Vineyards
Valhalla Vineyards	wineryName	Valhalla Vineyards
Flag Hill Winery	wineryName	Flag Hill Distillery & Winery
Kokopelli Winery	wineryName	Kokopelli Winery
Weingut von Othegraven	wineryName	von Othegraven
Adelaida Cellars	wineryName	Adelaida Cellars
Jalama Wines	wineryName	Jalama Wines
Brown Estate	wineryName	Brown Estate Vineyards
Ochagavia Wines	wineryName	Ochagavia Wines
Schramsberg Vineyards	wineryName	Schramsberg Vineyards
Scarecrow	wineryName	Scarecrow
Morgan Creek Vineyards	wineryName	Morgan Creek Vineyards
Roederer Estate	wineryName	Roederer Estate
Pelter Winery	wineryName	Pelter Winery
Château Golan	wineryName	Château Golan
Château MacCarthy	wineryName	Château MacCarthy
Clos Payrol	wineryName	Clos Payrol
Tablas Creek Vineyard	wineryName	Tablas Creek Vineyard
Leeuwin Estate	wineryName	Leeuwin Estate
Blenheim Vineyards	wineryName	Blenheim Vineyards
Jordan Vineyard & Winery	wineryName	Jordan Vineyard & Winery
Cullen Wines	wineryName	Cullen Wines
Château Chambert-Marbuzet	wineryName	Château Chambert-Marbuzet
Burrowing Owl Estate	wineryName	Burrowing Owl Estate
Cristom Vineyards	wineryName	Cristom Vineyards
Mission Hill Winery	wineryName	Mission Hill Family Estate
Gloria Ferrer Caves & Vineyards	wineryName	Gloria Ferrer Caves & Vineyards
Charles Creek Vineyard	wineryName	Charles Creek Vineyard
Orlando Wines	wineryName	Orlando Wines
Domaine de la Romanée-Conti	wineryName	Domaine de la Romanée-Conti
Chateau Chantal	wineryName	Chateau Chantal
Mount Avoca Vineyard	wineryName	Mount Avoca
Page Springs Cellars	wineryName	Page Springs Cellars
Andrew Murray Vineyards	wineryName	Andrew Murray Vineyards
Araujo Estate Wines	wineryName	Araujo Estate Wines
Haywire Winery	wineryName	Haywire Winery
Bass Phillip	wineryName	Bass Phillip
Kingston Family Vineyards	wineryName	Kingston Family Vineyards
Charles Melton Wines	wineryName	Charles Melton Wines
Acacia Winery	wineryName	Acacia Winery
Ahlgren Vineyard	wineryName	Ahlgren Vineyard
Adler Fels	wineryName	Adler Fels
Alderbrook Winery	wineryName	Alderbrook Winery
Terra de Promissio	wineryName	Terra de Promissio
Hacienda Wine Cellars	wineryName	Hacienda Wine Cellars
Bartholomew Park Winery	wineryName	Bartholomew Park Winery
Ancre Hill Estates	wineryName	Ancre Hill Estates
Taylors Wines	wineryName	Taylors Wines
Bethel Heights Vineyard	wineryName	Bethel Heights Vineyard
Breaux Vineyards	wineryName	Breaux Vineyards
Sokol Blosser Winery	wineryName	Sokol Blosser Winery
Larson Family Winery	wineryName	Larson Family Winery
Dalton Winery	wineryName	Dalton Winery
Château Quintus	wineryName	Château Quintus
Cantine Lungarotti Winery	wineryName	Cantine Lungarotti Winery
Binyamina Winery	wineryName	Binyamina
Burgess Cellars	wineryName	Burgess Cellars
Tishbi Winery	wineryName	Tishbi Winery
Domaine Ponsot	wineryName	Domaine Ponsot
Domaine Dujac	wineryName	Domaine Dujac
Cline Cellars	wineryName	Cline Cellars Winery
Château de Chamirey	wineryName	Château de Chamirey
Domaine de la Vougeraie	wineryName	Domaine de la Vougeraie
Grace Family Vineyards	wineryName	Grace Family Vineyards
Colgin Cellars	wineryName	Colgin Cellars
Caymus Vineyards	wineryName	Caymus Vineyards
Arsenal Cider House	wineryName	Arsenal Cider House and Wine Cellar
Blackbird Vineyards	wineryName	Blackbird Vineyards
Bryant Family Vineyard	wineryName	Bryant Family Vineyard
Alba Vineyard	wineryName	Alba Vineyard
Auburn Road Vineyards	wineryName	Auburn Road Vineyards
Amalthea Cellars	wineryName	Amalthea Cellars
Wagonhouse Winery	wineryName	Wagonhouse Winery
Villa Milagro Vineyards	wineryName	Villa Milagro Vineyards
Westfall Winery	wineryName	Westfall Winery
Brook Hollow Winery	wineryName	Brook Hollow Winery
Balic Winery	wineryName	Balic Winery
Willow Creek Winery	wineryName	Willow Creek Winery
Beneduce Vineyards	wineryName	Beneduce Winery
Bellview Winery	wineryName	Bellview Winery
Plagido's Winery	wineryName	Plagido's Winery
Cava Winery & Vineyard	wineryName	Cava Winery & Vineyard
Peppadew Fresh Vineyards	wineryName	Peppadew Fresh Vineyards
Old York Cellars	wineryName	Old York Cellars
Cape May Winery & Vineyard	wineryName	Cape May Winery & Vineyard
Chestnut Run Farm	wineryName	Chestnut Run Farm
Cedarvale Winery	wineryName	Cedarvale Winery
Coda Rossa Winery	wineryName	Coda Rossa Vineyards
Mount Salem Vineyards	wineryName	Mount Salem Vineyards
Laurita Winery	wineryName	Laurita Winery
Monroeville Vineyard & Winery	wineryName	Monroeville Vineyard & Winery
Natali Vineyards	wineryName	Natali Vineyards
DeMastro Vineyards	wineryName	DeMastro Vineyards
Jessie Creek Winery	wineryName	Jessie Creek Winery
Hawk Haven Vineyard & Winery	wineryName	Hawk Haven Vineyard & Winery
Hopewell Valley Vineyards	wineryName	Hopewell Valley Vineyards
Four Sisters Winery	wineryName	Four Sisters Winery
Cream Ridge Winery	wineryName	Cream Ridge Winery
Heritage Vineyards	wineryName	Heritage Vineyards
DiBella Winery	wineryName	DiBella Winery
Four JG's Orchards & Vineyards	wineryName	Four JG's Orchards & Vineyards
DiMatteo Vineyards	wineryName	DiMatteo Vineyards
Sharrott Winery	wineryName	Sharrott Winery
Swansea Vineyards	wineryName	Swansea Vineyards
Southwind Vineyard & Winery	wineryName	Southwind Vineyard & Winery
Sylvin Farms Winery	wineryName	Sylvin Farms Winery
Working Dog Winery	wineryName	Working Dog Winery
Unionville Vineyards	wineryName	Unionville Vineyards
Tomasello Winery	wineryName	Tomasello Winery
Turdo Vineyards & Winery	wineryName	Turdo Vineyards & Winery
Ventimiglia Vineyard	wineryName	Ventimiglia Vineyard
Vacchiano Farm	wineryName	Vacchiano Farm
Valenzano Winery	wineryName	Valenzano Winery
Silver Oak Cellars	wineryName	Silver Oak Cellars
Palmaz Vineyards	wineryName	Palmaz Vineyards
Twomey Cellars	wineryName	Twomey Cellars
Weingut Joh. Jos. Prüm	wineryName	Weingut Joh. Jos. Prüm
Weingut Fritz Haag	wineryName	Weingut Fritz Haag
Weingut Gunderloch	wineryName	Weingut Gunderloch
Weingut Dr. Heinrich Nägler	wineryName	Weingut Dr. Heinrich Nägler
Franz Wilhelm Langguth Erben	wineryName	F. W. Langguth Erben
Daniel Vineyards	wineryName	Daniel Vineyards
Willi Schaefer	wineryName	Willi Schaefer
Ponty vineyards	wineryName	Ponty Vineyards
Rimon Winery	wineryName	Rimon Winery
Consilience Wines	wineryName	Consilience Winery
Weingut Wittmann	wineryName	Weingut Wittmann
Whitehall Lane Winery & Vineyards	wineryName	Whitehall Lane Winery & Vineyards
Château Ka	wineryName	Kassatly Chtaura
Plantagenet Wines	wineryName	Plantagenet Wines
Cape Mentelle Vineyards	wineryName	Cape Mentelle Vineyards
Moss Wood	wineryName	Moss Wood
Voyager Estate	wineryName	Voyager Estate
Ashbrook Estate	wineryName	Ashbrook Estate
Brookland Valley Estate	wineryName	Brookland Valley Estate
Devil's Lair	wineryName	Devil's Lair
Sandalford Wines	wineryName	Sandalford Wines
Ferngrove Vineyards	wineryName	Ferngrove Vineyards
Castle Rock Estate	wineryName	Castle Rock Estate
Frankland Estate	wineryName	Frankland Estate
Alkoomi Wines	wineryName	Alkoomi Wines
Hay Shed Hill Wines	wineryName	Hay Shed Hill Wines
Coorinja Vineyard	wineryName	Coorinja Vineyard
Zarephath Wines	wineryName	Zarephath Wines
Forest Hill Vineyard	wineryName	Forest Hill Vineyard
Capel Vale Wines	wineryName	Capel Vale Wines
Gralyn Estate	wineryName	Gralyn Estate
Pierro	wineryName	Pierro
Woodlands Wines	wineryName	Woodlands Wines
Woodside Valley Estate	wineryName	Woodside Valley Estate
Stella Bella Wines	wineryName	Stella Bella Wines
Lenton Brae Estate	wineryName	Lenton Brae Estate
Driftwood Estate	wineryName	Driftwood Estate
Fermoy Estate	wineryName	Fermoy Estate
Force Majeure Vineyards	wineryName	Force Majeure Vineyard
Aravina Estate	wineryName	Aravina Estate
Adinfern Estate	wineryName	Adinfern Estate
Wise Wine	wineryName	Wise Wine
Deep Woods Estate	wineryName	Deep Woods Estate
Millbrook Winery	wineryName	Millbrook Winery
Smithbrook Wines	wineryName	Smithbrook Wines
Salitage Wines	wineryName	Salitage Wines
Picardy	wineryName	Picardy
Champagne Besserat de Bellefon	wineryName	Besserat de Bellefon
Lagarde	wineryName	Lagarde
Whalebone Vineyard	wineryName	Whalebone Vineyard
Clos Mogador	wineryName	Clos Mogador
Bosman Family Vineyards	wineryName	Bosman Family Vineyards
Zumot Winery	wineryName	Zumot Winery
Le Vieux Pin	wineryName	Le Vieux Pin
La Stella	wineryName	LaStella
Kenwood Vineyards	wineryName	Kenwood Vineyards
Lynfred Winery	wineryName	Lynfred Winery
Lost Spirits	wineryName	Lost Spirits
